2,00:10:20,2,True,7,10,-3,30,2,0
4,00:02:38,3,True,10,7,3,22,19,0
2,00:01:29,2,False,3,13,-10,1,1,0
2,00:02:02,1,False,10,14,-4,1,1,0
1,00:01:57,1,False,1,0,1,12,10,0
2,00:01:33,2,True,8,13,-5,13,3,0
2,00:00:39,1,False,10,0,10,23,10,0
1,00:10:07,1,True,0,0,0,2,2,0
3,00:09:16,3,True,0,10,-10,39,6,0
2,00:06:53,1,False,0,3,-3,1,1,0
4,00:02:54,1,False,3,34,-31,1,1,0
1,00:00:00,2,False,3,1,2,23,8,0
4,00:06:42,1,False,27,23,4,2,2,0
2,00:00:30,0,False,12,6,6,3,0,0
3,00:11:58,1,False,20,7,13,54,10,0
3,00:09:38,1,False,20,7,13,52,10,0
3,00:09:05,2,False,20,7,13,51,11,0
3,00:07:42,1,True,7,20,-13,17,10,0
3,00:00:50,1,False,23,7,16,41,10,0
4,00:02:33,1,False,26,13,13,11,10,0
4,00:02:27,2,False,26,13,13,20,1,0
1,00:04:22,1,True,6,3,3,41,10,0
2,00:02:07,2,True,19,10,9,39,9,0
3,00:14:13,1,False,13,19,-6,53,10,0
3,00:01:29,1,True,27,16,11,49,10,0
4,00:11:49,1,True,27,23,4,55,10,0
4,00:03:49,2,False,30,30,0,45,8,0
1,00:10:15,1,False,0,7,-7,51,10,0
1,00:00:32,1,False,3,7,-4,48,10,0
1,00:00:01,1,True,7,3,4,47,10,0
2,00:15:00,1,True,7,3,4,35,10,0
3,00:13:34,2,True,10,14,-4,47,2,0
3,00:11:27,1,True,10,15,-5,35,10,0
3,00:10:10,2,True,10,15,-5,55,2,0
3,00:03:22,1,True,10,15,-5,29,10,0
3,00:11:17,0,False,16,13,3,5,0,47
1,00:05:51,0,True,13,0,13,15,0,47
3,00:07:42,0,True,17,15,2,5,0,47
2,00:04:19,0,False,16,10,6,5,0,47
4,00:01:31,0,True,38,27,11,27,0,35
2,00:00:01,0,False,17,6,11,35,0,35
5,00:00:00,3,False,32,35,-3,30,5,35
2,00:02:52,3,False,7,3,4,44,7,35
1,00:08:08,3,True,6,0,6,29,3,35
4,00:04:45,0,True,38,25,13,42,0,18
2,00:04:01,0,True,3,0,3,38,0,18
2,00:14:26,0,False,2,0,2,36,0,18
2,00:00:25,0,True,0,2,-2,39,0,18
1,00:05:57,0,False,3,3,0,33,0,18
4,00:09:13,0,True,21,24,-3,46,0,18
2,00:11:23,0,False,3,2,1,51,0,18
2,00:06:38,0,True,7,7,0,50,0,18
2,00:10:49,0,True,9,16,-7,35,0,18
4,00:13:02,3,False,16,21,-5,37,10,66
2,00:09:33,3,True,7,10,-3,35,7,66
1,00:12:21,3,False,0,0,0,23,3,66
3,00:12:29,3,False,10,9,1,34,2,66
2,00:09:33,3,False,7,0,7,29,11,66
2,00:01:48,3,False,10,8,2,17,8,66
1,00:11:30,3,True,7,0,7,35,0,66
1,00:00:00,3,True,10,1,9,39,3,66
4,00:06:17,3,True,30,29,1,22,8,66
4,00:02:33,3,False,0,51,-51,21,1,66
4,00:07:18,3,False,13,24,-11,33,11,66
3,00:02:25,3,True,24,3,21,35,10,66
4,00:00:53,3,True,23,30,-7,25,2,66
1,00:08:33,3,False,7,7,0,40,8,66
2,00:02:26,3,True,20,3,17,11,6,66
2,00:07:41,3,False,15,0,15,17,10,66
2,00:01:24,3,False,3,13,-10,25,2,66
1,00:06:02,3,False,0,3,-3,39,9,66
4,00:04:33,3,False,32,25,7,27,7,66
1,00:01:52,3,False,0,7,-7,37,10,66
4,00:12:17,3,False,13,17,-4,20,4,66
1,00:04:14,3,False,0,0,0,17,9,66
4,00:08:09,3,False,13,24,-11,36,6,66
1,00:04:13,3,True,1,0,1,36,10,66
4,00:03:51,3,True,22,19,3,18,16,66
4,00:00:00,1,False,30,28,2,43,10,66
1,00:04:23,3,True,3,0,3,34,5,66
4,00:01:39,3,False,20,26,-6,37,8,66
2,00:00:00,1,True,3,15,-12,19,10,66
2,00:14:26,3,True,7,3,4,37,6,66
4,00:10:34,3,True,33,16,17,21,10,66
4,00:02:37,3,False,31,26,5,26,10,66
4,00:13:12,3,True,14,21,-7,15,2,66
1,00:07:53,3,True,0,0,0,28,9,66
3,00:04:11,3,False,8,23,-15,21,10,66
2,00:02:29,3,False,7,27,-20,36,10,66
4,00:02:18,3,True,27,23,4,34,10,66
2,00:02:35,3,True,11,14,-3,32,10,66
4,00:09:05,3,False,15,19,-4,33,6,66
1,00:08:08,3,True,0,0,0,33,9,66
3,00:05:42,3,False,4,10,-6,30,10,66
2,00:07:33,3,True,4,14,-10,33,4,66
3,00:06:02,3,True,20,21,-1,35,7,66
4,00:09:34,3,False,3,20,-17,24,6,66
4,00:09:46,3,False,24,13,11,30,9,66
4,00:06:56,3,False,24,21,3,31,8,66
2,00:05:01,3,True,17,0,17,28,10,66
2,00:00:00,3,False,7,1,6,16,6,66
3,00:01:22,3,True,11,7,4,29,12,66
4,00:00:30,3,True,17,22,-5,25,8,66
1,00:11:11,3,False,0,0,0,33,5,66
2,00:13:18,3,True,7,7,0,24,10,66
2,00:05:27,3,False,3,5,-2,29,15,66
3,00:04:56,3,False,6,15,-9,38,10,66
2,00:10:57,3,False,11,0,11,34,14,66
2,00:01:25,3,False,18,8,10,28,10,66
2,00:10:33,3,False,0,12,-12,39,5,66
4,00:04:34,3,False,24,29,-5,14,5,66
2,00:13:07,3,False,0,10,-10,34,4,66
2,00:06:45,3,True,3,3,0,28,15,66
1,00:10:21,3,False,0,0,0,30,10,66
4,00:00:21,3,False,24,25,-1,25,5,66
1,00:08:00,3,False,0,3,-3,23,3,66
1,00:06:11,3,False,0,0,0,21,18,66
1,00:11:28,3,True,0,0,0,30,4,66
3,00:00:10,3,False,7,23,-16,34,5,66
2,00:10:38,3,False,1,14,-13,28,7,66
2,00:14:44,3,False,0,6,-6,35,10,66
3,00:06:36,3,False,7,17,-10,31,4,66
2,00:00:00,2,True,6,12,-6,28,1,66
1,00:02:16,3,False,1,2,-1,39,4,66
4,00:04:07,3,False,11,25,-14,16,12,66
3,00:06:21,3,False,15,22,-7,28,5,66
3,00:04:57,3,True,20,10,10,34,14,66
2,00:03:14,3,False,9,3,6,29,10,66
2,00:12:05,3,False,16,8,8,19,5,66
2,00:05:11,2,True,6,10,-4,32,10,66
2,00:00:00,1,True,10,13,-3,21,10,66
3,00:11:27,3,True,10,14,-4,29,3,66
4,00:13:18,2,False,24,6,18,31,3,14
3,00:14:12,1,False,23,10,13,54,10,14
4,00:10:17,2,True,22,16,6,18,10,14
4,00:02:42,2,False,19,29,-10,25,0,14
1,00:15:00,0,True,0,0,0,35,0,14
1,00:02:55,1,True,0,3,-3,50,10,14
2,00:02:07,1,True,14,11,3,30,10,14
3,00:02:05,3,True,14,14,0,46,10,14
3,00:00:08,0,False,14,21,-7,52,0,14
2,00:08:14,1,False,7,10,-3,43,10,14
3,00:08:18,2,True,17,17,0,9,4,14
3,00:06:17,3,True,17,17,0,40,3,14
4,00:00:37,1,True,27,29,-2,40,10,14
2,00:01:02,1,False,7,17,-10,45,10,14
4,00:06:59,2,True,37,13,24,51,6,14
4,00:02:50,0,False,27,37,-10,53,0,14
1,00:02:52,1,False,0,8,-8,39,10,14
3,00:00:27,2,False,17,8,9,23,10,14
1,00:12:25,3,False,0,0,0,43,17,14
2,00:03:00,2,False,10,8,2,34,1,14
3,00:11:59,1,False,10,9,1,43,10,14
3,00:12:17,1,False,8,24,-16,34,10,14
3,00:03:39,1,True,34,8,26,38,10,14
1,00:13:36,1,False,0,0,0,50,10,14
3,00:07:49,3,False,8,16,-8,45,10,14
1,00:04:58,1,False,0,7,-7,55,10,14
4,00:15:00,1,False,0,44,-44,48,10,14
4,00:14:00,2,False,0,44,-44,55,1,14
2,00:12:20,3,False,6,7,-1,53,10,14
2,00:03:39,3,True,7,9,-2,48,2,14
3,00:01:35,1,False,13,17,-4,37,10,14
1,00:15:00,0,False,0,0,0,35,0,14
2,00:01:47,3,True,7,14,-7,20,25,14
4,00:06:48,2,False,21,23,-2,37,0,14
4,00:05:29,0,True,23,21,2,29,0,14
1,00:09:41,1,False,0,7,-7,40,10,14
1,00:12:22,2,False,0,0,0,38,10,14
2,00:09:51,1,True,11,17,-6,30,10,14
1,00:09:13,3,True,0,8,-8,48,6,14
1,00:08:16,0,True,0,8,-8,37,0,14
2,00:05:27,1,False,11,10,1,14,20,14
2,00:03:10,1,False,11,13,-2,35,10,14
1,00:01:53,1,False,0,5,-5,53,10,14
2,00:00:56,2,False,0,15,-15,32,1,14
2,00:00:33,3,False,0,15,-15,36,1,14
2,00:11:02,2,True,16,0,16,21,10,14
1,00:04:13,2,False,0,7,-7,30,20,14
3,00:14:28,1,False,11,20,-9,42,10,14
3,00:00:01,2,True,27,14,13,46,0,14
4,00:13:20,1,True,27,17,10,35,10,14
4,00:11:32,2,True,27,17,10,18,3,14
5,00:00:00,2,False,35,27,8,35,10,14
1,00:02:05,0,False,7,0,7,10,0,14
3,00:10:56,0,True,1,29,-28,35,0,14
4,00:12:32,3,True,6,39,-33,40,5,14
1,00:12:32,2,False,0,0,0,42,18,14
1,00:03:58,3,True,3,0,3,19,7,14
3,00:04:10,0,False,8,3,5,45,0,14
4,00:01:12,2,True,11,16,-5,30,10,14
4,00:14:15,3,True,17,6,11,36,7,14
2,00:12:56,0,True,7,16,-9,46,0,14
2,00:00:41,0,True,13,16,-3,45,0,14
3,00:11:55,3,False,16,13,3,10,11,14
3,00:10:52,0,False,16,13,3,41,0,14
4,00:00:56,2,True,20,30,-10,48,10,14
2,00:05:15,2,True,10,7,3,46,10,14
2,00:01:43,1,False,10,10,0,23,10,14
4,00:12:25,2,True,15,19,-4,55,10,14
2,00:12:59,2,False,8,11,-3,37,10,14
3,00:09:31,2,True,7,13,-6,1,1,14
4,00:05:40,2,True,7,19,-12,46,10,14
4,00:03:48,3,False,19,7,12,53,19,14
1,00:14:20,1,True,0,0,0,36,10,14
1,00:01:42,2,False,15,7,8,15,17,14
2,00:12:23,0,False,15,7,8,42,0,14
2,00:01:49,1,True,7,26,-19,35,10,14
4,00:11:47,2,True,14,47,-33,9,6,14
4,00:02:16,1,True,17,50,-33,30,10,14
2,00:13:35,0,False,6,9,-3,5,0,14
1,00:02:33,0,True,3,0,3,24,0,14
2,00:12:54,2,True,3,0,3,48,10,14
2,00:02:46,3,False,0,3,-3,35,12,14
2,00:01:55,0,False,0,3,-3,38,0,14
1,00:00:57,1,False,7,3,4,21,10,14
3,00:13:14,1,True,6,21,-15,49,10,14
3,00:01:28,3,False,31,6,25,24,9,14
4,00:12:16,1,True,9,32,-23,35,10,14
3,00:08:05,1,True,4,4,0,52,10,14
3,00:07:12,2,True,4,4,0,55,7,14
1,00:14:26,0,False,0,0,0,51,0,14
3,00:04:13,0,False,13,12,1,45,0,14
1,00:10:33,1,False,0,0,0,46,10,14
1,00:12:28,0,True,0,0,0,16,0,14
2,00:07:12,3,False,3,13,-10,48,9,14
4,00:12:16,1,True,26,20,6,30,10,14
1,00:00:01,2,False,3,10,-7,38,9,14
3,00:13:08,2,True,17,26,-9,38,10,14
3,00:04:44,2,True,17,29,-12,32,10,14
1,00:10:50,2,True,0,0,0,50,6,14
4,00:07:48,2,True,24,12,12,23,2,14
3,00:01:44,2,False,4,22,-18,53,9,14
1,00:09:55,0,True,0,0,0,13,0,14
4,00:01:24,0,True,28,30,-2,5,0,14
3,00:08:37,3,False,22,9,13,10,21,14
1,00:03:49,2,True,3,1,2,39,6,14
2,00:02:36,3,False,9,17,-8,43,8,14
1,00:14:53,1,True,0,0,0,30,10,14
1,00:08:13,1,True,0,7,-7,30,10,14
1,00:03:43,1,True,0,21,-21,42,10,14
4,00:05:11,3,False,32,13,19,41,15,14
4,00:01:27,1,True,13,35,-22,36,10,14
1,00:13:01,2,False,0,0,0,11,9,14
2,00:12:02,1,True,16,0,16,48,20,14
4,00:04:30,1,True,35,27,8,48,10,14
4,00:01:33,1,True,42,27,15,29,10,14
2,00:05:23,1,False,21,3,18,28,10,14
4,00:02:39,1,False,34,11,23,45,10,14
2,00:09:03,3,False,4,8,-4,51,4,14
2,00:02:38,2,False,7,8,-1,24,10,14
3,00:09:17,2,True,9,10,-1,34,17,14
3,00:08:29,0,False,10,9,1,35,0,14
4,00:03:28,2,True,14,14,0,35,6,14
2,00:14:20,1,True,13,0,13,7,7,14
2,00:10:15,2,True,14,7,7,51,10,14
2,00:04:47,2,False,16,14,2,25,10,14
3,00:06:25,1,True,21,16,5,37,10,14
3,00:01:59,3,True,14,7,7,38,7,14
3,00:01:36,0,False,9,14,-5,25,0,14
4,00:09:36,1,False,9,14,-5,6,10,14
4,00:10:06,2,True,33,17,16,37,8,14
1,00:04:08,0,True,0,3,-3,36,0,14
1,00:01:15,0,False,3,0,3,30,0,14
2,00:04:02,0,False,10,7,3,45,0,14
1,00:07:20,3,True,0,3,-3,43,2,14
2,00:09:28,2,True,0,12,-12,23,8,14
4,00:07:11,0,True,33,38,-5,5,0,14
1,00:14:55,1,False,0,0,0,36,10,14
3,00:09:08,1,False,21,14,7,46,10,14
1,00:09:52,0,True,0,0,0,48,0,14
2,00:11:33,1,False,1,9,-8,36,10,14
1,00:05:19,1,False,0,10,-10,54,10,14
2,00:02:58,3,True,24,0,24,50,10,14
4,00:13:32,0,True,27,7,20,48,0,14
4,00:06:52,0,True,27,29,-2,2,0,14
2,00:01:34,3,True,3,13,-10,48,20,14
2,00:07:53,1,False,17,3,14,53,10,14
1,00:12:25,2,True,0,0,0,42,1,14
1,00:10:38,1,True,0,0,0,30,10,14
1,00:06:52,0,True,0,7,-7,36,0,14
1,00:01:46,0,False,7,3,4,42,0,14
1,00:01:20,1,False,7,10,-3,43,10,14
2,00:11:29,1,False,7,20,-13,43,10,14
3,00:13:56,0,True,31,7,24,34,0,14
3,00:11:30,2,False,17,21,-4,14,4,14
2,00:10:48,3,True,0,14,-14,19,16,14
2,00:07:14,2,True,0,16,-16,21,10,14
4,00:10:45,2,False,23,17,6,24,9,14
4,00:10:16,0,True,17,23,-6,30,0,14
1,00:14:20,2,True,0,0,0,43,2,14
2,00:09:03,2,True,10,3,7,14,10,14
2,00:01:17,1,True,10,9,1,35,10,14
3,00:15:00,0,False,15,10,5,35,0,14
1,00:12:29,2,False,0,0,0,54,7,14
1,00:03:04,3,True,3,0,3,53,10,14
2,00:14:50,1,False,3,3,0,28,15,14
3,00:03:08,3,False,27,6,21,45,2,14
1,00:04:57,2,True,0,2,-2,38,7,14
3,00:12:55,1,False,2,0,2,26,10,14
3,00:11:24,2,False,2,3,-1,37,8,14
2,00:00:14,1,True,6,22,-16,16,10,14
3,00:13:45,1,True,6,22,-16,52,10,14
4,00:04:26,3,False,25,13,12,35,1,14
4,00:00:00,3,False,30,24,6,52,2,14
1,00:09:26,2,True,0,3,-3,35,10,14
2,00:08:24,0,True,17,3,14,34,0,14
2,00:07:20,2,False,3,17,-14,4,4,14
3,00:13:46,2,True,13,14,-1,44,2,14
4,00:04:50,2,True,16,24,-8,11,11,14
4,00:01:05,1,True,11,11,0,35,10,14
1,00:10:30,3,False,0,0,0,42,7,14
1,00:06:38,0,True,0,0,0,45,0,14
2,00:06:30,2,True,10,14,-4,38,8,14
3,00:12:12,2,True,10,14,-4,52,10,14
4,00:02:09,1,True,17,21,-4,18,10,14
1,00:05:34,2,False,3,7,-4,35,10,14
1,00:03:30,3,False,3,7,-4,47,2,14
2,00:00:48,1,True,21,13,8,44,10,14
1,00:09:43,1,False,0,0,0,34,10,14
1,00:08:17,3,False,0,0,0,32,3,14
2,00:13:25,1,True,7,0,7,42,10,14
1,00:01:22,0,False,0,17,-17,35,0,14
1,00:07:44,1,False,0,7,-7,39,10,14
2,00:09:47,1,False,0,17,-17,10,15,14
3,00:04:29,1,False,14,31,-17,28,10,14
4,00:06:32,0,True,45,14,31,50,0,14
4,00:00:27,1,True,20,27,-7,39,10,14
1,00:03:20,1,False,0,12,-12,47,10,14
2,00:13:17,2,False,0,19,-19,40,3,14
3,00:09:29,3,False,1,24,-23,28,8,14
1,00:12:51,1,True,0,0,0,33,10,14
3,00:07:54,2,True,20,21,-1,41,20,14
4,00:02:19,2,False,28,33,-5,45,10,14
2,00:15:00,2,False,0,14,-14,47,9,14
2,00:05:40,1,False,0,14,-14,38,10,14
3,00:12:11,3,True,20,0,20,38,1,14
1,00:05:31,2,False,0,7,-7,37,10,14
4,00:15:00,0,True,13,17,-4,53,0,14
4,00:08:47,2,False,24,14,10,43,2,14
4,00:00:02,2,True,28,24,4,5,5,14
2,00:13:55,1,False,0,10,-10,48,10,14
2,00:00:04,1,False,1,17,-16,53,10,14
3,00:04:16,3,True,20,22,-2,37,6,14
4,00:03:21,3,True,30,28,2,55,5,14
2,00:01:45,3,True,6,17,-11,52,4,14
4,00:07:46,1,True,15,34,-19,54,20,14
2,00:00:33,2,True,13,11,2,17,10,14
3,00:03:18,2,False,13,3,10,35,6,14
3,00:12:27,2,False,7,9,-2,38,2,14
4,00:00:10,2,False,7,10,-3,30,19,14
1,00:00:42,2,True,10,3,7,26,3,14
2,00:02:12,3,True,13,3,10,52,8,14
1,00:14:09,3,False,0,0,0,44,10,14
3,00:12:24,2,False,9,6,3,45,15,14
3,00:03:27,2,True,6,20,-14,46,10,14
1,00:12:00,2,False,0,7,-7,35,10,14
4,00:10:22,2,True,34,9,25,51,4,14
4,00:04:22,3,False,9,37,-28,47,2,14
1,00:06:34,1,True,0,3,-3,18,10,14
2,00:11:16,1,True,6,6,0,25,10,14
2,00:11:03,1,True,6,6,0,16,10,14
4,00:11:31,3,False,20,27,-7,39,4,14
4,00:06:57,2,True,29,20,9,39,7,14
2,00:10:53,1,True,5,3,2,40,10,14
3,00:11:20,2,False,10,21,-11,47,6,14
3,00:06:16,3,True,21,10,11,40,0,14
4,00:00:51,2,False,25,24,1,53,10,14
3,00:01:59,0,True,10,10,0,35,0,14
4,00:04:45,3,True,14,30,-16,40,4,14
4,00:01:15,1,True,17,33,-16,35,10,14
2,00:12:51,2,True,17,3,14,3,3,14
3,00:08:06,0,False,19,20,-1,43,0,14
4,00:06:24,2,True,30,29,1,35,10,14
3,00:10:42,1,True,21,14,7,13,10,14
3,00:03:45,1,True,21,21,0,50,10,14
3,00:01:59,2,False,21,21,0,39,19,14
3,00:10:12,1,True,8,4,4,2,2,14
3,00:00:01,1,True,8,7,1,54,15,14
4,00:03:45,1,False,7,8,-1,44,10,14
1,00:00:51,2,True,7,10,-3,38,9,14
3,00:09:07,1,True,7,17,-10,53,10,14
4,00:00:01,1,False,11,16,-5,25,20,14
1,00:03:37,2,True,0,10,-10,35,10,14
2,00:01:42,1,False,3,1,2,31,10,14
3,00:13:59,3,False,6,1,5,22,10,14
1,00:06:58,2,True,0,0,0,42,8,14
4,00:11:10,3,True,31,24,7,41,16,14
4,00:00:01,1,False,27,41,-14,25,10,14
3,00:12:23,0,True,7,8,-1,47,0,14
3,00:08:36,3,True,7,8,-1,9,0,14
4,00:07:27,0,False,19,16,3,30,0,14
2,00:01:36,2,False,3,8,-5,2,2,14
3,00:02:44,1,False,3,12,-9,51,10,14
2,00:01:41,0,True,11,7,4,8,0,14
2,00:00:57,2,False,7,14,-7,35,10,14
3,00:13:44,2,False,7,14,-7,49,11,14
3,00:12:26,0,False,12,13,-1,25,0,14
4,00:00:53,2,False,12,13,-1,32,7,14
1,00:07:08,3,False,0,8,-8,49,2,14
2,00:02:21,1,False,10,15,-5,36,10,14
2,00:04:17,2,False,3,3,0,8,8,14
3,00:08:10,0,False,6,5,1,30,0,14
4,00:01:23,2,True,5,7,-2,34,9,14
1,00:09:09,0,True,0,0,0,44,0,14
1,00:12:58,1,False,0,0,0,52,10,14
3,00:14:00,3,True,7,21,-14,40,7,14
1,00:00:42,3,False,1,7,-6,35,0,14
2,00:14:45,3,False,1,7,-6,38,10,14
4,00:01:58,3,False,30,24,6,44,1,14
2,00:03:00,1,False,3,6,-3,45,10,14
2,00:01:05,1,True,6,3,3,5,10,14
1,00:15:00,0,False,0,0,0,35,0,14
1,00:01:45,1,False,15,3,12,21,10,14
4,00:09:06,2,False,33,25,8,49,6,14
4,00:08:28,1,True,25,33,-8,53,10,14
2,00:14:39,1,True,3,3,0,45,10,14
2,00:03:02,3,False,3,6,-3,20,10,14
3,00:10:59,2,True,15,3,12,45,3,14
3,00:13:19,0,True,9,21,-12,36,0,14
4,00:10:16,0,True,9,30,-21,27,0,14
2,00:13:57,1,False,0,3,-3,31,10,14
2,00:07:18,2,False,1,3,-2,45,7,14
2,00:03:56,2,False,1,15,-14,43,10,14
4,00:04:38,2,False,15,28,-13,40,0,14
4,00:02:21,3,False,15,31,-16,44,6,14
1,00:10:24,3,True,0,0,0,43,23,14
3,00:13:09,2,False,22,10,12,29,18,14
3,00:07:30,0,False,0,17,-17,40,0,14
3,00:10:28,1,True,5,13,-8,46,10,14
1,00:00:10,2,False,7,0,7,23,8,14
2,00:10:25,1,True,0,7,-7,55,10,14
3,00:14:54,1,True,28,17,11,23,10,14
4,00:10:23,1,True,42,20,22,20,10,14
2,00:13:28,0,True,0,10,-10,45,0,14
3,00:13:50,2,True,10,20,-10,47,5,14
3,00:13:02,2,True,10,20,-10,19,12,14
3,00:01:12,1,False,30,13,17,44,10,14
4,00:04:27,3,False,3,34,-31,47,4,14
4,00:02:47,1,False,3,41,-38,34,10,14
1,00:06:45,1,True,0,0,0,21,10,14
3,00:05:13,1,False,7,24,-17,35,10,14
1,00:05:38,1,False,0,7,-7,38,10,14
2,00:07:13,3,False,0,14,-14,53,6,14
2,00:05:48,2,True,14,0,14,22,10,14
1,00:13:49,1,False,0,0,0,48,10,14
2,00:04:37,1,False,10,6,4,42,10,14
4,00:11:21,1,False,20,6,14,34,16,14
4,00:05:39,3,True,9,20,-11,48,5,14
2,00:12:19,1,False,15,6,9,35,10,14
1,00:09:30,3,True,0,0,0,33,9,14
2,00:00:01,2,True,7,13,-6,50,8,14
2,00:14:53,1,False,3,8,-5,23,10,14
2,00:05:29,1,True,15,7,8,54,25,14
3,00:13:15,2,False,7,15,-8,21,11,14
3,00:00:19,2,False,21,15,6,47,10,14
2,00:00:48,1,True,14,10,4,35,10,14
2,00:12:50,1,True,8,0,8,24,20,14
3,00:04:46,1,True,22,17,5,25,10,14
1,00:02:38,1,True,7,0,7,11,10,14
2,00:07:23,1,False,3,10,-7,42,10,14
2,00:00:44,2,True,10,3,7,24,9,14
3,00:12:03,3,True,10,3,7,25,10,14
4,00:06:52,1,True,11,12,-1,36,10,14
2,00:14:45,0,True,10,3,7,29,0,14
2,00:01:45,1,False,3,20,-17,15,10,14
3,00:06:00,2,True,27,3,24,21,10,14
2,00:07:32,2,True,7,3,4,50,6,14
2,00:10:00,2,False,10,3,7,29,10,14
3,00:00:03,2,False,27,16,11,45,6,14
4,00:12:26,2,True,16,27,-11,38,15,14
4,00:06:36,1,False,30,16,14,42,10,14
1,00:13:48,3,True,0,0,0,44,3,14
2,00:09:45,1,False,0,4,-4,13,10,14
2,00:05:31,2,True,11,3,8,39,6,14
4,00:10:13,1,True,21,6,15,48,10,14
4,00:02:22,1,False,9,28,-19,47,10,14
1,00:06:50,0,True,0,1,-1,11,0,14
2,00:01:59,0,True,10,4,6,16,0,14
2,00:01:37,2,False,4,10,-6,5,21,14
4,00:03:57,1,True,24,10,14,10,10,14
4,00:02:16,3,True,24,17,7,35,10,14
4,00:10:59,1,True,43,3,40,9,9,14
4,00:10:21,2,True,36,18,18,28,6,14
4,00:04:38,0,True,36,18,18,10,0,14
3,00:13:25,1,False,7,17,-10,28,10,14
1,00:11:41,0,False,0,0,0,38,0,14
2,00:13:52,1,False,7,3,4,21,10,14
2,00:03:44,2,True,10,14,-4,32,6,14
3,00:13:08,0,True,20,14,6,40,0,14
2,00:09:41,0,True,10,0,10,15,0,14
1,00:11:54,2,True,0,0,0,36,12,14
1,00:02:48,1,True,6,0,6,35,10,14
4,00:14:12,0,False,27,14,13,26,0,14
4,00:01:59,3,False,34,27,7,21,4,14
1,00:02:14,0,False,3,3,0,32,0,14
2,00:03:33,3,False,3,6,-3,45,2,14
1,00:13:05,1,False,0,0,0,18,10,14
1,00:06:30,2,False,0,0,0,11,4,14
2,00:01:02,1,False,22,7,15,20,20,14
3,00:06:43,3,False,30,7,23,42,2,14
3,00:05:05,1,True,7,30,-23,53,10,14
4,00:11:46,0,False,30,10,20,50,0,14
4,00:08:32,0,True,10,30,-20,15,0,14
1,00:12:02,0,True,6,0,6,25,0,14
2,00:07:35,2,False,10,16,-6,25,3,14
3,00:00:01,1,True,27,16,11,13,10,14
4,00:04:30,1,False,30,30,0,43,10,14
2,00:04:45,2,False,5,13,-8,29,8,14
2,00:10:35,3,False,15,7,8,31,10,14
1,00:01:21,3,False,1,3,-2,42,7,14
2,00:09:00,2,False,7,10,-3,15,2,14
3,00:11:05,2,True,10,10,0,54,15,14
4,00:06:26,3,True,25,11,14,42,21,14
1,00:04:40,1,True,7,3,4,37,10,14
4,00:07:17,3,True,25,11,14,49,12,14
4,00:00:51,1,True,29,11,18,25,10,14
4,00:07:49,0,False,16,27,-11,35,0,14
1,00:10:20,1,True,0,3,-3,35,10,14
2,00:11:28,1,False,10,3,7,18,10,14
3,00:00:45,2,True,21,11,10,41,3,14
1,00:00:04,0,True,14,0,14,1,0,14
4,00:14:00,0,False,14,43,-29,40,0,14
2,00:00:17,3,False,10,12,-2,25,3,14
2,00:00:34,2,False,7,6,1,52,10,14
1,00:07:12,2,False,0,0,0,32,5,14
2,00:07:13,0,True,6,7,-1,39,0,14
4,00:00:23,2,True,17,13,4,43,10,14
3,00:09:40,3,False,8,6,2,45,20,14
4,00:03:47,2,True,12,20,-8,43,2,14
1,00:13:02,2,False,0,0,0,28,10,14
2,00:00:01,2,True,4,9,-5,15,10,14
3,00:07:04,1,True,11,17,-6,28,20,14
1,00:03:32,3,True,0,16,-16,37,8,14
3,00:12:40,2,True,16,16,0,31,4,14
3,00:11:33,2,True,16,16,0,38,4,14
1,00:08:06,0,False,8,0,8,22,0,14
2,00:01:19,1,False,19,17,2,55,10,14
1,00:14:02,1,True,0,0,0,41,15,14
3,00:11:50,0,False,3,4,-1,39,0,14
2,00:12:59,0,False,10,3,7,52,0,14
2,00:05:04,0,False,6,7,-1,52,0,14
1,00:13:32,1,True,0,0,0,54,10,2
1,00:13:08,2,True,0,0,0,54,10,2
1,00:12:32,1,False,0,0,0,12,10,2
1,00:12:23,2,False,0,0,0,12,10,2
1,00:11:29,2,False,0,0,0,31,4,2
1,00:09:13,1,False,0,0,0,54,10,2
1,00:06:25,2,True,0,0,0,32,8,2
1,00:04:44,1,True,0,0,0,34,10,2
1,00:02:34,1,False,0,0,0,26,10,2
1,00:02:18,2,False,0,0,0,26,10,2
2,00:12:29,2,True,3,7,-4,34,6,2
2,00:08:16,1,False,7,3,4,50,10,2
2,00:04:42,2,False,7,3,4,55,12,2
2,00:03:54,1,True,3,7,-4,21,10,2
2,00:03:36,2,True,3,7,-4,21,10,2
2,00:02:46,1,False,7,3,4,55,10,2
2,00:00:16,1,False,14,3,11,54,10,2
3,00:12:20,1,True,3,14,-11,9,9,2
3,00:11:03,2,True,3,14,-11,5,5,2
3,00:08:54,1,True,3,17,-14,54,10,2
3,00:01:55,1,True,6,17,-11,30,10,2
4,00:11:19,3,False,24,6,18,6,6,2
4,00:01:40,1,True,6,24,-18,32,10,2
4,00:01:02,1,True,6,24,-18,44,10,2
4,00:00:51,1,True,6,24,-18,55,10,2
4,00:00:48,2,True,6,24,-18,55,10,2
4,00:00:25,3,True,6,24,-18,55,10,2
4,00:00:11,1,True,6,24,-18,49,10,2
4,00:00:07,2,True,6,24,-18,49,10,2
1,00:11:56,1,False,0,7,-7,51,15,2
1,00:10:28,1,True,7,0,7,50,20,2
1,00:10:08,2,True,7,0,7,40,20,2
1,00:07:10,2,True,7,0,7,26,8,2
1,00:04:04,2,True,7,3,4,44,4,2
1,00:01:11,1,True,7,3,4,24,10,2
1,00:00:49,2,True,7,3,4,24,10,2
1,00:00:10,1,True,7,6,1,27,10,2
2,00:15:00,2,True,7,6,1,27,10,2
2,00:13:43,1,True,7,6,1,47,10,2
2,00:13:23,2,True,7,6,1,47,10,2
2,00:12:18,1,True,7,13,-6,30,10,2
2,00:08:03,2,True,7,16,-9,34,9,2
2,00:06:39,2,False,16,7,9,46,7,2
2,00:04:28,1,False,16,7,9,43,10,2
2,00:04:16,2,False,16,7,9,43,10,2
2,00:02:33,1,False,16,7,9,43,10,2
2,00:02:11,2,False,16,7,9,43,10,2
2,00:01:39,1,False,16,7,9,30,10,2
2,00:01:02,2,False,16,10,6,44,1,2
2,00:00:44,1,True,10,16,-6,32,10,2
2,00:00:28,1,True,10,16,-6,25,10,2
3,00:09:33,1,True,12,23,-11,40,10,2
3,00:07:50,1,True,12,23,-11,45,10,2
3,00:07:21,2,True,12,23,-11,45,10,2
3,00:06:53,1,True,12,23,-11,9,10,2
3,00:06:42,2,True,12,23,-11,9,10,2
3,00:05:18,1,True,12,23,-11,7,7,2
3,00:05:03,2,True,12,23,-11,7,7,2
3,00:01:41,2,False,26,12,14,55,8,2
4,00:10:11,1,False,33,19,14,44,15,2
4,00:08:40,1,True,19,33,-14,33,10,2
4,00:07:45,1,True,19,33,-14,43,10,2
4,00:06:16,1,True,19,33,-14,53,10,2
4,00:04:09,1,False,33,26,7,35,10,2
4,00:03:50,2,False,33,26,7,35,10,2
4,00:02:52,1,True,26,33,-7,48,10,2
4,00:02:37,2,True,26,33,-7,48,10,2
4,00:02:19,1,False,33,26,7,29,10,2
4,00:01:01,2,True,26,33,-7,43,15,2
4,00:00:49,1,True,26,33,-7,17,10,2
1,00:14:26,2,True,0,0,0,50,8,2
1,00:11:54,1,True,0,0,0,50,10,2
1,00:07:26,2,True,7,0,7,49,4,2
1,00:04:12,2,True,7,0,7,28,13,2
1,00:02:19,1,True,7,0,7,13,10,2
1,00:01:55,2,True,7,0,7,13,10,2
1,00:00:34,2,True,7,0,7,46,16,2
2,00:02:56,1,True,14,7,7,47,10,2
2,00:02:37,2,True,14,7,7,47,10,2
2,00:01:04,2,False,7,14,-7,48,15,2
3,00:12:11,1,False,9,14,-5,27,10,2
4,00:14:10,1,False,16,21,-5,37,10,2
4,00:13:44,2,False,16,21,-5,37,10,2
4,00:11:52,1,True,22,16,6,49,10,2
4,00:10:41,1,True,22,16,6,18,10,2
4,00:00:43,1,True,29,19,10,2,2,2
1,00:01:55,2,False,3,7,-4,43,8,2
2,00:12:25,2,True,7,10,-3,45,6,2
2,00:08:53,2,True,7,11,-4,33,12,2
2,00:05:18,2,False,11,7,4,52,19,2
2,00:04:41,1,True,7,11,-4,19,10,2
2,00:01:40,2,True,14,11,3,30,1,2
2,00:01:04,2,False,11,14,-3,45,2,2
2,00:00:40,1,True,14,11,3,12,10,2
3,00:14:30,2,False,11,14,-3,40,7,2
3,00:02:40,1,True,14,14,0,46,10,2
3,00:02:27,2,True,14,14,0,46,10,2
3,00:00:57,1,False,14,21,-7,43,10,2
4,00:13:33,1,True,21,14,7,22,10,2
4,00:09:50,1,True,21,17,4,35,10,2
4,00:09:41,2,True,21,17,4,35,10,2
4,00:03:37,2,False,17,21,-4,30,7,2
4,00:02:07,2,True,24,17,7,27,4,2
4,00:01:56,1,True,24,17,7,15,10,2
4,00:00:12,1,False,31,24,7,53,10,2
1,00:12:53,2,True,0,0,0,55,5,2
2,00:12:56,1,True,7,3,4,35,10,2
2,00:07:34,2,False,10,7,3,47,8,2
2,00:04:53,2,True,7,10,-3,44,2,2
2,00:04:00,1,True,7,10,-3,18,10,2
2,00:02:17,1,True,7,10,-3,25,10,2
2,00:01:13,1,False,17,14,3,51,10,2
2,00:00:40,2,True,14,18,-4,39,1,2
3,00:08:28,2,False,18,21,-3,28,22,2
3,00:06:35,1,False,18,21,-3,40,10,2
3,00:06:23,2,False,18,21,-3,40,10,2
3,00:04:26,1,False,18,24,-6,46,10,2
3,00:04:05,2,False,18,24,-6,46,10,2
3,00:03:12,1,True,24,18,6,18,10,2
4,00:09:47,1,True,31,25,6,48,10,2
4,00:09:21,2,True,31,25,6,48,10,2
4,00:05:16,1,False,25,38,-13,42,10,2
4,00:05:05,2,False,25,38,-13,42,10,2
4,00:01:27,1,False,25,48,-23,39,10,2
1,00:14:20,2,True,0,0,0,37,7,2
1,00:13:32,1,False,0,0,0,42,10,2
1,00:13:12,2,False,0,0,0,42,10,2
1,00:12:32,1,True,0,0,0,48,10,2
1,00:12:16,2,True,0,0,0,48,10,2
1,00:06:27,2,False,0,0,0,31,4,2
1,00:03:44,2,True,3,0,3,50,10,2
1,00:03:07,1,True,3,0,3,14,10,2
2,00:13:12,1,False,7,3,4,30,10,2
2,00:10:37,2,False,7,10,-3,38,8,2
2,00:07:54,1,False,7,10,-3,28,10,2
2,00:06:46,1,False,7,10,-3,38,10,2
2,00:05:31,1,True,10,7,3,45,10,2
2,00:04:12,2,False,7,10,-3,38,0,2
3,00:14:12,2,False,17,17,0,43,8,2
3,00:13:31,1,True,17,17,0,21,10,2
3,00:11:47,2,False,17,17,0,40,8,2
3,00:09:17,2,True,17,17,0,46,8,2
3,00:05:45,1,True,17,17,0,18,15,2
3,00:03:36,2,True,17,20,-3,29,16,2
3,00:02:00,2,True,17,20,-3,12,5,2
4,00:09:59,1,False,26,20,6,35,10,2
4,00:06:06,1,False,26,20,6,24,10,2
4,00:04:49,1,False,26,20,6,39,10,2
4,00:01:42,2,True,27,26,1,39,4,2
4,00:01:01,2,True,27,29,-2,40,12,2
4,00:00:43,3,True,27,29,-2,40,12,2
1,00:10:20,2,False,0,7,-7,14,7,2
1,00:09:33,1,False,0,7,-7,34,10,2
1,00:02:09,2,False,0,17,-17,29,7,2
2,00:12:59,1,False,0,17,-17,40,10,2
2,00:11:47,1,True,17,0,17,55,10,2
2,00:11:06,2,True,17,0,17,45,20,2
2,00:10:22,1,False,0,17,-17,24,10,2
2,00:10:03,2,False,0,17,-17,24,10,2
2,00:06:36,1,True,17,0,17,13,10,2
2,00:04:36,1,True,17,7,10,21,10,2
2,00:01:44,1,True,17,7,10,42,10,2
2,00:01:11,1,False,7,17,-10,30,10,2
2,00:00:30,1,False,7,17,-10,53,10,2
2,00:00:18,2,False,7,17,-10,53,10,2
3,00:14:17,2,False,7,17,-10,7,2,2
3,00:13:43,1,False,7,20,-13,35,10,2
3,00:03:59,2,False,7,30,-23,20,19,2
3,00:01:12,1,True,30,7,23,53,10,2
4,00:14:23,1,False,7,30,-23,35,10,2
4,00:08:08,0,False,13,37,-24,5,0,2
4,00:03:48,1,True,37,20,17,33,10,2
4,00:02:56,1,True,37,27,10,53,10,2
4,00:02:11,1,True,37,34,3,27,10,2
4,00:01:40,2,True,37,34,3,40,8,2
4,00:00:59,2,False,34,37,-3,7,20,2
4,00:00:41,1,False,34,37,-3,50,10,2
4,00:00:27,3,True,37,34,3,53,3,2
1,00:09:54,1,False,0,1,-1,11,10,2
1,00:07:42,1,False,0,1,-1,27,10,2
1,00:05:45,1,False,0,1,-1,34,10,2
1,00:04:39,1,False,0,8,-8,25,10,2
2,00:11:59,2,True,8,0,8,5,5,2
2,00:09:26,2,True,8,3,5,45,10,2
2,00:03:04,1,False,10,8,2,32,10,2
2,00:02:30,1,False,10,8,2,44,10,2
2,00:01:16,2,True,8,17,-9,24,3,2
2,00:00:54,2,False,17,8,9,48,5,2
2,00:00:40,1,True,8,17,-9,26,10,2
3,00:05:10,2,False,17,8,9,46,6,2
4,00:12:51,1,True,8,20,-12,17,10,2
4,00:12:44,2,True,8,20,-12,17,10,2
4,00:12:08,1,False,20,8,12,46,10,2
4,00:10:40,2,True,8,20,-12,49,4,2
4,00:05:24,2,True,9,20,-11,40,8,2
4,00:00:30,1,True,9,20,-11,27,10,2
4,00:00:26,2,True,9,20,-11,27,10,2
1,00:14:33,2,False,0,0,0,38,7,2
1,00:14:07,1,True,0,0,0,37,10,2
1,00:13:50,2,True,0,0,0,37,10,2
1,00:12:40,2,False,0,0,0,38,2,2
1,00:11:37,2,True,0,0,0,36,6,2
1,00:10:51,1,False,0,0,0,13,10,2
1,00:09:20,2,False,0,0,0,31,8,2
1,00:07:16,2,False,0,0,0,43,8,2
1,00:06:38,1,False,0,0,0,15,10,2
1,00:01:14,1,True,2,0,2,32,10,2
1,00:00:03,1,True,2,7,-5,43,10,2
2,00:15:00,2,True,2,7,-5,43,10,2
2,00:13:21,2,False,7,2,5,25,18,2
2,00:11:50,1,False,7,2,5,15,10,2
2,00:10:11,2,False,7,9,-2,32,5,2
2,00:08:54,2,True,9,7,2,37,5,2
2,00:02:46,1,False,10,9,1,16,10,2
2,00:02:33,2,False,10,9,1,16,10,2
2,00:02:16,1,True,9,10,-1,48,10,2
2,00:01:36,1,False,10,9,1,47,10,2
2,00:01:32,2,False,10,9,1,47,10,2
2,00:01:08,2,True,9,10,-1,25,5,2
2,00:00:42,2,False,10,9,1,39,5,2
3,00:10:14,1,True,10,10,0,37,10,2
3,00:08:42,1,True,10,17,-7,18,10,2
3,00:08:23,2,True,10,17,-7,18,10,2
3,00:07:07,2,True,10,17,-7,52,6,2
3,00:02:27,2,False,17,17,0,46,5,2
3,00:00:45,2,True,17,17,0,39,11,2
4,00:07:20,1,False,17,17,0,53,10,2
4,00:03:03,1,False,20,17,3,29,10,2
4,00:02:15,2,False,20,24,-4,34,7,2
1,00:09:17,2,False,7,0,7,48,4,2
1,00:07:33,2,False,7,0,7,26,13,2
2,00:12:43,2,False,7,0,7,28,5,2
2,00:10:06,2,False,7,0,7,29,11,2
2,00:05:35,2,True,8,7,1,35,3,2
2,00:04:27,1,False,10,8,2,52,10,2
2,00:01:39,2,False,10,9,1,43,2,2
3,00:09:00,1,True,9,10,-1,39,20,2
3,00:04:39,1,True,9,13,-4,41,10,2
3,00:04:16,2,True,9,13,-4,41,10,2
3,00:03:05,1,False,13,9,4,46,10,2
4,00:13:20,1,True,9,16,-7,45,10,2
4,00:09:33,2,False,16,9,7,7,7,2
4,00:01:37,1,True,12,22,-10,48,10,2
4,00:01:30,2,True,12,22,-10,48,10,2
4,00:01:25,3,True,12,22,-10,48,10,2
1,00:14:20,2,False,0,0,0,45,6,2
1,00:08:14,2,False,0,3,-3,32,7,2
1,00:06:00,1,True,3,0,3,53,10,2
1,00:04:00,2,True,3,0,3,44,12,2
1,00:02:20,2,True,3,0,3,10,7,2
1,00:01:21,1,True,3,2,1,20,10,2
2,00:15:00,2,True,3,2,1,3,3,2
2,00:11:39,1,False,5,10,-5,32,10,2
2,00:11:28,2,False,5,10,-5,32,10,2
2,00:09:06,2,False,5,10,-5,25,3,2
2,00:07:35,1,False,5,10,-5,7,7,2
2,00:01:52,2,True,17,5,12,50,2,2
2,00:01:13,2,True,17,5,12,19,8,2
3,00:11:07,1,False,8,31,-23,33,10,2
3,00:10:50,2,False,8,31,-23,33,10,2
3,00:10:12,1,False,8,31,-23,47,10,2
3,00:08:53,2,False,8,31,-23,32,7,2
3,00:06:26,1,True,34,8,26,30,10,2
3,00:06:12,2,True,34,8,26,30,10,2
4,00:13:59,1,True,34,15,19,34,10,2
4,00:12:47,1,True,34,15,19,43,10,2
4,00:11:40,1,True,34,15,19,21,10,2
4,00:06:55,1,False,22,34,-12,14,10,2
4,00:02:59,1,False,22,37,-15,51,10,2
4,00:02:36,2,False,22,37,-15,51,10,2
1,00:14:53,1,False,0,0,0,38,10,2
1,00:08:11,1,True,7,1,6,50,10,2
1,00:03:48,2,False,1,7,-6,16,8,2
2,00:12:32,1,False,2,13,-11,35,10,2
2,00:10:53,1,True,13,2,11,36,10,2
2,00:09:30,2,True,13,2,11,24,11,2
2,00:06:56,2,True,13,2,11,49,4,2
2,00:02:23,2,True,13,2,11,12,4,2
2,00:01:52,1,True,13,5,8,42,10,2
2,00:01:49,2,True,13,5,8,42,10,2
2,00:01:34,1,False,5,13,-8,35,10,2
3,00:13:43,2,False,5,16,-11,39,15,2
3,00:13:15,1,True,16,5,11,21,10,2
3,00:13:02,2,True,16,5,11,21,10,2
3,00:11:43,1,True,16,5,11,29,10,2
3,00:11:20,2,True,16,5,11,29,10,2
3,00:08:27,1,False,8,16,-8,45,10,2
3,00:08:11,2,False,8,16,-8,45,10,2
3,00:03:56,1,True,23,21,2,5,10,2
3,00:03:18,1,True,23,21,2,35,10,2
3,00:03:04,2,True,23,21,2,35,10,2
3,00:01:13,1,True,23,28,-5,32,10,2
4,00:11:32,1,False,28,30,-2,52,10,2
4,00:06:17,1,True,30,30,0,35,10,2
1,00:13:59,2,False,0,0,0,45,4,2
1,00:12:48,1,True,0,0,0,40,10,2
1,00:00:50,2,False,0,7,-7,30,15,2
2,00:10:50,1,False,0,14,-14,45,10,2
2,00:08:40,2,False,0,14,-14,53,8,2
2,00:07:02,2,False,0,14,-14,10,6,2
2,00:04:22,1,False,0,14,-14,18,10,2
2,00:02:30,1,True,21,0,21,50,10,2
2,00:02:24,2,True,21,0,21,50,10,2
2,00:01:56,1,True,21,0,21,24,10,2
2,00:00:15,2,True,28,0,28,3,3,2
3,00:11:10,2,False,0,35,-35,29,8,2
3,00:10:10,1,False,0,38,-38,35,10,2
3,00:05:26,1,False,0,41,-41,35,10,2
3,00:04:12,1,False,0,41,-41,4,4,2
3,00:03:44,2,False,0,41,-41,4,4,2
3,00:02:27,2,False,0,44,-44,38,7,2
4,00:11:40,2,True,44,0,44,18,2,2
4,00:11:04,1,False,0,44,-44,54,10,2
4,00:10:53,2,False,0,44,-44,54,10,2
4,00:09:20,2,True,44,0,44,13,4,2
4,00:08:18,1,True,44,0,44,53,10,2
4,00:06:39,1,False,0,44,-44,49,10,2
4,00:01:36,2,False,0,52,-52,45,10,2
1,00:08:48,1,True,0,0,0,1,1,2
1,00:06:32,1,True,7,3,4,41,10,2
1,00:04:08,2,True,7,3,4,4,7,2
2,00:13:53,2,True,7,6,1,33,12,2
2,00:12:41,2,False,6,7,-1,53,10,2
2,00:11:50,1,True,7,6,1,22,10,2
2,00:11:30,2,True,7,6,1,22,10,2
2,00:08:44,2,False,9,7,2,46,5,2
2,00:07:57,1,True,7,9,-2,32,10,2
2,00:06:09,1,False,9,7,2,43,10,2
2,00:02:54,2,False,9,7,2,31,16,2
2,00:01:04,1,True,10,9,1,35,10,2
3,00:14:15,2,False,12,10,2,38,6,2
3,00:12:10,1,False,12,10,2,36,10,2
3,00:09:08,1,True,17,12,5,36,10,2
3,00:07:38,1,True,17,13,4,35,10,2
3,00:07:23,2,True,17,13,4,35,10,2
3,00:03:01,2,True,17,13,4,55,12,2
4,00:12:15,2,True,24,13,11,50,8,2
4,00:10:10,1,False,13,24,-11,45,10,2
4,00:03:37,1,True,25,13,12,40,10,2
4,00:03:19,2,True,25,13,12,40,10,2
4,00:03:00,3,True,25,13,12,40,10,2
4,00:02:02,1,False,13,25,-12,51,10,2
4,00:01:29,3,False,13,25,-12,53,14,2
4,00:00:41,1,True,25,13,12,26,10,2
1,00:11:03,2,False,0,7,-7,38,6,2
1,00:06:37,1,True,7,0,7,30,10,2
1,00:06:19,2,True,7,0,7,30,10,2
1,00:05:34,1,False,3,7,-4,53,10,2
1,00:04:50,1,True,7,3,4,47,10,2
1,00:00:38,1,True,7,10,-3,42,10,2
2,00:14:15,2,False,10,7,3,25,6,2
2,00:11:52,1,False,10,7,3,45,10,2
2,00:11:41,2,False,10,7,3,45,10,2
2,00:10:29,2,True,7,10,-3,23,6,2
2,00:09:52,1,False,10,7,3,42,10,2
2,00:07:56,2,True,7,11,-4,40,5,2
2,00:06:02,2,False,11,7,4,43,6,2
2,00:02:46,1,True,7,11,-4,36,10,2
2,00:02:09,1,True,7,14,-7,35,10,2
2,00:01:38,1,False,14,7,7,41,10,2
2,00:01:16,2,True,7,14,-7,54,5,2
3,00:14:05,1,True,7,14,-7,52,10,2
3,00:12:14,2,False,14,7,7,3,10,2
3,00:10:37,1,False,14,9,5,36,10,2
3,00:09:53,1,False,14,9,5,25,10,2
3,00:07:39,1,False,14,16,-2,36,10,2
3,00:01:10,1,True,23,14,9,20,10,2
4,00:11:29,2,False,21,23,-2,40,9,2
4,00:08:00,2,True,23,21,2,45,6,2
4,00:05:45,2,False,21,23,-2,29,3,2
4,00:02:20,1,True,23,24,-1,35,10,2
1,00:14:55,1,False,0,0,0,31,10,2
1,00:10:55,1,True,0,7,-7,40,10,2
1,00:10:46,2,True,0,7,-7,40,10,2
1,00:09:42,1,False,7,0,7,17,10,2
1,00:03:49,2,False,8,3,5,8,3,2
1,00:01:46,2,False,8,3,5,22,4,2
1,00:00:23,1,False,8,6,2,47,10,2
1,00:00:07,2,False,8,6,2,47,10,2
2,00:13:37,1,False,8,6,2,10,10,2
2,00:11:41,2,False,8,6,2,39,6,2
2,00:07:15,1,False,8,13,-5,50,10,2
2,00:06:50,2,False,8,13,-5,50,10,2
3,00:14:25,2,True,13,15,-2,31,4,2
3,00:13:30,1,False,15,13,2,37,10,2
3,00:10:35,1,True,13,15,-2,44,10,2
3,00:04:33,1,False,22,16,6,35,10,2
3,00:04:01,2,False,22,16,6,30,15,2
4,00:14:17,1,False,22,16,6,17,10,2
4,00:14:07,2,False,22,16,6,17,10,2
4,00:03:23,1,True,19,22,-3,25,10,2
4,00:02:19,2,True,19,22,-3,42,6,2
1,00:12:43,1,True,0,0,0,40,10,2
1,00:10:50,1,False,0,0,0,23,10,2
1,00:08:44,1,False,0,7,-7,51,10,2
1,00:08:19,2,False,0,7,-7,51,10,2
2,00:15:00,2,True,8,7,1,55,11,2
2,00:12:40,2,False,7,8,-1,40,1,2
2,00:05:03,1,True,8,14,-6,6,6,2
2,00:02:52,1,True,8,14,-6,51,10,2
2,00:01:13,1,True,8,14,-6,40,10,2
2,00:00:43,1,False,14,8,6,31,10,2
3,00:13:17,1,True,8,17,-9,55,20,2
3,00:12:13,1,False,17,8,9,34,10,2
3,00:05:36,2,True,15,17,-2,3,3,2
3,00:02:25,2,False,20,15,5,52,10,2
4,00:14:32,1,False,20,15,5,27,10,2
4,00:13:18,1,True,15,20,-5,37,15,2
4,00:12:56,2,True,15,20,-5,37,15,2
4,00:07:59,2,False,27,22,5,44,11,2
4,00:03:24,1,False,27,22,5,7,7,2
4,00:02:58,3,False,27,22,5,5,5,2
4,00:02:08,1,False,27,22,5,48,10,2
4,00:02:04,2,False,27,22,5,48,10,2
4,00:01:59,3,False,27,22,5,48,10,2
4,00:01:08,1,True,22,27,-5,46,10,2
4,00:00:34,2,False,27,22,5,38,4,2
4,00:00:24,1,False,27,22,5,31,10,2
4,00:00:12,1,False,27,22,5,10,10,2
1,00:07:01,1,False,0,7,-7,44,10,2
1,00:05:20,1,False,0,7,-7,6,6,2
1,00:04:21,1,False,0,10,-10,35,10,2
1,00:02:57,1,False,0,10,-10,27,10,2
2,00:11:03,1,False,0,17,-17,51,10,2
2,00:08:20,2,True,17,0,17,45,7,2
2,00:06:16,1,False,0,17,-17,51,10,2
2,00:04:40,1,True,17,0,17,17,10,2
2,00:04:15,2,True,17,0,17,17,10,2
2,00:02:22,2,True,17,0,17,10,5,2
3,00:12:50,2,False,3,24,-21,46,8,2
3,00:08:31,1,True,24,3,21,15,10,2
3,00:07:36,1,True,24,3,21,13,10,2
3,00:07:20,2,True,24,3,21,13,10,2
3,00:03:37,1,True,24,3,21,35,10,2
3,00:03:13,2,True,24,3,21,35,10,2
4,00:10:15,2,True,25,4,21,15,10,2
4,00:07:04,2,False,7,25,-18,44,13,2
4,00:06:08,2,True,25,7,18,18,4,2
4,00:00:01,2,False,7,25,-18,21,4,2
1,00:14:42,1,False,0,0,0,41,10,2
1,00:14:22,2,False,0,0,0,41,10,2
1,00:09:07,1,False,14,0,14,32,10,2
1,00:03:35,1,False,14,3,11,21,10,2
1,00:01:11,2,False,14,10,4,36,3,2
1,00:00:07,1,False,14,10,4,47,10,2
2,00:15:00,2,False,14,10,4,47,10,2
2,00:13:13,2,True,11,14,-3,54,5,2
2,00:11:12,1,True,11,14,-3,18,10,2
2,00:06:03,2,True,11,20,-9,36,8,2
2,00:04:38,2,False,20,11,9,8,11,2
2,00:03:56,1,True,13,20,-7,47,10,2
2,00:03:30,2,True,13,20,-7,47,10,2
3,00:12:37,2,False,23,20,3,31,8,2
3,00:00:14,2,False,24,33,-9,53,7,2
4,00:14:13,2,True,33,24,9,17,6,2
4,00:13:20,1,True,33,24,9,53,10,2
4,00:13:10,2,True,33,24,9,53,10,2
4,00:12:28,1,True,33,24,9,2,10,2
4,00:12:01,2,True,33,24,9,2,10,2
4,00:10:59,1,True,33,24,9,42,10,2
4,00:08:10,1,False,31,33,-2,29,15,2
4,00:01:49,2,True,33,34,-1,29,9,2
4,00:01:41,1,True,33,37,-4,35,10,2
4,00:01:31,3,True,33,37,-4,43,2,2
4,00:00:25,1,True,33,38,-5,35,10,2
1,00:09:45,2,True,0,8,-8,48,6,2
1,00:07:20,2,True,0,8,-8,41,17,2
1,00:04:30,2,False,11,0,11,50,8,2
1,00:02:43,2,False,11,0,11,7,13,2
1,00:01:54,1,False,11,0,11,42,10,2
1,00:01:14,1,False,11,0,11,26,10,2
1,00:00:40,2,False,11,0,11,26,10,2
2,00:15:00,1,False,11,3,8,35,10,2
2,00:13:32,2,False,11,3,8,14,11,2
2,00:12:42,2,False,11,3,8,31,4,2
2,00:12:06,1,True,3,11,-8,20,10,2
2,00:11:45,2,True,3,11,-8,20,10,2
2,00:10:59,1,False,11,3,8,38,10,2
2,00:09:56,1,True,3,11,-8,47,10,2
2,00:04:11,1,False,11,10,1,12,10,2
2,00:03:48,2,False,11,10,1,12,10,2
2,00:02:47,1,False,11,13,-2,47,10,2
2,00:02:10,1,False,11,20,-9,51,10,2
2,00:01:31,1,True,20,12,8,35,10,2
2,00:01:18,1,False,12,20,-8,49,10,2
3,00:14:33,2,True,20,12,8,44,6,2
3,00:13:28,2,False,12,20,-8,32,5,2
3,00:12:42,1,True,20,12,8,22,10,2
3,00:07:33,2,False,12,23,-11,20,25,2
3,00:00:01,2,True,23,12,11,27,9,2
4,00:14:16,1,True,23,15,8,30,15,2
4,00:13:54,2,True,23,15,8,30,15,2
4,00:12:50,1,True,23,15,8,49,10,2
4,00:10:25,1,True,23,23,0,34,10,2
4,00:06:46,1,True,23,30,-7,47,10,2
4,00:06:00,2,True,23,30,-7,37,20,2
1,00:14:20,1,True,0,0,0,50,10,2
1,00:13:07,1,False,0,0,0,8,8,2
1,00:09:18,2,False,7,7,0,40,8,2
1,00:03:56,1,True,8,14,-6,39,10,2
1,00:03:42,2,True,8,14,-6,39,10,2
2,00:12:32,1,True,15,21,-6,50,10,2
2,00:11:19,1,True,15,21,-6,35,10,2
2,00:09:57,1,True,15,21,-6,14,10,2
2,00:09:29,2,True,15,21,-6,14,10,2
2,00:07:45,1,False,24,22,2,29,10,2
3,00:14:49,1,False,31,25,6,48,10,2
3,00:13:06,2,True,25,31,-6,33,8,2
3,00:11:41,1,False,34,25,9,25,10,2
3,00:05:36,2,True,32,34,-2,27,7,2
3,00:01:55,2,True,32,34,-2,54,9,2
4,00:15:00,1,False,34,32,2,43,10,2
4,00:13:20,2,True,32,34,-2,46,3,2
4,00:12:03,1,True,32,34,-2,21,15,2
4,00:08:52,1,False,34,32,2,40,10,2
4,00:08:33,2,False,34,32,2,40,10,2
4,00:05:46,1,False,34,32,2,10,10,2
4,00:01:03,2,True,39,34,5,42,7,2
4,00:00:03,1,True,39,34,5,8,5,2
1,00:14:26,2,False,0,0,0,42,5,2
1,00:13:20,2,False,0,0,0,9,7,2
1,00:10:18,1,False,0,2,-2,16,10,2
1,00:07:11,1,False,0,5,-5,40,15,2
1,00:06:46,2,False,0,5,-5,40,15,2
1,00:02:30,2,False,0,5,-5,29,15,2
1,00:00:56,2,True,5,0,5,49,7,2
2,00:10:12,2,False,0,5,-5,36,7,2
2,00:01:53,2,True,15,0,15,49,4,2
2,00:00:39,2,False,0,15,-15,36,1,2
3,00:12:44,1,True,15,0,15,42,10,2
3,00:12:32,2,True,15,0,15,42,10,2
3,00:11:27,2,False,0,15,-15,22,4,2
3,00:09:29,1,False,0,15,-15,39,10,2
3,00:06:31,1,True,15,0,15,26,10,2
3,00:02:06,2,True,15,7,8,46,5,2
4,00:13:57,2,False,7,22,-15,31,12,2
4,00:11:02,1,False,7,22,-15,15,10,2
4,00:02:19,1,True,36,14,22,50,10,2
4,00:01:22,2,True,36,14,22,21,25,2
4,00:01:03,2,False,14,36,-22,53,7,2
4,00:00:51,3,False,14,36,-22,53,7,2
1,00:13:45,1,True,0,0,0,49,10,2
1,00:07:20,1,True,7,0,7,44,10,2
1,00:04:16,1,False,0,7,-7,12,10,2
1,00:03:12,1,False,0,14,-14,28,10,2
1,00:02:52,2,False,0,14,-14,28,10,2
1,00:00:45,2,False,0,16,-16,46,3,2
2,00:05:48,1,False,6,23,-17,17,10,2
2,00:02:12,2,False,6,24,-18,22,23,2
2,00:01:54,1,False,6,24,-18,14,10,2
2,00:01:23,1,False,6,31,-25,53,10,2
2,00:00:56,2,False,6,31,-25,53,10,2
3,00:13:10,1,True,31,6,25,53,10,2
3,00:11:34,1,True,31,6,25,17,10,2
3,00:00:30,2,False,21,38,-17,55,16,2
4,00:14:35,2,True,38,21,17,37,6,2
4,00:11:57,1,True,38,21,17,27,10,2
4,00:11:12,2,True,38,21,17,32,15,2
4,00:10:25,1,True,38,24,14,45,10,2
4,00:01:25,1,True,44,24,20,52,10,2
4,00:01:09,1,True,44,24,20,40,10,2
4,00:00:36,1,True,44,24,20,35,20,2
1,00:11:56,1,False,0,0,0,35,10,2
1,00:08:29,1,False,0,7,-7,43,15,2
1,00:06:05,1,True,7,0,7,30,15,2
1,00:04:50,1,False,0,7,-7,40,10,2
2,00:11:42,1,False,0,17,-17,33,10,2
2,00:10:07,1,False,0,20,-20,49,10,2
2,00:08:08,1,True,20,0,20,3,3,2
2,00:06:26,2,True,20,3,17,36,9,2
2,00:02:47,2,True,20,3,17,11,6,2
2,00:02:26,1,True,20,4,16,35,10,2
3,00:09:01,1,True,27,11,16,46,10,2
3,00:03:30,1,True,27,11,16,34,10,2
4,00:13:52,2,True,27,14,13,39,6,2
4,00:10:30,2,True,27,17,10,20,4,2
4,00:02:43,2,False,24,27,-3,27,9,2
4,00:02:13,1,False,24,27,-3,23,10,2
4,00:02:08,2,False,24,27,-3,23,10,2
4,00:01:15,1,False,24,27,-3,29,10,2
4,00:01:10,2,False,24,27,-3,29,10,2
4,00:00:44,1,True,27,24,3,10,10,2
4,00:00:31,2,True,27,24,3,10,10,2
5,00:00:00,1,False,35,27,8,35,10,2
5,00:00:00,3,False,35,27,8,54,29,2
1,00:14:54,1,False,0,0,0,36,10,2
2,00:14:41,1,False,14,0,14,53,10,2
2,00:14:16,2,False,14,0,14,53,10,2
2,00:12:56,1,True,0,14,-14,19,10,2
2,00:10:56,2,True,0,14,-14,44,3,2
2,00:09:40,1,False,15,0,15,29,10,2
2,00:08:35,1,False,15,0,15,17,10,2
2,00:08:16,2,False,15,0,15,17,10,2
2,00:07:10,2,False,15,1,14,38,7,2
2,00:03:47,2,False,15,1,14,48,12,2
2,00:01:27,2,True,1,15,-14,29,18,2
2,00:01:00,1,True,1,15,-14,53,10,2
3,00:14:20,2,True,1,22,-21,17,3,2
3,00:08:26,1,False,36,1,35,33,10,2
3,00:08:00,2,False,36,1,35,33,10,2
3,00:04:36,2,False,36,4,32,43,14,2
3,00:03:20,2,False,36,4,32,10,7,2
3,00:00:47,1,True,6,36,-30,37,10,2
4,00:14:06,2,True,6,36,-30,17,9,2
4,00:09:00,1,True,6,39,-33,44,10,2
4,00:07:21,1,False,39,6,33,19,10,2
4,00:05:03,1,False,39,12,27,17,10,2
4,00:04:42,2,False,39,12,27,17,10,2
4,00:04:20,3,False,39,12,27,17,10,2
4,00:01:58,1,False,39,12,27,45,10,2
4,00:01:53,2,False,39,12,27,45,10,2
4,00:01:43,1,False,39,12,27,30,10,2
4,00:01:38,2,False,39,12,27,30,10,2
4,00:00:39,2,False,39,15,24,48,7,2
1,00:12:19,2,True,0,0,0,46,9,2
1,00:08:59,2,False,0,0,0,8,8,2
1,00:05:31,2,True,3,0,3,21,6,2
1,00:04:22,2,True,3,0,3,19,7,2
1,00:03:21,1,False,0,3,-3,54,10,2
1,00:03:17,2,False,0,3,-3,54,10,2
2,00:10:55,1,False,7,3,4,44,10,2
2,00:07:44,2,True,3,7,-4,46,14,2
2,00:00:24,1,True,3,8,-5,43,10,2
3,00:09:32,1,False,8,3,5,23,10,2
3,00:09:16,2,False,8,3,5,23,10,2
3,00:05:40,1,True,3,8,-5,23,10,2
3,00:02:30,2,False,8,3,5,42,9,2
4,00:13:00,1,True,4,8,-4,47,10,2
4,00:09:59,1,False,9,4,5,20,10,2
4,00:09:47,2,False,9,4,5,20,10,2
4,00:07:26,1,True,4,9,-5,15,10,2
4,00:04:51,2,True,4,16,-12,33,17,2
4,00:03:55,2,False,16,4,12,45,6,2
4,00:01:48,2,False,16,11,5,53,11,2
4,00:01:17,1,True,11,16,-5,30,10,2
1,00:14:17,2,False,0,0,0,38,8,2
1,00:12:59,1,True,0,0,0,45,10,2
1,00:12:04,1,False,0,0,0,51,10,2
1,00:11:48,2,False,0,0,0,51,10,2
1,00:00:14,1,False,0,7,-7,11,10,2
2,00:09:53,2,False,0,10,-10,26,8,2
2,00:05:41,2,True,13,0,13,35,7,2
2,00:03:38,1,True,13,3,10,40,10,2
2,00:02:27,1,False,3,13,-10,33,10,2
2,00:01:18,1,False,3,14,-11,47,10,2
2,00:01:13,2,False,3,14,-11,47,10,2
2,00:00:49,1,True,14,3,11,21,10,2
2,00:00:44,2,True,14,3,11,21,10,2
2,00:00:17,2,True,14,3,11,50,4,2
3,00:14:51,1,True,14,3,11,27,10,2
3,00:12:34,2,False,3,14,-11,43,15,2
3,00:07:16,2,False,3,14,-11,19,1,2
3,00:06:00,2,False,3,14,-11,17,12,2
3,00:03:57,2,False,3,17,-14,50,9,2
3,00:00:25,2,True,17,3,14,5,5,2
4,00:03:40,2,False,9,24,-15,48,3,2
4,00:03:00,2,False,9,24,-15,48,9,2
4,00:02:26,1,False,9,24,-15,19,10,2
4,00:01:49,1,True,24,9,15,44,10,2
1,00:06:54,2,False,7,0,7,9,7,2
1,00:05:17,1,False,7,3,4,46,10,2
1,00:05:05,2,False,7,3,4,46,10,2
1,00:03:42,2,True,3,7,-4,9,10,2
2,00:04:18,2,True,11,14,-3,39,1,2
2,00:02:26,1,False,14,11,3,24,10,2
2,00:01:56,2,False,14,11,3,29,15,2
2,00:00:32,1,True,14,14,0,26,10,2
2,00:00:01,1,True,14,21,-7,50,10,2
3,00:11:08,2,False,21,17,4,36,1,2
3,00:06:44,1,False,21,17,4,21,10,2
3,00:06:09,2,False,21,17,4,21,10,2
3,00:03:29,2,False,21,20,1,48,7,2
4,00:12:08,2,False,21,28,-7,39,4,2
4,00:05:02,1,False,21,35,-14,33,10,2
4,00:00:18,1,True,36,21,15,34,10,2
1,00:03:38,1,False,16,7,9,25,10,2
1,00:02:46,2,False,16,7,9,20,15,2
1,00:02:04,1,False,16,7,9,51,10,2
2,00:12:19,1,True,7,16,-9,22,10,2
2,00:07:20,1,False,16,7,9,32,10,2
2,00:07:03,2,False,16,7,9,32,10,2
2,00:05:37,2,False,16,10,6,35,10,2
2,00:04:13,2,False,16,10,6,52,7,2
2,00:03:17,1,False,16,10,6,14,10,2
2,00:01:40,2,False,16,10,6,19,3,2
2,00:01:08,1,False,16,13,3,45,10,2
2,00:00:50,2,False,16,13,3,45,10,2
3,00:13:47,2,True,13,16,-3,47,11,2
3,00:12:39,2,False,16,13,3,10,11,2
3,00:11:33,1,True,13,16,-3,48,10,2
3,00:09:57,1,True,13,16,-3,5,10,2
3,00:07:03,1,True,13,23,-10,38,10,2
3,00:06:22,2,True,13,23,-10,38,10,2
3,00:00:10,2,True,13,23,-10,41,10,2
4,00:09:22,1,True,13,30,-17,30,10,2
4,00:04:04,1,True,20,30,-10,44,5,2
4,00:03:01,2,False,30,20,10,43,2,2
4,00:01:08,1,True,20,30,-10,48,10,2
1,00:14:06,1,False,0,0,0,28,20,2
1,00:06:42,2,False,0,0,0,18,10,2
1,00:00:18,2,False,7,3,4,10,4,2
2,00:13:54,2,False,7,10,-3,39,3,2
2,00:10:26,2,False,7,10,-3,43,8,2
2,00:08:54,1,False,7,10,-3,54,10,2
2,00:05:33,1,True,10,7,3,46,10,2
2,00:03:12,1,True,10,7,3,25,10,2
2,00:02:43,2,True,10,7,3,25,10,2
2,00:02:15,2,True,10,10,0,43,5,2
3,00:09:51,1,True,13,16,-3,42,10,2
3,00:00:23,2,False,19,13,6,5,20,2
4,00:13:35,1,True,15,19,-4,55,10,2
4,00:12:56,2,True,15,19,-4,55,10,2
4,00:09:42,2,False,19,22,-3,25,12,2
4,00:07:00,2,False,19,22,-3,27,5,2
4,00:05:53,1,False,19,25,-6,30,15,2
4,00:05:32,2,False,19,25,-6,30,15,2
4,00:04:57,1,True,25,19,6,47,10,2
4,00:03:33,1,False,19,25,-6,53,10,2
1,00:09:34,2,False,0,3,-3,51,8,2
2,00:13:57,2,False,7,11,-4,49,8,2
2,00:07:15,1,True,11,14,-3,22,10,2
2,00:02:50,1,True,11,14,-3,5,10,2
2,00:02:06,2,True,11,14,-3,26,9,2
2,00:01:49,1,False,14,11,3,39,10,2
2,00:01:41,2,False,14,11,3,39,10,2
2,00:01:26,1,True,11,14,-3,34,10,2
3,00:11:38,2,True,14,21,-7,44,6,2
3,00:09:07,2,True,14,22,-8,47,8,2
3,00:04:21,2,False,29,14,15,52,6,2
4,00:08:18,1,True,21,32,-11,29,10,2
4,00:08:06,2,True,21,32,-11,29,10,2
4,00:03:24,2,True,21,32,-11,42,5,2
4,00:03:11,3,True,21,32,-11,42,5,2
4,00:01:52,1,True,21,39,-18,22,10,2
4,00:01:11,1,False,39,21,18,38,10,2
4,00:01:06,2,False,39,21,18,38,10,2
1,00:14:53,1,True,0,0,0,27,10,2
1,00:13:31,1,True,0,0,0,53,10,2
1,00:13:25,2,True,0,0,0,53,10,2
1,00:07:08,1,False,7,3,4,27,10,2
1,00:03:19,2,False,7,10,-3,41,8,2
1,00:02:05,2,True,10,7,3,52,8,2
2,00:15:00,2,False,7,11,-4,50,5,2
2,00:13:11,1,False,8,11,-3,37,10,2
2,00:10:30,1,False,8,11,-3,6,6,2
2,00:08:46,1,False,8,18,-10,45,10,2
2,00:01:13,1,True,18,15,3,38,10,2
3,00:12:33,1,False,15,25,-10,28,10,2
3,00:04:31,2,True,25,22,3,33,3,2
3,00:00:30,1,True,25,25,0,44,30,2
4,00:13:07,1,False,25,25,0,36,10,2
4,00:11:28,2,True,25,25,0,31,10,2
4,00:07:32,1,True,25,32,-7,38,10,2
4,00:05:10,2,False,32,25,7,27,7,2
4,00:04:10,2,False,32,26,6,40,5,2
4,00:02:56,1,True,26,32,-6,37,10,2
1,00:14:53,1,False,0,0,0,39,10,2
1,00:14:33,2,False,0,0,0,39,10,2
1,00:08:53,1,False,0,0,0,30,10,2
1,00:04:38,2,True,7,0,7,40,10,2
2,00:12:15,1,True,7,3,4,36,10,2
2,00:11:10,1,True,7,3,4,22,10,2
2,00:09:40,2,True,7,6,1,39,6,2
2,00:01:25,2,False,13,7,6,52,16,2
3,00:14:31,2,True,7,13,-6,42,5,2
3,00:12:27,1,False,13,7,6,52,10,2
3,00:07:38,1,False,16,7,9,52,10,2
3,00:01:28,1,True,7,19,-12,35,10,2
4,00:15:00,2,True,7,19,-12,52,4,2
4,00:09:46,2,False,19,7,12,43,2,2
4,00:09:23,3,False,19,7,12,43,2,2
4,00:05:47,1,True,7,19,-12,46,10,2
4,00:03:00,2,False,19,14,5,33,9,2
4,00:00:47,1,True,14,22,-8,35,10,2
4,00:00:42,2,True,14,22,-8,35,10,2
1,00:03:44,2,False,15,7,8,32,10,2
1,00:00:46,1,True,7,15,-8,55,10,2
1,00:00:25,2,True,7,15,-8,55,10,2
2,00:12:40,2,True,7,15,-8,42,7,2
2,00:10:53,2,True,7,15,-8,29,7,2
2,00:10:10,1,False,15,7,8,47,10,2
2,00:08:45,1,True,7,15,-8,8,10,2
2,00:06:09,2,True,7,15,-8,27,9,2
2,00:03:37,1,True,7,25,-18,25,10,2
2,00:02:31,2,True,7,25,-18,45,4,2
2,00:01:21,1,False,33,7,26,35,10,2
2,00:00:58,1,False,33,14,19,37,10,2
2,00:00:15,1,True,14,33,-19,50,10,2
3,00:09:29,2,True,14,40,-26,34,10,2
3,00:08:12,2,False,40,14,26,40,11,2
3,00:07:00,2,True,14,40,-26,26,4,2
4,00:15:00,2,True,14,47,-33,8,15,2
4,00:13:10,1,True,14,47,-33,35,10,2
4,00:10:48,2,True,14,47,-33,5,3,2
4,00:08:22,2,False,50,14,36,39,10,2
4,00:06:52,1,False,50,14,36,23,10,2
4,00:06:30,2,False,50,14,36,23,10,2
4,00:04:34,2,False,50,17,33,55,5,2
4,00:03:23,2,True,17,50,-33,9,6,2
4,00:01:50,2,True,17,50,-33,30,10,2
4,00:01:20,2,True,17,53,-36,41,4,2
1,00:11:15,1,False,0,7,-7,44,10,2
1,00:11:06,2,False,0,7,-7,44,10,2
1,00:02:56,1,False,0,7,-7,37,10,2
1,00:02:32,2,False,0,7,-7,37,10,2
1,00:01:04,1,False,0,8,-8,47,10,2
1,00:00:49,2,False,0,8,-8,47,10,2
2,00:01:20,1,False,13,9,4,18,10,2
3,00:14:25,2,False,13,13,0,33,12,2
3,00:12:24,1,False,13,14,-1,35,10,2
3,00:10:10,2,True,14,13,1,55,10,2
3,00:08:54,2,False,13,14,-1,24,5,2
3,00:07:20,1,False,13,14,-1,24,10,2
3,00:05:10,2,False,13,17,-4,31,14,2
3,00:01:59,1,False,13,17,-4,47,10,2
3,00:01:44,2,False,13,17,-4,47,10,2
4,00:12:17,1,False,13,18,-5,35,10,2
4,00:02:24,2,True,25,20,5,45,10,2
1,00:14:22,2,True,0,0,0,50,11,2
1,00:10:30,1,False,0,0,0,39,15,2
1,00:01:45,2,False,0,3,-3,47,6,2
2,00:13:16,1,True,3,0,3,48,10,2
2,00:06:11,1,True,3,0,3,47,15,2
2,00:04:15,2,False,0,3,-3,38,2,2
2,00:01:19,1,True,3,0,3,18,10,2
3,00:09:31,2,True,3,8,-5,47,8,2
4,00:14:26,2,True,3,15,-12,41,12,2
4,00:12:17,1,True,3,15,-12,23,10,2
4,00:06:39,2,True,3,15,-12,52,7,2
4,00:06:07,1,True,3,15,-12,9,10,2
4,00:02:32,1,False,17,3,14,38,10,2
4,00:00:01,3,True,3,17,-14,41,26,2
1,00:13:56,1,False,0,0,0,41,10,2
1,00:13:21,2,False,0,0,0,41,10,2
1,00:11:15,1,False,0,0,0,53,10,2
1,00:05:14,2,False,0,0,0,17,9,2
1,00:03:48,2,False,0,1,-1,29,16,2
2,00:06:19,1,False,14,1,13,52,10,2
2,00:02:33,1,True,1,14,-13,44,10,2
2,00:02:15,1,True,1,14,-13,39,10,2
2,00:00:52,2,False,17,1,16,20,4,2
3,00:14:28,2,False,17,4,13,31,7,2
3,00:13:29,1,True,4,17,-13,47,10,2
3,00:09:04,1,True,4,20,-16,38,10,2
3,00:08:46,2,True,4,20,-16,38,10,2
3,00:02:05,1,False,27,4,23,54,10,2
4,00:12:10,2,True,11,34,-23,35,5,2
4,00:11:36,1,False,34,11,23,21,10,2
4,00:09:32,1,False,34,11,23,51,20,2
4,00:07:32,1,False,35,11,24,44,10,2
4,00:06:15,1,False,35,11,24,16,10,2
4,00:05:08,3,False,35,11,24,15,9,2
4,00:00:26,1,False,35,11,24,37,10,2
1,00:14:08,1,True,0,0,0,38,10,2
1,00:03:58,2,False,7,3,4,50,4,2
2,00:07:03,1,True,6,14,-8,28,10,2
2,00:06:49,2,True,6,14,-8,28,10,2
3,00:02:04,2,False,31,6,25,24,9,2
3,00:00:11,2,False,31,6,25,15,10,2
4,00:14:48,1,False,31,9,22,35,10,2
4,00:02:25,3,False,35,9,26,11,10,2
1,00:13:42,1,True,0,0,0,42,10,2
1,00:13:31,2,True,0,0,0,42,10,2
1,00:12:15,2,False,0,0,0,51,6,2
1,00:10:56,1,False,0,0,0,42,10,2
1,00:08:28,1,False,0,0,0,25,10,2
1,00:06:27,1,False,0,0,0,53,10,2
2,00:14:36,1,True,1,1,0,1,10,2
2,00:14:24,2,True,1,1,0,1,10,2
2,00:09:56,2,True,1,3,-2,40,8,2
2,00:07:07,2,True,1,3,-2,11,7,2
2,00:06:17,1,False,3,1,2,50,10,2
2,00:03:15,2,True,1,3,-2,55,8,2
2,00:02:13,2,False,3,1,2,32,7,2
2,00:01:32,2,True,1,3,-2,45,16,2
2,00:00:55,2,False,3,1,2,18,15,2
2,00:00:13,2,False,3,1,2,25,2,2
3,00:13:20,2,True,4,3,1,54,7,2
3,00:10:42,1,False,4,4,0,6,10,2
3,00:08:46,2,False,4,4,0,19,7,2
3,00:05:03,2,False,4,4,0,49,1,2
3,00:04:14,1,False,4,4,0,50,10,2
3,00:03:48,2,False,4,4,0,50,10,2
3,00:00:01,1,True,11,4,7,35,10,2
4,00:15:00,2,True,11,4,7,35,10,2
4,00:12:40,1,True,11,4,7,24,10,2
4,00:08:15,1,False,11,14,-3,52,10,2
4,00:06:53,1,True,14,12,2,35,10,2
4,00:06:39,2,True,14,12,2,35,10,2
4,00:06:00,1,False,12,14,-2,43,10,2
4,00:05:37,2,False,12,14,-2,43,10,2
4,00:02:36,2,False,12,14,-2,12,7,2
4,00:00:36,1,True,17,12,5,43,10,2
4,00:00:29,2,True,17,12,5,43,10,2
1,00:14:10,2,False,0,0,0,37,9,2
1,00:13:13,2,True,0,0,0,38,7,2
1,00:06:53,2,True,0,7,-7,35,11,2
1,00:04:09,1,False,10,0,10,52,10,2
2,00:13:37,1,True,0,24,-24,50,10,2
2,00:11:40,1,False,24,0,24,34,10,2
2,00:10:58,1,False,24,0,24,20,10,2
2,00:10:23,2,False,24,0,24,20,10,2
2,00:08:52,2,False,24,3,21,50,8,2
2,00:01:43,2,False,24,10,14,33,3,2
2,00:00:21,1,False,24,13,11,10,10,2
2,00:00:02,0,True,19,24,-5,5,0,2
3,00:10:55,2,False,24,19,5,21,11,2
3,00:08:25,2,False,24,22,2,51,10,2
3,00:06:36,1,False,24,22,2,44,10,2
3,00:04:57,0,True,28,24,4,5,0,2
3,00:00:01,1,False,24,35,-11,33,10,2
4,00:15:00,2,False,24,35,-11,33,10,2
4,00:14:24,1,True,35,24,11,40,10,2
4,00:10:25,2,True,35,24,11,19,5,2
4,00:09:50,1,True,35,27,8,35,10,2
4,00:04:01,1,False,27,38,-11,30,10,2
4,00:03:37,2,False,27,38,-11,30,10,2
4,00:02:37,2,True,38,27,11,46,6,2
4,00:02:22,1,False,27,38,-11,28,10,2
4,00:02:11,3,False,27,38,-11,36,2,2
1,00:03:13,2,False,3,0,3,43,6,2
1,00:01:03,1,True,0,3,-3,35,10,2
2,00:13:58,1,False,3,0,3,29,10,2
2,00:13:37,2,False,3,0,3,29,10,2
2,00:12:56,1,False,3,3,0,35,10,2
2,00:09:55,1,False,3,3,0,25,10,2
2,00:01:32,2,False,10,10,0,45,2,2
3,00:01:32,1,True,24,10,14,28,10,2
4,00:11:21,1,False,13,24,-11,34,10,2
4,00:10:16,1,False,13,24,-11,55,10,2
4,00:08:50,2,False,13,24,-11,36,6,2
4,00:01:26,1,True,31,14,17,12,10,2
1,00:11:07,2,True,0,0,0,5,5,2
1,00:09:30,2,True,0,3,-3,53,8,2
1,00:08:23,2,False,3,0,3,26,9,2
1,00:07:33,1,True,0,3,-3,43,10,2
1,00:06:53,1,True,0,3,-3,55,10,2
1,00:04:20,1,False,3,0,3,9,10,2
1,00:04:09,2,False,3,0,3,9,10,2
1,00:03:27,1,False,3,0,3,51,10,2
1,00:01:43,2,False,3,0,3,32,9,2
2,00:14:35,1,False,3,1,2,35,10,2
2,00:12:27,1,False,3,1,2,52,10,2
2,00:09:15,1,False,3,1,2,50,10,2
2,00:04:31,1,True,2,3,-1,20,10,2
2,00:01:25,1,False,6,2,4,33,10,2
2,00:01:13,2,False,6,2,4,28,5,2
2,00:00:23,1,False,6,2,4,37,10,2
3,00:14:54,1,False,6,9,-3,28,10,2
3,00:14:30,2,False,6,9,-3,28,10,2
3,00:02:00,1,True,12,21,-9,47,10,2
3,00:01:40,2,True,12,21,-9,47,10,2
3,00:00:40,2,False,21,12,9,20,3,2
4,00:13:09,2,False,21,12,9,26,9,2
4,00:11:07,1,False,21,12,9,35,10,2
4,00:10:53,2,False,21,12,9,35,10,2
4,00:08:42,2,True,15,21,-6,54,8,2
4,00:05:51,2,True,15,21,-6,30,6,2
4,00:03:27,2,True,15,21,-6,41,6,2
4,00:02:14,1,False,21,15,6,47,10,2
4,00:01:53,2,False,21,15,6,47,10,2
4,00:01:26,1,True,15,21,-6,47,10,2
4,00:01:12,2,True,15,21,-6,47,10,2
4,00:00:26,1,True,22,21,1,50,10,2
4,00:00:21,2,True,22,21,1,50,10,2
1,00:14:11,1,False,0,0,0,21,10,2
1,00:13:46,2,False,0,0,0,21,10,2
1,00:11:18,2,False,0,0,0,40,11,2
1,00:09:49,1,True,0,0,0,50,10,2
1,00:09:47,2,True,0,0,0,50,10,2
1,00:09:07,1,False,0,0,0,26,10,2
1,00:06:28,2,True,0,0,0,41,5,2
1,00:00:01,1,False,0,0,0,6,6,2
2,00:15:00,2,False,0,0,0,6,6,2
2,00:10:10,1,False,0,3,-3,37,10,2
2,00:03:00,1,False,0,13,-13,47,10,2
2,00:02:11,1,True,13,0,13,46,10,2
2,00:02:05,2,True,13,0,13,46,10,2
2,00:01:19,1,False,0,13,-13,29,10,2
2,00:00:45,1,False,0,13,-13,15,10,2
3,00:12:18,2,False,0,16,-16,22,11,2
3,00:10:41,2,True,16,0,16,54,22,2
3,00:09:36,2,True,16,0,16,24,5,2
3,00:05:51,1,True,16,0,16,45,10,2
3,00:05:22,2,True,16,0,16,45,10,2
4,00:10:57,1,False,0,30,-30,36,10,2
4,00:10:20,2,False,0,30,-30,36,10,2
4,00:05:16,1,False,0,37,-37,25,10,2
1,00:14:52,1,True,0,0,0,43,10,2
1,00:12:46,2,False,0,0,0,16,12,2
1,00:08:51,1,True,3,0,3,19,10,2
1,00:08:28,2,True,3,0,3,19,10,2
1,00:06:14,2,True,3,3,0,39,17,2
1,00:00:56,1,False,3,10,-7,32,10,2
2,00:12:16,2,True,10,3,7,40,7,2
2,00:11:44,1,False,3,10,-7,23,10,2
2,00:08:14,1,False,3,13,-10,47,10,2
2,00:06:33,2,True,13,3,10,11,2,2
2,00:05:32,2,True,13,6,7,39,6,2
2,00:00:41,1,False,6,20,-14,32,10,2
2,00:00:28,1,False,6,20,-14,44,10,2
3,00:14:46,1,False,6,20,-14,41,10,2
3,00:13:11,1,True,20,6,14,46,10,2
3,00:09:26,2,True,20,13,7,26,8,2
3,00:08:12,2,False,13,20,-7,51,9,2
3,00:04:30,2,False,13,20,-7,16,6,2
3,00:03:01,2,False,13,23,-10,41,4,2
4,00:14:49,1,False,13,23,-10,16,10,2
4,00:14:28,2,False,13,23,-10,16,10,2
4,00:08:10,2,False,27,26,1,45,10,2
4,00:04:58,2,False,27,26,1,7,6,2
4,00:03:37,2,False,27,29,-2,39,6,2
1,00:14:20,2,True,0,0,0,41,4,2
1,00:07:28,1,True,0,1,-1,49,10,2
1,00:01:11,1,True,0,8,-8,48,10,2
2,00:13:54,2,False,8,7,1,21,28,2
2,00:10:30,2,False,8,14,-6,42,6,2
2,00:09:43,1,True,14,8,6,30,10,2
2,00:09:24,2,True,14,8,6,30,10,2
2,00:08:00,2,True,14,8,6,30,10,2
2,00:07:20,1,True,14,11,3,35,10,2
2,00:00:45,1,False,14,14,0,44,10,2
3,00:07:59,1,True,14,24,-10,50,10,2
3,00:07:02,1,False,24,14,10,44,10,2
3,00:01:22,1,False,27,14,13,50,10,2
3,00:00:26,1,False,27,14,13,34,10,2
3,00:00:01,2,False,27,14,13,34,10,2
4,00:02:49,1,True,17,37,-20,49,10,2
4,00:02:28,1,False,37,17,20,41,10,2
4,00:01:59,1,False,37,17,20,9,5,2
4,00:00:22,1,True,24,37,-13,21,10,2
1,00:14:14,1,True,0,0,0,44,10,2
1,00:10:59,2,False,0,3,-3,17,6,2
1,00:06:44,2,False,0,10,-10,50,9,2
1,00:05:59,1,True,10,0,10,20,10,2
1,00:02:20,2,True,10,0,10,10,8,2
1,00:01:29,2,True,10,3,7,45,7,2
2,00:14:45,1,True,10,3,7,2,10,2
2,00:14:25,2,True,10,3,7,2,10,2
2,00:04:13,1,True,17,19,-2,36,10,2
2,00:02:25,1,True,17,19,-2,24,10,2
2,00:02:01,1,True,17,26,-9,29,10,2
3,00:14:51,1,False,26,17,9,37,10,2
3,00:13:35,1,True,17,26,-9,38,10,2
3,00:11:59,2,True,17,26,-9,10,8,2
3,00:10:20,1,True,17,29,-12,50,10,2
3,00:09:52,2,True,17,29,-12,50,10,2
3,00:07:00,1,False,29,17,12,53,10,2
3,00:06:45,2,False,29,17,12,53,10,2
3,00:05:09,1,True,17,29,-12,32,10,2
3,00:03:11,2,True,17,29,-12,5,5,2
4,00:14:30,2,False,32,20,12,35,10,2
4,00:11:22,1,False,32,20,12,10,10,2
4,00:04:18,2,True,20,32,-12,47,15,2
4,00:02:15,1,False,32,20,12,32,10,2
4,00:00:52,1,True,20,32,-12,17,10,2
4,00:00:44,2,True,20,32,-12,17,10,2
1,00:14:54,1,False,0,0,0,39,10,2
1,00:08:28,2,True,0,0,0,3,3,2
1,00:07:09,1,False,3,0,3,41,10,2
2,00:09:52,1,True,7,3,4,17,10,2
2,00:08:11,1,True,7,6,1,55,10,2
3,00:14:20,2,True,14,6,8,37,9,2
3,00:11:50,1,True,14,6,8,51,10,2
3,00:10:02,2,True,14,6,8,16,1,2
3,00:08:58,2,True,14,6,8,9,8,2
3,00:01:04,1,True,21,9,12,9,10,2
4,00:11:17,2,False,12,21,-9,13,5,2
4,00:02:08,2,False,12,31,-19,24,7,2
4,00:02:03,3,False,12,31,-19,24,7,2
4,00:00:27,1,False,12,38,-26,53,10,2
4,00:00:23,2,False,12,38,-26,53,10,2
1,00:14:54,1,False,0,0,0,36,10,2
1,00:14:34,2,False,0,0,0,36,10,2
1,00:11:05,2,False,0,0,0,41,6,2
1,00:08:04,2,True,1,0,1,45,3,2
1,00:05:12,1,True,1,0,1,36,10,2
1,00:04:56,2,True,1,0,1,36,10,2
1,00:02:43,1,False,1,1,0,43,10,2
1,00:01:16,1,False,1,1,0,38,20,2
2,00:14:00,2,True,8,1,7,21,14,2
2,00:06:22,1,True,15,1,14,51,10,2
2,00:03:53,2,True,15,1,14,28,7,2
2,00:03:14,1,False,1,15,-14,46,10,2
2,00:02:21,1,True,15,1,14,48,10,2
2,00:00:29,1,True,15,1,14,52,10,2
2,00:00:21,2,True,15,1,14,52,10,2
3,00:14:51,1,True,15,1,14,39,10,2
3,00:14:28,2,True,15,1,14,39,10,2
3,00:12:50,1,False,1,15,-14,39,10,2
3,00:12:06,2,False,1,15,-14,39,10,2
3,00:05:50,2,True,22,1,21,43,13,2
3,00:04:45,1,False,4,22,-18,53,10,2
3,00:04:21,2,False,4,22,-18,53,10,2
3,00:00:01,2,True,22,11,11,46,10,2
4,00:09:11,2,True,22,19,3,39,17,2
4,00:04:31,2,True,22,19,3,18,16,2
4,00:02:55,1,True,22,27,-5,22,10,2
4,00:02:51,2,True,22,27,-5,22,10,2
4,00:01:31,1,True,22,27,-5,26,10,2
1,00:12:45,1,False,0,0,0,38,15,2
1,00:10:35,1,False,0,0,0,43,10,2
1,00:04:27,2,True,3,0,3,9,5,2
1,00:00:23,1,False,3,3,0,55,10,2
2,00:14:48,1,True,3,3,0,23,10,2
2,00:13:31,1,False,3,3,0,49,10,2
2,00:11:42,2,False,3,3,0,31,5,2
2,00:04:59,1,False,10,6,4,27,10,2
2,00:01:26,1,True,6,17,-11,12,10,2
2,00:00:27,1,False,17,6,11,52,10,2
3,00:13:57,1,True,6,17,-11,45,10,2
3,00:12:40,2,False,17,6,11,46,6,2
3,00:09:50,1,True,8,17,-9,34,10,2
3,00:09:41,2,True,8,17,-9,34,10,2
3,00:06:34,1,True,8,17,-9,24,10,2
4,00:11:31,2,True,15,27,-12,44,8,2
4,00:02:16,2,True,22,27,-5,20,9,2
4,00:00:46,2,False,30,28,2,23,13,2
4,00:00:10,1,False,30,28,2,53,10,2
1,00:04:35,2,True,0,7,-7,47,5,2
1,00:03:15,2,True,0,8,-8,38,7,2
1,00:02:29,1,False,8,0,8,23,10,2
1,00:02:12,2,False,8,0,8,23,10,2
1,00:00:51,1,False,8,0,8,36,10,2
2,00:12:46,1,True,3,8,-5,43,10,2
2,00:12:30,2,True,3,8,-5,43,10,2
2,00:07:36,1,True,3,15,-12,26,10,2
2,00:03:44,1,False,15,3,12,54,20,2
2,00:03:30,2,False,15,3,12,54,20,2
2,00:01:52,1,True,3,22,-19,37,10,2
2,00:00:58,2,False,22,3,19,32,7,2
3,00:06:15,1,False,22,16,6,34,10,2
3,00:05:05,1,False,22,16,6,44,10,2
3,00:00:29,1,False,22,16,6,42,10,2
4,00:15:00,1,True,16,22,-6,35,10,2
4,00:14:38,2,True,16,22,-6,35,10,2
4,00:13:47,1,True,16,23,-7,20,10,2
4,00:04:48,1,False,30,19,11,45,5,2
4,00:01:06,1,False,33,19,14,48,10,2
4,00:00:46,3,True,19,33,-14,47,25,2
1,00:12:28,1,False,0,0,0,9,9,2
1,00:05:25,1,True,3,0,3,39,10,2
1,00:02:11,1,True,3,1,2,24,10,2
2,00:05:02,1,False,9,10,-1,14,10,2
2,00:02:49,2,False,9,17,-8,43,8,2
2,00:02:25,1,True,17,9,8,21,10,2
2,00:02:14,1,True,17,9,8,10,10,2
3,00:14:13,2,True,17,16,1,45,6,2
3,00:12:09,1,False,16,17,-1,40,10,2
3,00:12:02,2,False,16,17,-1,40,10,2
3,00:09:01,2,True,17,16,1,39,17,2
3,00:06:08,2,True,17,16,1,49,7,2
3,00:02:37,2,False,17,17,0,39,11,2
3,00:01:20,2,False,17,17,0,12,13,2
3,00:00:40,1,False,17,17,0,45,10,2
3,00:00:21,2,False,17,17,0,45,10,2
4,00:13:13,1,False,17,17,0,53,10,2
4,00:11:13,2,False,17,17,0,5,6,2
4,00:09:28,1,False,17,19,-2,39,10,2
4,00:07:07,1,False,17,19,-2,11,10,2
4,00:02:13,2,False,20,26,-6,37,8,2
4,00:01:39,1,False,20,27,-7,37,10,2
4,00:00:21,1,False,20,27,-7,55,15,2
4,00:00:14,2,False,20,27,-7,55,15,2
1,00:09:30,2,False,0,0,0,20,12,2
1,00:06:31,1,False,0,0,0,27,10,2
1,00:06:11,2,False,0,0,0,27,10,2
1,00:04:55,1,False,0,3,-3,53,10,2
1,00:04:38,2,False,0,3,-3,53,10,2
1,00:01:11,2,True,3,0,3,50,12,2
1,00:00:36,1,False,0,3,-3,30,10,2
1,00:00:16,2,False,0,3,-3,30,10,2
2,00:13:21,2,True,3,0,3,40,14,2
2,00:06:17,2,True,3,7,-4,25,6,2
2,00:00:34,1,False,15,3,12,45,10,2
2,00:00:24,1,True,3,15,-12,40,10,2
3,00:13:56,1,False,16,3,13,24,10,2
3,00:08:40,1,False,23,10,13,50,10,2
3,00:06:02,1,True,10,23,-13,42,10,2
4,00:15:00,1,False,25,10,15,49,10,2
4,00:14:47,2,False,25,10,15,49,10,2
4,00:14:03,1,True,10,25,-15,34,10,2
4,00:13:41,2,True,10,25,-15,34,10,2
4,00:05:20,1,True,10,28,-18,55,10,2
4,00:03:50,1,False,28,10,18,23,10,2
4,00:02:42,1,False,28,10,18,9,9,2
4,00:02:09,1,True,17,28,-11,46,10,2
4,00:02:05,2,True,17,28,-11,46,10,2
4,00:02:00,3,True,17,28,-11,41,15,2
4,00:00:30,1,True,17,31,-14,35,10,2
1,00:13:06,2,True,0,7,-7,35,9,2
1,00:06:25,1,True,0,14,-14,39,10,2
1,00:05:16,2,False,14,0,14,41,6,2
1,00:02:00,1,True,0,21,-21,43,10,2
2,00:11:36,1,False,21,0,21,28,10,2
2,00:08:56,2,False,21,0,21,54,6,2
2,00:05:18,1,True,0,21,-21,26,10,2
2,00:03:18,1,True,0,28,-28,37,10,2
2,00:02:51,2,True,0,28,-28,32,15,2
2,00:02:30,1,False,28,0,28,50,10,2
2,00:00:27,1,False,31,0,31,52,10,2
3,00:10:06,1,False,31,3,28,26,10,2
3,00:09:02,3,False,31,3,28,20,4,2
3,00:05:07,2,True,3,31,-28,37,17,2
3,00:03:37,1,True,3,32,-29,48,10,2
3,00:03:05,2,True,3,32,-29,48,10,2
4,00:15:00,1,False,32,3,29,48,10,2
4,00:10:41,1,False,32,10,22,31,10,2
4,00:09:15,2,False,32,10,22,8,8,2
4,00:06:07,2,False,32,13,19,46,10,2
1,00:14:52,1,True,0,0,0,32,10,2
1,00:14:25,2,True,0,0,0,32,10,2
1,00:11:18,2,False,0,7,-7,25,9,2
1,00:09:47,2,False,0,7,-7,51,1,2
1,00:03:26,2,False,0,13,-13,40,14,2
2,00:13:51,1,False,0,16,-16,35,10,2
2,00:06:58,1,False,7,16,-9,33,10,2
2,00:06:26,2,False,7,16,-9,38,5,2
2,00:01:59,1,False,7,23,-16,46,10,2
2,00:01:54,2,False,7,23,-16,46,10,2
2,00:00:28,1,False,7,23,-16,47,10,2
3,00:12:39,2,True,26,7,19,21,6,2
3,00:11:24,2,True,26,10,16,35,10,2
3,00:06:55,2,True,26,17,9,45,6,2
3,00:05:30,1,False,17,26,-9,49,10,2
3,00:05:14,2,False,17,26,-9,49,10,2
3,00:02:40,1,True,26,17,9,25,10,2
3,00:01:17,2,True,26,17,9,6,5,2
4,00:15:00,2,True,26,20,6,51,8,2
4,00:12:10,2,True,26,20,6,55,6,2
1,00:13:33,1,False,0,0,0,53,20,2
1,00:11:10,1,True,0,0,0,18,10,2
1,00:00:27,2,False,14,0,14,17,10,2
2,00:13:57,1,True,3,14,-11,44,10,2
2,00:08:55,1,True,3,21,-18,46,10,2
2,00:08:35,2,True,3,21,-18,46,10,2
2,00:07:30,2,False,21,3,18,31,9,2
2,00:04:24,2,True,3,21,-18,29,6,2
2,00:01:16,1,True,3,31,-28,41,10,2
2,00:01:11,2,True,3,31,-28,41,10,2
3,00:14:15,1,False,31,3,28,38,10,2
3,00:13:54,2,False,31,3,28,38,10,2
3,00:13:11,1,True,3,31,-28,37,10,2
3,00:08:22,1,False,31,3,28,30,10,2
3,00:08:13,2,False,31,3,28,30,10,2
3,00:07:55,3,False,31,3,28,30,10,2
3,00:05:03,2,True,3,31,-28,43,8,2
3,00:00:50,2,True,3,32,-29,49,5,2
4,00:15:00,1,True,3,32,-29,21,10,2
4,00:13:52,1,True,3,39,-36,25,10,2
4,00:13:40,2,True,3,39,-36,25,10,2
4,00:11:55,1,True,3,39,-36,39,10,2
4,00:11:24,2,True,3,39,-36,39,10,2
4,00:10:15,1,True,3,40,-37,51,10,2
4,00:06:40,2,True,10,40,-30,52,10,2
4,00:05:54,1,True,10,40,-30,54,10,2
4,00:03:53,1,False,40,17,23,7,7,2
4,00:03:34,2,False,40,17,23,7,7,2
1,00:11:56,2,True,0,0,0,34,13,2
1,00:02:54,1,False,10,0,10,48,10,2
1,00:02:37,2,False,10,0,10,48,10,2
2,00:06:30,1,True,7,10,-3,53,10,2
2,00:06:14,2,True,7,10,-3,53,10,2
2,00:00:50,1,False,17,7,10,49,10,2
3,00:14:32,2,True,7,17,-10,16,3,2
3,00:13:57,1,True,7,17,-10,21,10,2
3,00:10:38,2,False,17,7,10,55,14,2
3,00:09:03,2,True,7,17,-10,17,11,2
3,00:06:40,1,True,7,17,-10,30,10,2
3,00:06:19,2,True,7,17,-10,30,10,2
3,00:03:33,1,True,7,17,-10,30,10,2
3,00:02:57,1,True,7,17,-10,13,10,2
4,00:14:43,1,False,24,8,16,35,10,2
4,00:14:27,2,False,24,8,16,35,10,2
4,00:12:48,1,False,24,8,16,11,10,2
4,00:12:18,2,False,24,8,16,11,10,2
4,00:11:40,1,False,24,11,13,31,10,2
4,00:08:48,1,True,11,24,-13,39,10,2
4,00:08:29,2,True,11,24,-13,39,10,2
4,00:07:49,1,True,11,27,-16,35,10,2
4,00:07:15,1,True,11,27,-16,40,10,2
4,00:05:17,1,True,11,34,-23,35,10,2
4,00:01:42,2,True,18,34,-16,15,11,2
1,00:10:43,1,False,0,0,0,28,10,2
1,00:10:22,2,False,0,0,0,28,10,2
1,00:09:00,2,False,0,3,-3,38,7,2
1,00:05:35,1,True,10,0,10,8,8,2
1,00:05:23,2,True,10,0,10,8,8,2
1,00:01:16,1,False,3,17,-14,20,10,2
2,00:13:53,2,False,3,17,-14,49,13,2
2,00:11:15,2,True,17,3,14,53,7,2
2,00:09:47,1,False,3,18,-15,54,10,2
2,00:09:36,2,False,3,18,-15,54,10,2
2,00:07:31,2,False,3,18,-15,46,6,2
2,00:06:35,1,False,3,18,-15,10,10,2
2,00:04:08,1,True,18,3,15,50,10,2
2,00:03:46,2,True,18,3,15,50,10,2
2,00:01:13,1,False,4,25,-21,38,10,2
2,00:01:07,2,False,4,25,-21,38,10,2
2,00:00:43,1,True,25,4,21,49,10,2
3,00:12:27,1,True,25,4,21,52,10,2
3,00:09:46,2,False,4,25,-21,7,6,2
3,00:06:25,2,True,28,4,24,35,4,2
3,00:03:54,1,False,4,28,-24,36,10,2
3,00:00:25,1,False,11,35,-24,50,10,2
4,00:13:45,1,False,11,35,-24,43,10,2
4,00:09:36,1,False,11,38,-27,27,10,2
4,00:09:22,2,False,11,38,-27,27,10,2
4,00:08:37,1,True,38,11,27,33,10,2
4,00:06:09,1,False,11,38,-27,41,10,2
1,00:13:29,1,True,0,0,0,35,10,2
1,00:11:44,2,True,0,0,0,51,7,2
1,00:10:05,1,True,0,0,0,8,8,2
1,00:09:37,2,True,0,0,0,8,8,2
1,00:07:18,1,False,3,0,3,21,10,2
1,00:05:23,2,False,3,7,-4,39,11,2
1,00:03:30,1,True,7,3,4,40,10,2
2,00:15:00,2,True,7,3,4,37,6,2
2,00:14:05,2,True,7,4,3,41,6,2
2,00:13:06,2,False,4,7,-3,25,13,2
2,00:12:00,1,True,7,4,3,55,10,2
2,00:11:40,2,True,7,4,3,55,10,2
2,00:09:35,2,False,4,8,-4,51,4,2
2,00:04:46,1,True,8,7,1,45,10,2
2,00:03:30,1,True,8,7,1,55,10,2
2,00:03:25,2,True,8,7,1,55,10,2
2,00:02:47,1,False,7,8,-1,24,10,2
2,00:02:28,1,False,7,8,-1,43,10,2
2,00:02:07,2,False,7,8,-1,43,10,2
3,00:13:35,1,True,8,7,1,17,10,2
3,00:13:29,2,True,8,7,1,17,10,2
3,00:11:35,1,False,10,8,2,54,10,2
3,00:06:26,1,True,9,10,-1,40,10,2
3,00:06:04,2,True,9,10,-1,40,10,2
3,00:04:19,2,True,9,11,-2,39,11,2
3,00:03:37,1,False,11,9,2,11,10,2
4,00:15:00,2,False,11,11,0,18,18,2
4,00:11:20,2,True,14,11,3,31,6,2
4,00:08:07,1,False,14,14,0,48,10,2
4,00:07:54,2,False,14,14,0,48,10,2
4,00:06:47,2,True,14,14,0,35,6,2
4,00:05:54,1,False,14,14,0,41,10,2
4,00:00:54,1,False,21,21,0,34,10,2
4,00:00:49,2,False,21,21,0,34,10,2
1,00:13:11,1,False,0,0,0,8,8,2
1,00:11:16,2,True,3,0,3,51,8,2
1,00:08:20,1,False,0,3,-3,49,10,2
1,00:07:47,2,False,0,3,-3,49,10,2
1,00:07:01,1,False,0,3,-3,15,10,2
1,00:06:47,2,False,0,3,-3,15,10,2
1,00:04:34,1,False,0,3,-3,2,2,2
1,00:03:15,2,False,0,10,-10,25,10,2
1,00:01:36,2,False,0,10,-10,38,9,2
2,00:13:56,2,True,13,0,13,6,6,2
2,00:05:28,1,False,4,16,-12,39,10,2
2,00:04:00,2,False,4,16,-12,13,9,2
2,00:02:53,1,False,4,19,-15,41,10,2
2,00:01:24,1,False,11,19,-8,44,10,2
2,00:00:37,1,False,11,19,-8,16,10,2
2,00:00:32,2,False,11,19,-8,16,10,2
2,00:00:13,1,False,11,19,-8,48,10,2
2,00:00:04,2,False,11,19,-8,48,10,2
3,00:14:54,1,False,11,19,-8,30,10,2
3,00:14:31,2,False,11,19,-8,30,10,2
3,00:13:03,1,False,11,19,-8,52,10,2
3,00:12:41,2,False,11,19,-8,52,10,2
3,00:10:27,1,False,11,19,-8,20,10,2
3,00:07:10,1,True,26,11,15,21,10,2
3,00:04:46,1,True,26,18,8,15,10,2
4,00:06:18,1,False,26,26,0,6,6,2
4,00:04:34,2,True,33,26,7,50,8,2
4,00:01:39,1,False,26,33,-7,45,10,2
4,00:01:25,1,True,33,26,7,53,10,2
4,00:00:13,2,True,40,26,14,44,8,2
1,00:09:34,1,True,7,0,7,29,10,2
1,00:09:16,2,True,7,0,7,29,10,2
1,00:02:32,1,True,7,0,7,2,2,2
2,00:11:41,1,False,7,14,-7,47,10,2
2,00:10:40,1,True,14,7,7,51,10,2
2,00:09:05,1,True,14,7,7,8,10,2
2,00:05:55,2,True,14,16,-2,34,4,2
2,00:05:10,1,False,16,14,2,25,10,2
2,00:02:34,2,False,16,21,-5,38,6,2
2,00:01:33,2,False,16,21,-5,47,4,2
3,00:11:15,1,False,16,21,-5,49,10,2
3,00:10:55,2,False,16,21,-5,49,10,2
3,00:08:17,2,True,21,16,5,35,5,2
3,00:07:30,1,False,16,21,-5,38,10,2
3,00:07:18,2,False,16,21,-5,38,10,2
3,00:03:10,1,True,21,19,2,49,10,2
3,00:01:58,1,False,19,21,-2,25,10,2
4,00:13:09,2,False,19,21,-2,16,8,2
4,00:10:34,2,True,24,19,5,49,22,2
4,00:09:17,2,True,24,19,5,17,5,2
4,00:06:33,2,False,19,24,-5,52,6,2
4,00:04:58,1,True,24,19,5,23,10,2
4,00:04:33,2,True,24,19,5,23,10,2
4,00:02:21,1,False,22,24,-2,1,10,2
4,00:02:16,2,False,22,24,-2,1,10,2
4,00:00:18,3,True,26,22,4,35,0,2
1,00:14:54,1,False,0,0,0,39,10,2
1,00:14:31,2,False,0,0,0,39,10,2
1,00:08:00,1,True,0,0,0,38,10,2
1,00:05:19,1,False,3,0,3,46,10,2
1,00:02:16,1,False,3,0,3,54,10,2
2,00:13:13,2,False,3,7,-4,45,6,2
2,00:09:16,1,False,3,14,-11,25,10,2
2,00:02:16,1,False,3,14,-11,26,10,2
2,00:00:27,1,True,14,3,11,24,10,2
3,00:13:58,1,True,14,3,11,51,10,2
3,00:12:41,1,True,14,4,10,35,10,2
3,00:10:53,2,False,4,14,-10,47,9,2
3,00:07:54,2,False,4,14,-10,43,7,2
3,00:06:14,2,True,14,4,10,9,13,2
3,00:05:25,1,True,14,4,10,40,10,2
3,00:03:39,2,True,14,4,10,42,7,2
3,00:02:25,2,True,14,7,7,38,7,2
4,00:07:53,2,False,9,14,-5,32,3,2
4,00:05:52,2,False,9,14,-5,47,6,2
4,00:04:20,2,True,14,9,5,44,4,2
1,00:05:53,1,False,3,7,-4,11,10,2
1,00:04:12,1,True,7,3,4,50,10,2
2,00:15:00,1,True,7,6,1,41,10,2
2,00:00:35,2,False,16,14,2,13,13,2
3,00:09:40,1,False,16,24,-8,25,10,2
3,00:09:24,2,False,16,24,-8,25,10,2
3,00:07:38,1,False,16,24,-8,42,10,2
3,00:07:02,2,False,16,24,-8,42,10,2
3,00:05:30,2,False,16,24,-8,9,11,2
4,00:14:42,1,False,16,33,-17,38,10,2
4,00:14:08,2,False,16,33,-17,38,10,2
4,00:11:55,1,True,33,16,17,21,10,2
4,00:11:20,2,True,33,16,17,21,10,2
4,00:08:01,2,True,33,17,16,47,2,2
4,00:05:57,0,False,23,33,-10,5,0,2
4,00:00:15,1,True,36,26,10,34,20,2
1,00:14:26,2,False,0,0,0,45,4,2
1,00:11:09,2,True,0,0,0,9,9,2
1,00:10:19,2,True,0,3,-3,36,9,2
1,00:07:53,2,False,3,0,3,40,8,2
1,00:05:19,1,False,3,0,3,45,10,2
1,00:02:41,2,False,3,0,3,40,7,2
1,00:02:01,1,True,0,3,-3,30,10,2
1,00:01:36,2,True,0,3,-3,30,10,2
2,00:08:18,1,False,10,0,10,12,10,2
2,00:06:35,2,False,10,7,3,54,0,2
2,00:02:01,1,False,10,14,-4,33,10,2
2,00:01:57,2,False,10,14,-4,33,10,2
2,00:01:41,1,False,10,14,-4,12,10,2
2,00:01:37,2,False,10,14,-4,12,10,2
2,00:00:26,1,True,17,10,7,40,10,2
2,00:00:05,1,True,17,17,0,47,10,2
2,00:00:01,2,True,17,17,0,47,10,2
3,00:09:07,1,False,17,20,-3,45,10,2
3,00:04:50,1,True,20,24,-4,55,10,2
3,00:00:20,1,False,24,23,1,49,10,2
4,00:12:02,1,False,24,23,1,15,10,2
4,00:11:45,2,False,24,23,1,15,10,2
4,00:07:25,2,True,26,31,-5,45,7,2
4,00:06:29,1,False,31,26,5,33,10,2
4,00:03:00,1,False,31,26,5,26,10,2
4,00:02:47,2,False,31,26,5,26,10,2
4,00:01:46,2,True,27,31,-4,54,8,2
4,00:01:16,1,True,27,31,-4,31,10,2
4,00:01:10,2,True,27,31,-4,31,10,2
4,00:01:03,3,True,27,31,-4,31,10,2
1,00:14:30,2,False,0,0,0,25,20,2
1,00:12:04,1,True,0,0,0,52,10,2
1,00:01:51,2,True,0,12,-12,50,8,2
1,00:00:41,1,True,0,12,-12,26,10,2
2,00:14:24,1,False,12,0,12,44,20,2
2,00:01:31,2,True,7,15,-8,25,12,2
2,00:00:51,2,True,7,15,-8,37,7,2
2,00:00:09,2,True,7,18,-11,17,5,2
3,00:12:20,2,False,21,14,7,38,11,2
3,00:08:26,2,False,28,21,7,47,6,2
3,00:07:36,1,True,21,28,-7,19,10,2
3,00:05:35,1,False,28,21,7,47,10,2
3,00:03:42,2,False,28,21,7,35,9,2
3,00:01:51,2,False,28,24,4,45,7,2
3,00:01:17,1,True,24,28,-4,37,10,2
3,00:00:01,1,False,28,24,4,38,10,2
4,00:14:00,2,False,28,24,4,23,7,2
4,00:11:27,1,False,28,27,1,41,10,2
4,00:10:10,1,True,27,28,-1,21,10,2
4,00:09:25,2,True,27,28,-1,26,15,2
4,00:03:13,2,False,38,36,2,33,12,2
4,00:02:36,2,False,38,36,2,22,5,2
4,00:02:12,1,True,36,38,-2,49,10,2
4,00:00:38,2,True,36,38,-2,10,5,2
4,00:00:28,1,True,36,38,-2,31,10,2
4,00:00:15,1,True,36,38,-2,46,10,2
1,00:07:15,2,True,7,0,7,51,2,2
1,00:06:37,1,True,7,0,7,13,10,2
1,00:05:09,2,True,7,2,5,53,8,2
1,00:03:44,2,True,7,2,5,2,13,2
1,00:01:12,1,True,7,4,3,25,10,2
1,00:00:01,1,True,7,4,3,21,21,2
2,00:06:06,2,True,7,14,-7,50,9,2
2,00:01:35,1,True,14,14,0,30,10,2
2,00:01:00,1,True,14,21,-7,42,10,2
2,00:00:33,1,False,21,14,7,40,10,2
3,00:14:48,1,True,14,21,-7,29,10,2
3,00:14:08,1,True,14,21,-7,46,10,2
3,00:13:53,2,True,14,21,-7,46,10,2
3,00:07:56,2,False,21,14,7,45,11,2
3,00:07:16,1,True,14,21,-7,12,10,2
3,00:02:43,1,False,21,14,7,49,10,2
4,00:07:02,1,True,14,29,-15,41,10,2
4,00:01:33,2,True,14,32,-18,38,7,2
1,00:12:42,2,False,0,0,0,46,5,2
1,00:07:53,1,True,0,1,-1,35,10,2
1,00:02:28,1,False,1,2,-1,23,10,2
2,00:12:42,1,True,9,1,8,40,10,2
2,00:11:58,2,True,9,1,8,40,10,2
3,00:05:30,1,False,8,23,-15,21,10,2
3,00:04:59,2,False,8,23,-15,21,10,2
3,00:02:40,1,True,24,8,16,33,10,2
3,00:00:53,2,True,24,8,16,11,11,2
4,00:13:18,2,False,11,24,-13,43,6,2
4,00:09:01,1,True,24,11,13,12,10,2
4,00:07:16,1,True,24,18,6,43,10,2
4,00:04:33,2,False,18,24,-6,48,14,2
4,00:01:44,1,True,24,18,6,37,10,2
4,00:01:28,2,True,24,18,6,37,10,2
1,00:14:31,2,False,0,0,0,36,6,2
1,00:10:43,2,False,0,7,-7,40,5,2
1,00:09:59,1,True,7,0,7,27,10,2
1,00:04:26,1,True,10,0,10,48,10,2
2,00:14:53,1,False,0,17,-17,44,10,2
2,00:13:05,1,True,17,0,17,37,10,2
2,00:09:13,3,True,17,0,17,34,7,2
2,00:03:30,2,True,24,0,24,50,10,2
2,00:02:34,2,True,24,0,24,25,12,2
2,00:00:27,2,True,24,3,21,6,3,2
3,00:14:52,1,True,24,6,18,36,10,2
3,00:09:06,1,False,7,24,-17,36,10,2
3,00:06:05,2,False,7,24,-17,30,9,2
3,00:04:04,1,False,7,24,-17,35,15,2
4,00:14:17,1,False,7,27,-20,40,10,2
4,00:12:41,2,True,27,7,20,16,3,2
4,00:08:12,1,False,14,27,-13,37,10,2
4,00:07:47,2,False,14,27,-13,37,10,2
4,00:03:22,1,False,14,27,-13,15,10,2
4,00:01:38,3,False,14,34,-20,35,2,2
4,00:00:09,1,True,37,14,23,48,10,2
4,00:00:02,2,True,37,14,23,48,10,2
1,00:14:54,1,True,0,0,0,27,10,2
1,00:12:47,2,False,0,0,0,39,6,2
1,00:08:55,2,True,3,3,0,26,19,2
1,00:07:27,2,False,3,3,0,33,3,2
2,00:08:55,2,False,6,10,-4,40,6,2
2,00:08:03,1,True,10,6,4,32,10,2
2,00:02:48,1,True,10,9,1,35,10,2
2,00:01:30,1,True,10,9,1,23,10,2
3,00:00:03,1,False,22,24,-2,44,10,2
4,00:15:00,2,False,22,24,-2,44,10,2
4,00:11:17,1,False,22,24,-2,35,10,2
4,00:11:13,2,False,22,24,-2,35,10,2
4,00:07:51,1,True,27,29,-2,49,10,2
4,00:05:47,1,False,29,27,2,25,10,2
1,00:14:00,1,True,0,0,0,49,10,2
1,00:10:25,2,True,0,0,0,30,9,2
1,00:07:46,1,True,0,0,0,31,10,2
1,00:07:01,1,True,0,0,0,53,10,2
1,00:05:30,2,True,0,0,0,16,4,2
1,00:02:16,2,True,0,3,-3,33,12,2
1,00:00:41,1,False,3,0,3,35,10,2
1,00:00:01,2,False,3,0,3,35,10,2
2,00:12:36,2,False,3,0,3,40,6,2
2,00:02:24,1,False,13,3,10,52,10,2
3,00:14:51,1,True,10,20,-10,20,10,2
3,00:14:03,1,True,10,20,-10,34,10,2
3,00:12:31,2,False,20,10,10,38,10,2
3,00:11:10,2,False,20,10,10,20,6,2
3,00:09:42,2,False,20,10,10,50,4,2
3,00:08:49,1,False,20,10,10,13,10,2
3,00:05:15,2,False,20,10,10,55,7,2
3,00:03:26,1,True,10,20,-10,43,10,2
3,00:03:02,2,True,10,20,-10,43,10,2
4,00:15:00,1,True,10,20,-10,37,10,2
4,00:13:10,2,True,10,20,-10,4,4,2
4,00:09:19,2,False,23,10,13,26,12,2
4,00:08:35,1,False,23,13,10,25,20,2
4,00:02:20,1,False,24,13,11,19,10,2
4,00:00:42,1,True,13,27,-14,35,10,2
4,00:00:31,3,True,13,27,-14,44,1,2
1,00:12:18,2,False,0,0,0,6,6,2
1,00:10:06,1,True,3,0,3,30,10,2
1,00:09:45,2,True,3,0,3,30,10,2
1,00:07:00,2,True,3,3,0,42,14,2
1,00:02:56,2,True,3,3,0,25,10,2
1,00:00:01,2,True,3,10,-7,34,7,2
2,00:12:48,1,True,3,10,-7,30,10,2
2,00:07:22,1,False,17,3,14,50,10,2
2,00:04:33,1,True,3,17,-14,16,10,2
2,00:04:09,2,True,3,17,-14,16,10,2
2,00:01:58,1,False,20,3,17,19,10,2
2,00:01:53,2,False,20,3,17,19,10,2
2,00:01:49,3,False,20,3,17,19,10,2
2,00:00:30,1,False,20,3,17,55,10,2
3,00:14:55,1,True,3,23,-20,44,10,2
3,00:07:49,2,False,23,10,13,46,11,2
3,00:06:34,1,True,10,23,-13,33,10,2
3,00:06:14,2,True,10,23,-13,33,10,2
3,00:04:56,2,False,23,10,13,36,3,2
3,00:02:02,2,False,23,10,13,54,5,2
3,00:01:18,1,False,23,10,13,15,10,2
4,00:15:00,2,False,23,10,13,34,12,2
4,00:13:29,1,True,10,23,-13,33,10,2
4,00:10:40,1,False,23,10,13,27,10,2
4,00:08:09,2,False,23,17,6,50,13,2
4,00:06:52,2,False,23,17,6,22,2,2
4,00:06:05,1,True,17,23,-6,35,10,2
4,00:04:59,1,True,17,23,-6,50,10,2
4,00:02:30,1,False,23,17,6,13,10,2
4,00:01:30,2,True,20,23,-3,26,6,2
4,00:00:50,1,True,20,26,-6,54,10,2
4,00:00:33,3,False,26,20,6,49,3,2
1,00:14:09,2,False,0,0,0,43,4,2
1,00:11:15,2,True,0,0,0,50,5,2
1,00:08:16,1,True,0,7,-7,38,10,2
1,00:07:49,2,True,0,7,-7,38,10,2
1,00:07:08,1,False,7,0,7,36,10,2
1,00:00:01,1,False,7,10,-3,8,10,2
2,00:12:37,1,False,7,13,-6,20,10,2
2,00:06:18,2,False,7,27,-20,47,5,2
2,00:04:13,2,True,27,7,20,45,5,2
2,00:03:10,1,False,7,27,-20,36,10,2
2,00:02:50,2,False,7,27,-20,36,10,2
2,00:00:44,1,False,7,28,-21,8,8,2
2,00:00:24,2,False,7,28,-21,8,8,2
3,00:14:14,2,False,7,31,-24,34,8,2
3,00:09:50,1,True,31,7,24,29,10,2
3,00:06:24,2,True,31,14,17,26,7,2
3,00:04:48,2,True,31,14,17,47,6,2
3,00:03:34,1,True,31,14,17,32,10,2
3,00:00:42,2,True,31,14,17,55,13,2
4,00:14:02,1,True,31,14,17,49,10,2
4,00:12:22,1,False,14,32,-18,35,10,2
4,00:10:57,1,False,14,32,-18,51,10,2
4,00:08:17,1,True,32,14,18,52,10,2
4,00:05:52,1,True,32,14,18,45,20,2
4,00:02:55,1,False,14,32,-18,27,10,2
4,00:02:25,3,False,14,32,-18,34,3,2
4,00:01:30,1,False,14,35,-21,35,10,2
4,00:01:25,2,False,14,35,-21,35,10,2
1,00:14:53,1,False,0,0,0,40,10,2
1,00:13:02,2,True,0,0,0,44,8,2
1,00:10:50,2,False,0,0,0,50,4,2
1,00:08:18,1,True,0,0,0,34,10,2
1,00:00:42,1,True,14,0,14,31,10,2
1,00:00:24,2,True,14,0,14,31,10,2
2,00:14:42,1,False,0,14,-14,51,10,2
2,00:13:56,1,True,14,0,14,19,10,2
2,00:13:20,2,True,14,0,14,19,10,2
2,00:11:36,1,True,14,3,11,49,10,2
2,00:08:20,2,True,21,3,18,48,8,2
2,00:05:54,1,True,21,3,18,41,10,2
2,00:05:35,2,True,21,3,18,41,10,2
2,00:03:00,2,False,3,21,-18,25,8,2
2,00:02:39,1,False,3,24,-21,35,10,2
2,00:00:20,1,True,31,3,28,50,10,2
2,00:00:06,2,True,31,3,28,50,10,2
3,00:13:32,1,False,3,31,-28,50,10,2
3,00:12:51,2,False,3,31,-28,50,10,2
3,00:10:03,2,False,3,31,-28,18,14,2
3,00:08:34,2,False,3,34,-31,36,9,2
3,00:07:59,3,False,3,34,-31,36,9,2
3,00:06:45,1,False,3,34,-31,48,10,2
3,00:06:24,2,False,3,34,-31,48,10,2
3,00:05:19,1,True,34,3,31,26,10,2
3,00:03:03,2,True,34,3,31,40,7,2
3,00:00:40,2,False,3,34,-31,48,4,2
4,00:10:35,2,True,34,5,29,52,4,2
4,00:07:12,2,True,36,5,31,49,9,2
4,00:02:16,2,True,36,5,31,21,5,2
4,00:01:52,3,True,36,5,31,21,5,2
4,00:01:43,2,True,36,5,31,25,6,2
4,00:00:39,1,True,36,5,31,31,10,2
4,00:00:16,2,True,36,5,31,31,10,2
4,00:00:11,3,True,36,5,31,31,10,2
1,00:12:26,1,True,0,0,0,52,10,2
1,00:12:11,2,True,0,0,0,52,10,2
1,00:08:18,2,False,0,7,-7,24,10,2
1,00:06:40,1,False,0,7,-7,38,10,2
2,00:09:31,2,True,13,7,6,40,5,2
2,00:03:16,2,True,21,10,11,48,3,2
2,00:00:48,1,True,21,10,11,46,10,2
2,00:00:37,1,True,21,10,11,7,7,2
3,00:14:07,2,False,17,21,-4,48,11,2
3,00:09:54,2,False,17,21,-4,25,6,2
3,00:06:18,2,False,17,21,-4,36,5,2
3,00:05:32,1,False,17,24,-7,35,10,2
3,00:05:17,2,False,17,24,-7,35,10,2
3,00:03:08,1,False,17,24,-7,13,10,2
3,00:02:51,2,False,17,24,-7,13,10,2
3,00:01:09,1,True,27,17,10,10,10,2
3,00:00:45,2,True,27,17,10,10,10,2
4,00:08:06,2,True,27,20,7,48,12,2
4,00:07:18,1,True,27,21,6,35,10,2
4,00:06:08,1,False,21,27,-6,50,10,2
4,00:05:00,1,False,21,27,-6,1,10,2
4,00:02:09,1,False,21,36,-15,50,10,2
4,00:02:03,2,False,21,36,-15,50,10,2
1,00:14:05,1,True,0,7,-7,35,10,2
1,00:13:46,2,True,0,7,-7,35,10,2
1,00:12:22,2,False,7,0,7,55,10,2
1,00:11:04,2,True,0,7,-7,24,4,2
1,00:09:53,1,True,0,7,-7,30,10,2
1,00:08:44,1,True,0,7,-7,6,6,2
1,00:02:23,2,False,10,0,10,43,11,2
1,00:01:46,1,False,10,1,9,35,10,2
2,00:13:55,2,False,12,1,11,48,5,2
2,00:13:03,1,True,1,12,-11,29,10,2
2,00:11:58,1,False,12,1,11,31,10,2
2,00:07:32,2,False,12,1,11,52,6,2
2,00:06:39,1,True,1,12,-11,39,10,2
2,00:06:16,2,True,1,12,-11,39,10,2
2,00:03:24,1,False,12,8,4,52,10,2
3,00:12:23,2,False,15,22,-7,35,9,2
3,00:10:12,1,False,15,22,-7,26,10,2
4,00:08:40,1,False,15,36,-21,41,15,2
4,00:06:45,1,True,36,15,21,25,10,2
4,00:01:48,2,False,22,43,-21,46,5,2
4,00:01:24,1,True,43,22,21,30,10,2
1,00:14:54,1,True,0,0,0,39,10,2
1,00:13:55,1,False,0,0,0,36,10,2
1,00:11:56,2,False,0,0,0,53,8,2
1,00:05:40,1,True,0,7,-7,55,10,2
2,00:15:00,1,True,0,14,-14,54,10,2
2,00:11:56,1,True,0,14,-14,25,10,2
2,00:08:07,1,True,0,16,-16,21,10,2
2,00:05:48,2,True,0,16,-16,34,6,2
2,00:02:48,2,True,0,16,-16,48,6,2
2,00:01:32,2,False,16,0,16,15,1,2
2,00:00:36,1,True,3,16,-13,54,10,2
3,00:14:28,2,False,16,3,13,43,9,2
3,00:00:46,2,False,23,10,13,47,4,2
4,00:13:01,1,False,23,10,13,52,20,2
4,00:09:25,1,False,23,17,6,25,10,2
4,00:05:25,2,True,20,23,-3,35,9,2
4,00:02:45,1,True,27,23,4,34,10,2
4,00:02:34,2,True,27,23,4,34,10,2
4,00:00:18,1,False,24,27,-3,17,10,2
4,00:00:14,2,False,24,27,-3,17,10,2
4,00:00:08,3,False,24,27,-3,17,10,2
1,00:07:36,2,False,3,0,3,40,6,2
1,00:00:58,2,True,3,3,0,30,6,2
1,00:00:12,1,False,3,3,0,29,10,2
2,00:14:03,1,False,3,3,0,52,10,2
2,00:09:55,2,True,10,3,7,48,7,2
2,00:09:17,1,True,10,3,7,14,10,2
2,00:08:39,1,True,10,3,7,5,5,2
2,00:06:50,2,True,10,6,4,35,10,2
2,00:05:39,1,True,10,6,4,46,10,2
2,00:02:57,2,True,10,6,4,27,9,2
2,00:01:40,2,True,10,6,4,25,12,2
2,00:01:06,1,True,10,9,1,12,10,2
2,00:00:36,0,False,15,10,5,5,0,2
3,00:14:15,2,False,15,10,5,27,6,2
3,00:12:49,1,False,15,13,2,51,10,2
3,00:12:34,2,False,15,13,2,51,10,2
3,00:03:07,1,True,19,15,4,23,10,2
4,00:15:00,2,True,19,18,1,44,22,2
4,00:12:42,1,True,19,18,1,38,10,2
4,00:11:04,2,False,18,19,-1,35,3,2
4,00:08:22,2,True,22,18,4,31,6,2
4,00:01:35,2,False,25,29,-4,25,14,2
1,00:14:51,1,True,0,0,0,44,10,2
1,00:12:34,1,True,0,0,0,50,10,2
1,00:09:51,2,False,0,7,-7,46,7,2
1,00:06:34,2,False,0,7,-7,21,8,2
1,00:05:41,1,False,0,7,-7,25,10,2
1,00:05:29,2,False,0,7,-7,25,10,2
1,00:02:49,1,False,0,7,-7,35,10,2
1,00:02:28,2,False,0,7,-7,35,10,2
1,00:01:13,2,False,0,10,-10,37,8,2
2,00:14:47,2,True,10,0,10,51,12,2
2,00:03:49,1,True,11,14,-3,32,10,2
2,00:03:21,2,True,11,14,-3,32,10,2
3,00:14:02,2,False,15,11,4,48,4,2
3,00:11:58,1,True,11,15,-4,46,10,2
3,00:08:41,1,False,15,11,4,11,10,2
3,00:05:33,2,False,15,17,-2,36,8,2
3,00:04:45,1,True,17,15,2,29,10,2
3,00:03:26,2,False,15,17,-2,17,10,2
3,00:02:13,2,False,15,17,-2,53,11,2
4,00:12:33,2,True,19,15,4,34,10,2
4,00:10:14,2,False,15,19,-4,33,6,2
4,00:08:08,2,False,15,20,-5,52,8,2
4,00:02:15,1,True,20,23,-3,53,10,2
4,00:01:59,2,True,20,23,-3,53,10,2
4,00:01:52,3,True,20,23,-3,53,10,2
1,00:14:53,1,False,0,0,0,26,10,2
1,00:07:26,2,True,0,3,-3,53,8,2
1,00:03:10,1,False,3,0,3,10,5,2
2,00:12:57,1,False,4,7,-3,43,10,2
2,00:12:38,2,False,4,7,-3,43,10,2
2,00:11:34,2,False,4,7,-3,15,7,2
2,00:09:17,2,False,4,7,-3,38,9,2
2,00:07:10,2,False,4,10,-6,50,6,2
2,00:02:30,2,False,4,17,-13,47,8,2
2,00:01:19,2,True,17,4,13,33,12,2
3,00:13:28,1,False,4,17,-13,40,10,2
3,00:11:00,2,True,17,4,13,44,5,2
3,00:08:59,1,False,4,17,-13,55,10,2
3,00:06:24,1,True,17,4,13,26,10,2
3,00:06:00,2,True,17,4,13,26,10,2
3,00:04:29,1,True,17,4,13,14,10,2
3,00:04:02,2,True,17,4,13,14,10,2
3,00:01:55,1,True,17,7,10,52,10,2
4,00:15:00,2,False,7,17,-10,35,10,2
4,00:14:30,1,True,17,7,10,44,10,2
4,00:10:00,2,False,7,20,-13,32,13,2
4,00:06:58,2,False,7,20,-13,9,9,2
4,00:05:45,2,False,7,23,-16,40,5,2
4,00:04:27,2,True,23,7,16,37,5,2
4,00:03:54,1,False,7,23,-16,40,10,2
1,00:14:16,2,True,0,0,0,30,7,2
1,00:11:22,2,False,0,0,0,52,5,2
1,00:10:36,1,False,0,0,0,8,10,2
1,00:07:47,1,True,3,0,3,37,10,2
1,00:06:27,1,True,3,0,3,24,10,2
1,00:06:02,2,True,3,0,3,24,10,2
1,00:03:47,1,True,3,0,3,53,10,2
1,00:03:28,2,True,3,0,3,53,10,2
2,00:14:26,1,False,3,3,0,33,10,2
2,00:09:06,1,True,6,3,3,16,10,2
2,00:05:20,2,True,6,10,-4,32,3,2
2,00:03:53,2,False,10,6,4,51,12,2
2,00:03:17,1,True,6,10,-4,1,10,2
2,00:02:40,1,True,6,10,-4,14,10,2
2,00:02:20,2,True,6,10,-4,14,10,2
2,00:00:39,1,True,6,17,-11,21,10,2
2,00:00:38,2,True,6,17,-11,21,10,2
2,00:00:28,1,True,6,17,-11,40,10,2
3,00:12:05,1,True,6,20,-14,52,10,2
3,00:11:40,2,True,6,20,-14,52,10,2
4,00:12:31,1,False,30,6,24,48,10,2
4,00:12:20,2,False,30,6,24,48,10,2
4,00:11:00,2,False,30,7,23,37,8,2
4,00:07:35,2,False,30,7,23,19,5,2
4,00:03:12,2,True,7,37,-30,45,4,2
4,00:00:45,1,True,7,37,-30,1,10,2
4,00:00:34,1,True,7,37,-30,12,10,2
1,00:14:30,2,False,0,0,0,47,6,2
1,00:13:47,1,True,0,0,0,13,10,2
1,00:13:29,2,True,0,0,0,13,10,2
1,00:12:48,1,True,0,0,0,49,10,2
1,00:12:38,2,True,0,0,0,49,10,2
1,00:11:15,1,True,0,0,0,14,10,2
1,00:10:06,2,True,0,0,0,30,7,2
1,00:08:28,1,True,0,0,0,18,10,2
1,00:08:02,2,True,0,0,0,18,10,2
1,00:01:13,1,False,10,3,7,35,10,2
1,00:00:53,2,False,10,3,7,35,10,2
2,00:13:25,2,True,3,10,-7,36,5,2
2,00:02:20,1,True,10,13,-3,35,10,2
3,00:11:38,1,False,13,10,3,34,10,2
3,00:09:47,1,False,13,10,3,24,10,2
3,00:08:36,2,False,13,10,3,4,4,2
3,00:03:38,2,True,13,16,-3,38,7,2
3,00:02:57,1,False,16,13,3,45,10,2
4,00:03:10,1,False,23,26,-3,50,10,2
1,00:13:25,1,True,0,0,0,50,10,2
1,00:10:56,2,True,0,0,0,23,9,2
1,00:09:08,2,True,0,0,0,33,9,2
1,00:05:45,2,True,0,1,-1,54,7,2
1,00:00:01,1,True,0,2,-2,29,10,2
2,00:09:58,2,False,2,0,2,20,10,2
2,00:05:31,1,False,2,0,2,32,10,2
3,00:14:29,1,False,2,0,2,41,10,2
3,00:13:51,2,False,2,0,2,41,10,2
3,00:12:44,1,False,2,0,2,22,10,2
3,00:12:26,2,False,2,0,2,22,10,2
3,00:10:48,1,True,3,2,1,51,10,2
3,00:10:26,2,True,3,2,1,51,10,2
3,00:09:28,2,False,2,3,-1,20,9,2
3,00:08:02,2,False,2,3,-1,28,7,2
3,00:01:36,1,False,9,6,3,35,10,2
3,00:00:13,2,False,9,6,3,15,8,2
4,00:12:55,2,False,9,6,3,51,3,2
4,00:12:07,1,True,6,9,-3,23,10,2
4,00:11:55,2,True,6,9,-3,23,10,2
4,00:10:59,2,True,6,9,-3,45,3,2
4,00:08:52,1,True,6,10,-4,46,10,2
4,00:08:15,2,True,6,10,-4,46,10,2
4,00:06:39,2,True,6,10,-4,50,10,2
4,00:03:35,1,True,6,10,-4,54,10,2
4,00:02:43,1,False,10,6,4,46,10,2
4,00:00:10,1,True,13,10,3,25,10,2
1,00:11:24,1,False,0,0,0,20,10,2
1,00:11:08,2,False,0,0,0,20,10,2
2,00:13:49,2,False,7,3,4,22,6,2
2,00:02:26,1,False,14,13,1,54,10,2
3,00:05:50,2,True,16,24,-8,51,21,2
3,00:04:00,1,True,16,24,-8,42,10,2
4,00:15:00,1,False,25,16,9,45,10,2
4,00:11:05,2,False,25,23,2,55,5,2
4,00:05:57,2,False,25,23,2,38,8,2
4,00:03:46,2,True,26,25,1,48,6,2
1,00:14:50,1,True,0,0,0,41,10,2
1,00:12:19,2,True,0,0,0,50,8,2
1,00:07:16,2,False,0,0,0,6,6,2
2,00:12:00,1,True,6,7,-1,35,10,2
2,00:05:13,2,True,6,14,-8,45,8,2
2,00:02:06,1,True,6,22,-16,47,10,2
2,00:01:51,2,True,6,22,-16,47,10,2
2,00:01:19,2,False,22,6,16,35,4,2
3,00:07:12,2,True,13,22,-9,13,3,2
3,00:05:34,1,True,13,22,-9,42,10,2
3,00:05:11,2,True,13,22,-9,42,10,2
3,00:01:33,1,True,13,22,-9,34,15,2
4,00:06:54,1,True,13,25,-12,46,10,2
4,00:06:36,2,True,13,25,-12,46,10,2
4,00:03:29,2,True,13,25,-12,32,10,2
4,00:02:28,3,True,13,28,-15,42,3,2
4,00:00:56,2,True,13,35,-22,36,4,2
4,00:00:16,2,False,35,13,22,45,5,2
1,00:14:50,1,True,0,0,0,35,10,2
1,00:12:08,2,True,0,0,0,9,9,2
1,00:07:36,1,False,3,7,-4,34,10,2
1,00:05:55,2,True,7,3,4,46,5,2
1,00:03:54,1,False,3,7,-4,30,10,2
2,00:13:01,1,False,10,14,-4,24,10,2
2,00:12:37,2,False,10,14,-4,24,10,2
2,00:10:48,2,True,14,10,4,48,6,2
2,00:06:32,1,False,10,21,-11,43,10,2
2,00:03:00,2,False,10,21,-11,21,5,2
2,00:02:40,1,False,10,24,-14,35,10,2
3,00:14:29,1,False,17,24,-7,55,10,2
3,00:09:57,2,True,24,24,0,55,3,2
3,00:06:15,2,False,24,24,0,31,6,2
3,00:05:05,2,True,24,24,0,44,5,2
4,00:14:40,1,True,24,27,-3,55,10,2
4,00:14:06,2,True,24,27,-3,55,10,2
4,00:09:07,2,True,24,27,-3,53,6,2
4,00:01:22,2,True,24,27,-3,14,8,2
4,00:01:07,1,False,30,24,6,44,10,2
4,00:01:03,2,False,30,24,6,44,10,2
4,00:00:58,3,False,30,24,6,44,10,2
1,00:10:28,2,True,0,0,0,38,4,2
1,00:09:44,1,True,0,3,-3,35,10,2
1,00:05:31,1,False,3,7,-4,48,10,2
1,00:05:07,2,False,3,7,-4,48,10,2
1,00:01:39,1,False,3,7,-4,42,10,2
1,00:01:20,2,False,3,7,-4,42,10,2
2,00:13:33,2,False,3,7,-4,12,8,2
2,00:11:36,1,False,3,10,-7,50,10,2
2,00:10:22,1,False,3,10,-7,29,10,2
2,00:08:40,1,False,3,17,-14,34,10,2
2,00:06:30,2,False,3,17,-14,14,4,2
2,00:04:40,1,True,24,3,21,40,10,2
2,00:03:08,2,True,24,3,21,17,10,2
2,00:01:49,1,False,6,31,-25,33,10,2
2,00:01:43,2,False,6,31,-25,33,10,2
3,00:12:54,1,True,31,6,25,52,10,2
3,00:11:35,1,False,6,31,-25,22,10,2
3,00:10:52,1,False,6,31,-25,40,10,2
3,00:10:20,2,False,6,31,-25,40,10,2
3,00:07:53,1,False,6,31,-25,37,10,2
3,00:04:09,1,True,31,6,25,29,10,2
3,00:02:00,2,True,31,13,18,45,10,2
3,00:00:40,1,True,31,13,18,26,10,2
3,00:00:01,2,True,31,13,18,26,10,2
4,00:14:48,1,True,31,16,15,35,10,2
4,00:13:22,1,False,16,31,-15,23,10,2
4,00:11:54,2,False,16,31,-15,45,4,2
4,00:02:38,1,True,45,16,29,32,10,2
4,00:02:23,1,True,45,16,29,16,10,2
1,00:13:34,1,True,0,0,0,52,10,2
1,00:13:17,2,True,0,0,0,52,10,2
1,00:11:17,2,False,0,0,0,53,12,2
1,00:09:29,2,False,0,0,0,36,5,2
1,00:04:13,1,True,3,0,3,8,8,2
1,00:01:25,1,False,7,3,4,42,10,2
1,00:01:00,2,False,7,3,4,42,10,2
2,00:10:20,1,True,3,14,-11,49,10,2
2,00:06:18,1,False,14,10,4,24,10,2
2,00:02:47,1,False,14,13,1,27,10,2
2,00:01:25,2,False,14,13,1,51,6,2
2,00:01:04,1,False,14,13,1,33,10,2
3,00:12:49,2,True,13,14,-1,35,12,2
3,00:11:51,1,False,14,13,1,50,10,2
3,00:11:32,2,False,14,13,1,50,10,2
3,00:10:19,2,True,13,14,-1,30,18,2
3,00:09:30,1,False,14,13,1,30,10,2
3,00:08:09,2,True,13,14,-1,27,10,2
3,00:05:12,1,True,13,14,-1,12,10,2
3,00:04:57,2,True,13,14,-1,12,10,2
3,00:02:38,2,True,13,14,-1,17,9,2
3,00:00:58,2,True,13,14,-1,7,7,2
3,00:00:01,1,True,13,17,-4,29,10,2
4,00:15:00,2,True,13,17,-4,29,10,2
4,00:13:44,2,False,17,13,4,41,9,2
4,00:09:53,2,False,17,13,4,33,13,2
4,00:09:17,1,False,17,16,1,35,10,2
4,00:02:22,1,False,24,22,2,5,5,2
1,00:14:52,1,False,0,0,0,35,10,2
1,00:12:20,2,True,0,0,0,46,13,2
1,00:10:40,1,True,0,0,0,19,10,2
1,00:09:00,2,False,0,0,0,46,5,2
2,00:13:23,1,False,3,7,-4,50,10,2
2,00:13:09,2,False,3,7,-4,50,10,2
2,00:11:47,2,False,3,7,-4,49,5,2
2,00:11:16,1,False,3,7,-4,20,10,2
2,00:10:57,2,False,3,7,-4,20,10,2
2,00:10:25,1,False,3,7,-4,52,10,2
2,00:10:14,2,False,3,7,-4,52,10,2
2,00:07:51,1,True,7,3,4,26,10,2
2,00:06:34,1,False,3,7,-4,54,10,2
2,00:05:50,1,True,7,3,4,29,10,2
2,00:04:10,1,True,7,4,3,35,10,2
2,00:02:05,2,True,7,4,3,9,7,2
2,00:01:43,3,True,7,4,3,9,7,2
2,00:01:12,2,True,7,4,3,23,7,2
3,00:10:14,2,False,4,10,-6,45,16,2
3,00:06:40,1,False,4,10,-6,30,10,2
3,00:03:49,1,True,11,4,7,38,10,2
3,00:00:47,1,False,4,11,-7,25,10,2
3,00:00:20,2,False,4,11,-7,20,15,2
4,00:14:47,1,True,11,4,7,44,15,2
4,00:14:31,2,True,11,4,7,44,15,2
4,00:07:30,2,True,11,4,7,40,7,2
4,00:06:54,1,False,4,11,-7,42,10,2
4,00:03:07,1,True,11,4,7,23,10,2
4,00:02:38,1,True,11,11,0,38,10,2
4,00:00:08,1,True,11,14,-3,35,10,2
4,00:00:01,2,True,11,14,-3,35,10,2
1,00:14:53,1,False,0,0,0,33,10,2
1,00:13:49,1,True,0,0,0,35,10,2
1,00:10:55,2,False,0,0,0,42,7,2
1,00:06:50,2,False,0,0,0,45,12,2
1,00:02:07,1,False,7,0,7,22,10,2
2,00:14:40,1,False,7,7,0,20,10,2
2,00:14:10,3,False,7,7,0,20,10,2
2,00:10:18,1,True,7,7,0,38,10,2
2,00:02:55,2,True,7,10,-3,39,10,2
2,00:00:51,2,False,17,7,10,29,2,2
3,00:14:15,1,True,7,17,-10,43,10,2
3,00:13:32,1,True,7,17,-10,34,10,2
3,00:12:08,1,True,7,20,-13,35,10,2
3,00:11:46,2,True,7,20,-13,35,10,2
3,00:10:30,2,False,20,7,13,27,6,2
3,00:03:21,1,True,14,20,-6,55,10,2
4,00:15:00,1,True,21,20,1,30,10,2
4,00:13:30,2,True,21,20,1,19,14,2
4,00:09:08,1,False,23,21,2,50,10,2
4,00:08:47,2,False,23,21,2,50,10,2
4,00:08:08,1,False,23,21,2,19,10,2
4,00:04:29,2,False,23,28,-5,40,10,2
4,00:02:10,2,False,23,28,-5,33,9,2
1,00:14:17,2,False,0,0,0,37,9,2
1,00:12:29,2,False,0,7,-7,39,9,2
1,00:10:14,2,True,7,0,7,55,5,2
1,00:02:20,1,True,10,0,10,15,10,2
1,00:01:59,2,True,10,0,10,15,10,2
2,00:15:00,1,False,7,10,-3,27,10,2
2,00:14:34,2,False,7,10,-3,27,10,2
2,00:08:25,2,True,10,14,-4,23,9,2
2,00:05:39,1,True,10,14,-4,48,10,2
2,00:05:19,2,True,10,14,-4,48,10,2
2,00:03:00,2,True,10,14,-4,41,6,2
2,00:01:39,2,True,10,14,-4,41,4,2
2,00:00:11,1,True,10,14,-4,49,10,2
3,00:14:08,1,False,14,10,4,42,10,2
3,00:12:32,1,True,10,14,-4,52,10,2
3,00:06:52,2,True,10,21,-11,40,4,2
3,00:03:03,1,True,10,21,-11,50,10,2
4,00:07:16,1,True,17,21,-4,36,10,2
4,00:01:40,1,True,17,21,-4,28,10,2
4,00:00:45,1,False,21,17,4,52,10,2
4,00:00:37,2,False,21,17,4,52,10,2
4,00:00:30,3,False,21,17,4,52,10,2
1,00:10:22,1,False,0,7,-7,50,10,2
1,00:09:45,2,False,0,7,-7,55,5,2
1,00:06:54,2,True,7,0,7,46,3,2
1,00:03:42,1,True,7,0,7,51,10,2
1,00:00:10,1,False,0,14,-14,30,10,2
2,00:12:42,1,True,14,0,14,19,10,2
2,00:09:55,1,False,3,14,-11,46,10,2
2,00:07:15,2,False,3,14,-11,34,18,2
2,00:05:00,2,True,17,3,14,52,7,2
2,00:02:50,1,False,4,17,-13,51,10,2
2,00:02:32,2,False,4,17,-13,51,10,2
2,00:00:55,2,True,17,4,13,35,5,2
3,00:13:10,1,True,17,7,10,30,10,2
3,00:11:04,1,True,17,7,10,7,7,2
3,00:10:41,2,True,17,7,10,7,7,2
3,00:09:13,2,True,17,10,7,31,6,2
3,00:07:03,1,False,10,17,-7,44,10,2
3,00:05:25,1,True,17,10,7,42,10,2
3,00:03:05,1,True,17,17,0,26,10,2
4,00:14:34,2,False,17,17,0,33,5,2
4,00:13:07,1,False,17,17,0,28,10,2
4,00:08:26,1,True,17,17,0,18,10,2
4,00:08:08,2,True,17,17,0,18,10,2
4,00:07:19,1,True,17,20,-3,34,10,2
4,00:06:12,1,True,17,20,-3,5,5,2
4,00:04:24,1,True,17,20,-3,37,10,2
4,00:04:03,2,True,17,20,-3,37,10,2
4,00:02:17,2,False,20,17,3,51,7,2
4,00:01:59,1,False,20,17,3,34,10,2
4,00:01:43,2,False,20,17,3,34,10,2
4,00:01:28,1,False,20,20,0,46,10,2
1,00:14:18,1,True,0,0,0,33,10,2
1,00:13:35,1,False,0,0,0,21,10,2
1,00:12:47,1,False,0,0,0,32,10,2
1,00:08:17,1,False,3,0,3,51,10,2
2,00:13:03,1,False,6,14,-8,52,10,2
2,00:12:16,1,False,6,14,-8,29,10,2
2,00:09:26,2,False,6,21,-15,34,5,2
2,00:08:34,1,True,21,6,15,49,10,2
2,00:08:21,2,True,21,6,15,49,10,2
2,00:06:39,1,False,6,21,-15,27,10,2
2,00:06:09,2,False,6,21,-15,27,10,2
2,00:04:23,1,False,6,21,-15,48,10,2
2,00:02:25,1,True,21,6,15,21,10,2
2,00:01:58,2,True,21,6,15,38,10,2
3,00:13:35,1,False,13,21,-8,54,10,2
3,00:13:26,2,False,13,21,-8,54,10,2
3,00:07:29,1,True,28,13,15,38,10,2
4,00:09:50,2,True,35,16,19,40,5,2
4,00:02:19,1,False,23,38,-15,35,10,2
4,00:00:55,1,False,23,41,-18,35,10,2
1,00:14:49,1,False,0,0,0,43,10,2
1,00:14:02,2,False,0,0,0,48,5,2
1,00:11:44,1,False,0,0,0,47,10,2
1,00:11:33,2,False,0,0,0,47,10,2
1,00:05:13,2,True,1,0,1,29,5,2
1,00:01:20,2,False,7,1,6,26,9,2
2,00:12:49,1,False,14,4,10,51,10,2
2,00:12:30,2,False,14,4,10,51,10,2
2,00:10:44,1,False,14,4,10,47,10,2
2,00:03:56,1,False,15,4,11,45,10,2
2,00:03:14,1,False,15,4,11,18,10,2
2,00:01:45,2,False,15,4,11,20,9,2
2,00:01:05,1,False,15,7,8,36,10,2
3,00:14:52,1,True,7,22,-15,40,10,2
3,00:11:51,1,True,7,23,-16,35,10,2
3,00:10:09,2,False,23,7,16,45,5,2
3,00:09:33,1,False,23,7,16,19,10,2
3,00:09:16,2,False,23,7,16,19,10,2
3,00:08:32,1,False,23,7,16,35,10,2
3,00:06:52,2,False,23,7,16,12,9,2
3,00:05:13,2,False,23,10,13,41,5,2
3,00:04:10,1,True,10,23,-13,24,15,2
4,00:13:48,1,True,10,23,-13,14,10,2
4,00:13:28,2,True,10,23,-13,14,10,2
4,00:10:57,3,False,26,10,16,47,4,2
4,00:08:15,2,True,10,26,-16,44,7,2
4,00:06:30,2,False,26,10,16,45,9,2
4,00:05:40,1,True,10,26,-16,33,10,2
4,00:04:46,1,False,26,10,16,50,10,2
4,00:02:50,2,False,26,10,16,50,6,2
4,00:02:26,1,True,10,26,-16,51,10,2
4,00:01:40,3,False,26,10,16,54,15,2
4,00:00:24,1,True,10,26,-16,33,10,2
1,00:13:42,2,True,0,0,0,32,11,2
1,00:13:12,1,False,0,0,0,51,10,2
1,00:12:59,2,False,0,0,0,51,10,2
1,00:09:09,1,False,0,0,0,25,10,2
1,00:07:54,1,True,0,0,0,32,10,2
1,00:02:25,2,True,0,0,0,54,9,2
1,00:01:42,1,False,0,0,0,13,10,2
1,00:01:28,2,False,0,0,0,13,10,2
2,00:12:24,2,True,7,0,7,30,13,2
2,00:11:11,2,False,0,7,-7,43,12,2
3,00:12:11,1,False,9,14,-5,52,10,2
3,00:02:25,2,False,16,14,2,49,6,2
4,00:13:08,1,False,16,14,2,25,10,2
4,00:13:02,2,False,16,14,2,25,10,2
4,00:12:22,1,True,14,16,-2,53,10,2
4,00:12:00,2,True,14,16,-2,53,10,2
4,00:09:30,2,True,14,16,-2,27,8,2
4,00:06:29,1,True,14,16,-2,24,10,2
4,00:01:54,3,True,14,16,-2,40,6,2
4,00:00:01,1,True,14,19,-5,51,10,2
1,00:14:45,1,False,0,0,0,37,10,2
1,00:14:34,2,False,0,0,0,37,10,2
1,00:13:30,2,False,0,0,0,48,9,2
1,00:05:56,1,False,0,14,-14,51,10,2
1,00:05:39,2,False,0,14,-14,51,10,2
1,00:04:24,1,True,14,0,14,53,10,2
1,00:02:13,1,False,0,14,-14,10,10,2
1,00:01:57,2,False,0,14,-14,10,10,2
2,00:10:52,1,True,18,0,18,23,10,2
2,00:06:49,1,True,18,3,15,13,10,2
2,00:02:35,1,True,21,10,11,52,10,2
2,00:01:27,2,False,10,21,-11,33,9,2
3,00:07:17,1,False,13,24,-11,7,17,2
3,00:04:50,1,False,13,24,-11,51,10,2
3,00:01:29,1,False,13,31,-18,47,10,2
3,00:00:42,2,False,13,31,-18,52,5,2
4,00:15:00,2,False,13,31,-18,39,4,2
4,00:13:26,1,False,13,34,-21,48,10,2
4,00:12:39,1,False,13,34,-21,39,10,2
4,00:11:16,2,False,13,34,-21,19,7,2
4,00:10:37,1,False,13,37,-24,35,10,2
4,00:06:42,2,False,13,37,-24,43,8,2
4,00:04:50,2,False,13,37,-24,16,19,2
4,00:00:56,1,False,13,37,-24,26,10,2
1,00:09:12,1,True,7,0,7,15,10,2
1,00:04:46,1,False,0,7,-7,9,9,2
1,00:03:18,1,False,0,14,-14,18,20,2
1,00:02:56,2,False,0,14,-14,18,20,2
2,00:15:00,1,False,0,17,-17,35,10,2
2,00:13:46,1,False,0,17,-17,45,10,2
2,00:09:06,2,False,0,17,-17,28,8,2
2,00:08:23,1,True,17,0,17,41,10,2
2,00:08:12,2,True,17,0,17,41,10,2
2,00:06:20,2,False,0,17,-17,47,5,2
2,00:01:56,2,True,24,7,17,32,7,2
2,00:00:01,2,True,24,7,17,53,14,2
3,00:14:55,1,False,7,24,-17,27,10,2
3,00:07:56,2,True,31,7,24,49,5,2
3,00:07:30,1,True,31,7,24,39,10,2
3,00:05:40,1,True,31,14,17,37,10,2
3,00:01:11,2,True,38,14,24,15,6,2
4,00:06:00,2,False,14,45,-31,34,26,2
1,00:13:41,2,True,0,0,0,52,9,2
1,00:12:48,1,False,0,1,-1,35,10,2
1,00:04:01,1,False,0,1,-1,39,10,2
1,00:01:35,1,False,0,4,-4,51,10,2
2,00:13:21,1,True,11,0,11,45,10,2
2,00:12:58,2,True,11,0,11,45,10,2
2,00:08:33,2,False,0,11,-11,41,6,2
2,00:07:55,1,False,0,11,-11,8,10,2
2,00:07:35,2,False,0,11,-11,8,10,2
2,00:06:54,1,True,11,0,11,46,10,2
2,00:00:19,1,False,0,11,-11,52,10,2
2,00:00:13,2,False,0,11,-11,52,10,2
3,00:11:06,2,False,0,11,-11,19,11,2
3,00:10:28,1,False,0,14,-14,35,10,2
3,00:09:44,1,False,0,14,-14,50,10,2
3,00:09:20,2,False,0,14,-14,50,10,2
3,00:08:12,2,True,14,0,14,39,11,2
3,00:07:00,2,False,0,14,-14,40,7,2
3,00:05:11,2,True,14,0,14,42,8,2
3,00:03:17,1,False,0,15,-15,45,10,2
4,00:12:50,1,False,1,22,-21,27,10,2
4,00:07:19,1,False,1,29,-28,22,10,2
4,00:06:55,2,False,1,29,-28,22,10,2
4,00:05:50,1,False,1,29,-28,22,20,2
4,00:05:28,2,False,1,29,-28,22,20,2
4,00:02:19,1,False,1,29,-28,18,10,2
4,00:02:15,2,False,1,29,-28,18,10,2
4,00:00:57,1,False,1,29,-28,29,10,2
4,00:00:46,2,False,1,29,-28,29,10,2
4,00:00:30,1,True,29,1,28,24,10,2
1,00:08:42,1,True,7,0,7,34,10,2
1,00:07:47,1,True,7,0,7,24,10,2
1,00:04:44,1,False,7,7,0,32,10,2
1,00:04:22,2,False,7,7,0,32,10,2
2,00:13:19,1,True,14,7,7,4,4,2
2,00:09:59,1,True,14,10,4,53,5,2
2,00:06:42,2,True,14,13,1,36,2,2
2,00:03:08,1,False,13,14,-1,40,10,2
3,00:14:10,2,False,13,17,-4,41,5,2
3,00:12:54,2,True,17,13,4,37,6,2
3,00:11:35,2,True,17,13,4,48,9,2
3,00:07:08,1,False,13,17,-4,12,10,2
3,00:05:46,2,False,13,17,-4,25,10,2
3,00:02:09,1,True,17,13,4,29,10,2
3,00:00:31,1,True,17,13,4,17,10,2
4,00:07:32,1,False,27,17,10,51,10,2
4,00:06:19,2,False,27,17,10,41,20,2
4,00:01:41,2,False,27,20,7,33,3,2
1,00:13:23,1,False,0,0,0,44,10,2
1,00:09:12,1,True,3,0,3,51,10,2
1,00:04:09,1,True,12,0,12,44,15,2
1,00:01:00,2,False,0,12,-12,28,22,2
2,00:11:43,1,False,0,19,-19,3,10,2
2,00:10:23,2,False,0,19,-19,23,6,2
2,00:07:53,1,False,0,21,-21,47,10,2
2,00:04:39,2,False,1,21,-20,43,10,2
2,00:01:04,1,False,1,24,-23,35,10,2
2,00:00:41,1,False,1,24,-23,51,10,2
3,00:14:19,1,False,1,24,-23,43,10,2
3,00:10:08,2,False,1,24,-23,28,8,2
3,00:04:15,1,False,3,31,-28,35,10,2
4,00:14:24,1,True,31,3,28,28,10,2
4,00:13:44,1,True,31,3,28,18,10,2
4,00:12:15,2,True,31,3,28,12,5,2
4,00:08:32,1,True,31,3,28,4,4,2
4,00:08:14,2,True,31,3,28,4,4,2
4,00:05:15,1,False,10,31,-21,55,10,2
4,00:04:48,2,False,10,31,-21,55,10,2
1,00:14:55,1,True,0,0,0,34,10,2
1,00:14:31,2,True,0,0,0,34,10,2
1,00:13:37,1,False,0,0,0,48,10,2
1,00:00:32,1,True,7,14,-7,8,8,2
2,00:11:55,2,False,21,7,14,49,6,2
2,00:03:03,1,True,14,21,-7,38,10,2
2,00:00:13,1,False,21,14,7,40,10,2
3,00:13:12,1,True,17,21,-4,50,10,2
3,00:11:13,2,False,21,17,4,9,9,2
3,00:08:10,1,True,20,21,-1,41,20,2
3,00:05:21,2,True,20,22,-2,38,7,2
3,00:04:42,1,False,22,20,2,33,10,2
3,00:04:20,2,False,22,20,2,33,10,2
3,00:03:28,1,True,20,22,-2,37,10,2
3,00:02:47,1,True,20,22,-2,49,10,2
3,00:02:15,1,True,20,22,-2,39,10,2
4,00:11:47,2,True,20,25,-5,12,6,2
4,00:10:52,1,False,28,26,2,5,5,2
4,00:08:06,1,True,26,28,-2,27,10,2
4,00:06:33,1,False,28,26,2,30,20,2
4,00:06:10,2,False,28,26,2,30,20,2
4,00:02:25,1,False,28,33,-5,45,10,2
4,00:00:23,2,False,28,36,-8,38,7,2
4,00:00:11,3,False,28,36,-8,28,17,2
1,00:08:22,2,True,0,0,0,42,6,2
1,00:06:30,2,False,0,7,-7,27,15,2
1,00:03:14,1,False,0,7,-7,43,10,2
1,00:01:09,1,False,0,14,-14,34,10,2
1,00:00:42,2,False,0,14,-14,24,20,2
2,00:09:58,1,True,14,0,14,8,10,2
2,00:05:00,1,False,0,14,-14,43,10,2
2,00:04:08,1,False,0,14,-14,27,10,2
2,00:03:52,2,False,0,14,-14,27,10,2
2,00:02:31,2,False,0,17,-17,48,8,2
2,00:01:53,2,True,17,0,17,29,9,2
2,00:01:26,1,False,0,17,-17,37,10,2
2,00:00:23,2,False,0,17,-17,20,1,2
3,00:11:42,1,True,20,0,20,40,10,2
3,00:09:56,2,True,20,0,20,16,10,2
3,00:09:11,1,True,20,3,17,23,10,2
3,00:07:55,1,False,3,20,-17,52,10,2
3,00:06:31,1,True,20,3,17,54,10,2
3,00:02:46,1,True,20,3,17,24,10,2
3,00:01:06,1,True,20,3,17,48,10,2
4,00:07:30,2,False,3,21,-18,49,11,2
4,00:03:32,2,False,3,21,-18,41,7,2
4,00:01:30,1,True,24,3,21,7,7,2
4,00:01:28,2,True,24,3,21,7,7,2
4,00:01:20,1,True,24,9,15,5,0,2
1,00:11:18,1,False,0,0,0,42,10,2
1,00:11:03,2,False,0,0,0,42,10,2
1,00:06:52,2,False,0,7,-7,34,5,2
1,00:05:57,1,False,0,7,-7,37,10,2
1,00:00:01,2,True,7,7,0,48,7,2
2,00:11:39,1,False,7,7,0,15,15,2
2,00:11:20,2,False,7,7,0,15,15,2
2,00:08:42,2,False,7,7,0,6,6,2
2,00:07:44,1,False,7,10,-3,47,10,2
2,00:01:36,1,False,10,10,0,28,10,2
2,00:01:30,2,False,10,10,0,28,10,2
3,00:14:32,2,True,10,10,0,23,4,2
3,00:13:02,1,True,10,10,0,22,10,2
3,00:06:55,1,False,17,13,4,35,10,2
3,00:06:29,2,False,17,13,4,35,10,2
3,00:04:40,2,True,13,17,-4,42,5,2
3,00:02:48,1,False,17,13,4,48,10,2
3,00:02:37,2,False,17,13,4,48,10,2
3,00:01:22,2,True,13,17,-4,28,6,2
3,00:00:24,1,False,17,13,4,45,10,2
4,00:12:32,1,True,13,17,-4,10,10,2
4,00:07:20,2,False,24,21,3,31,8,2
4,00:00:19,2,True,28,24,4,12,4,2
4,00:00:08,1,True,28,24,4,5,5,2
1,00:14:24,2,True,0,0,0,35,3,2
1,00:13:39,1,False,0,0,0,38,10,2
1,00:13:22,2,False,0,0,0,38,10,2
1,00:08:54,1,False,0,7,-7,50,10,2
1,00:05:04,2,True,7,0,7,18,7,2
1,00:02:43,2,True,7,0,7,42,8,2
1,00:00:01,1,False,0,7,-7,12,10,2
2,00:15:00,2,False,0,7,-7,12,10,2
2,00:08:34,1,True,17,0,17,31,10,2
2,00:06:12,1,True,17,0,17,28,10,2
2,00:05:51,2,True,17,0,17,28,10,2
2,00:01:41,2,False,1,17,-16,37,2,2
3,00:12:29,1,True,17,1,16,31,10,2
3,00:04:16,1,True,25,8,17,33,10,2
4,00:13:40,1,False,15,28,-13,51,10,2
4,00:12:41,1,True,28,15,13,48,10,2
4,00:08:26,0,True,34,15,19,5,0,2
4,00:03:20,1,True,41,15,26,47,10,2
4,00:00:03,2,True,48,15,33,30,1,2
1,00:13:37,1,True,0,0,0,30,10,2
1,00:12:55,1,True,0,0,0,13,10,2
1,00:07:09,1,True,7,3,4,17,10,2
1,00:04:09,1,False,10,7,3,39,10,2
1,00:03:00,1,True,7,10,-3,30,10,2
1,00:00:29,1,False,10,7,3,18,10,2
1,00:00:01,2,False,10,7,3,18,10,2
2,00:13:03,2,True,10,10,0,47,18,2
2,00:08:50,1,True,10,10,0,45,10,2
2,00:08:40,2,True,10,10,0,45,10,2
2,00:00:25,2,True,13,16,-3,23,4,2
3,00:06:32,2,True,20,19,1,20,5,2
3,00:04:36,2,True,20,22,-2,37,6,2
4,00:13:10,1,False,22,23,-1,25,10,2
4,00:10:04,2,False,22,30,-8,45,7,2
4,00:08:37,1,True,30,28,2,5,0,2
4,00:07:20,2,True,30,28,2,29,6,2
4,00:06:43,1,False,28,30,-2,38,10,2
4,00:03:50,2,True,30,28,2,55,5,2
4,00:02:39,2,False,28,30,-2,15,10,2
4,00:02:18,1,False,28,33,-5,35,10,2
4,00:01:02,2,True,33,28,5,29,5,2
4,00:00:44,1,True,33,28,5,18,10,2
4,00:00:39,2,True,33,28,5,18,10,2
4,00:00:29,1,True,33,34,-1,5,0,2
4,00:00:22,1,True,33,34,-1,22,10,2
4,00:00:18,2,True,33,34,-1,22,10,2
4,00:00:01,2,False,34,33,1,54,3,2
1,00:13:18,1,True,0,0,0,40,10,2
1,00:12:00,1,False,0,0,0,31,10,2
1,00:11:48,2,False,0,0,0,31,10,2
1,00:03:26,1,True,0,0,0,50,10,2
1,00:01:41,2,False,0,0,0,44,4,2
1,00:00:33,2,False,0,1,-1,41,4,2
2,00:14:30,2,True,1,0,1,33,6,2
2,00:12:43,2,False,0,1,-1,32,22,2
2,00:12:05,1,True,1,0,1,35,10,2
2,00:11:55,2,True,1,0,1,35,10,2
2,00:11:12,1,False,0,1,-1,34,10,2
2,00:09:04,2,True,1,0,1,53,8,2
2,00:04:54,2,False,7,1,6,43,10,2
2,00:02:40,1,False,7,1,6,47,10,2
2,00:00:50,1,False,7,1,6,20,10,2
3,00:12:05,2,False,7,10,-3,29,16,2
4,00:08:15,1,False,8,25,-17,40,10,2
4,00:07:36,1,True,25,8,17,38,10,2
4,00:06:14,2,True,25,8,17,26,13,2
4,00:05:36,1,True,25,11,14,35,10,2
4,00:05:14,2,True,25,11,14,35,10,2
4,00:04:29,1,False,11,25,-14,45,10,2
4,00:04:04,2,False,11,25,-14,45,10,2
1,00:12:34,1,False,0,3,-3,35,10,2
1,00:10:59,1,True,3,0,3,37,10,2
1,00:05:35,2,False,3,3,0,14,9,2
1,00:04:25,1,False,3,6,-3,30,15,2
1,00:02:52,2,True,6,3,3,41,6,2
2,00:11:02,2,False,10,6,4,27,7,2
2,00:03:02,2,False,17,6,11,51,7,2
2,00:02:02,1,True,6,17,-11,46,10,2
2,00:00:47,1,False,17,9,8,35,10,2
3,00:14:15,1,False,17,9,8,40,10,2
3,00:08:44,2,False,24,9,15,15,7,2
3,00:04:08,1,False,31,12,19,46,10,2
4,00:10:46,2,True,15,31,-16,5,5,2
4,00:06:19,2,True,15,34,-19,35,5,2
4,00:02:54,1,False,34,15,19,46,10,2
4,00:02:28,3,False,34,15,19,53,17,2
1,00:13:43,2,True,0,0,0,51,3,2
1,00:10:25,1,False,1,0,1,54,10,2
1,00:10:20,2,False,1,0,1,54,10,2
1,00:07:22,2,False,1,0,1,40,7,2
1,00:06:47,1,True,0,1,-1,20,10,2
1,00:03:16,1,True,0,1,-1,8,8,2
1,00:02:52,2,True,0,1,-1,8,8,2
1,00:01:17,2,True,0,4,-4,46,10,2
2,00:11:17,2,False,11,0,11,11,3,2
2,00:10:28,2,False,11,3,8,40,5,2
2,00:07:50,1,False,11,3,8,3,3,2
2,00:07:14,2,False,11,3,8,3,3,2
2,00:05:17,2,False,11,6,5,41,9,2
2,00:03:07,1,False,11,6,5,5,5,2
3,00:11:27,2,True,13,14,-1,20,6,2
3,00:06:28,1,False,14,13,1,45,10,2
3,00:04:35,1,True,13,14,-1,47,15,2
3,00:03:51,1,True,13,14,-1,11,10,2
3,00:00:01,2,True,13,16,-3,29,9,2
4,00:11:52,2,True,13,16,-3,23,7,2
4,00:11:14,1,True,13,19,-6,35,10,2
4,00:10:35,2,True,13,19,-6,25,20,2
4,00:08:12,2,True,13,19,-6,33,6,2
4,00:04:25,1,True,13,26,-13,51,10,2
4,00:03:36,1,False,26,13,13,34,10,2
4,00:01:51,1,True,13,26,-13,35,10,2
4,00:01:40,2,True,13,26,-13,25,20,2
4,00:00:27,1,True,13,26,-13,19,10,2
1,00:14:15,2,True,0,0,0,13,6,2
1,00:13:37,1,False,0,0,0,45,10,2
1,00:07:37,2,True,0,7,-7,31,7,2
1,00:06:02,1,True,0,7,-7,40,10,2
1,00:04:56,1,False,7,0,7,14,10,2
1,00:03:14,2,True,0,7,-7,45,9,2
1,00:02:10,2,False,7,0,7,27,13,2
2,00:10:37,1,True,0,7,-7,19,10,2
2,00:08:19,1,True,0,7,-7,2,2,2
2,00:08:06,2,True,0,7,-7,2,2,2
2,00:07:25,1,True,0,10,-10,35,10,2
2,00:07:11,2,True,0,10,-10,35,10,2
2,00:06:19,1,True,0,10,-10,45,10,2
2,00:02:15,1,True,0,13,-13,50,10,2
2,00:01:30,2,False,13,0,13,15,15,2
2,00:01:07,1,False,13,3,10,35,10,2
2,00:00:15,1,True,3,13,-10,52,10,2
3,00:13:46,1,False,13,3,10,36,10,2
3,00:09:06,2,True,3,13,-10,47,4,2
3,00:00:50,1,False,13,3,10,37,10,2
3,00:00:33,2,False,13,3,10,37,10,2
4,00:07:23,2,True,3,20,-17,31,14,2
4,00:02:30,2,True,3,26,-23,30,15,2
4,00:00:54,2,False,26,3,23,49,7,2
1,00:10:37,1,True,0,0,0,29,10,2
1,00:10:14,2,True,0,0,0,29,10,2
1,00:07:49,2,False,3,0,3,10,7,2
1,00:05:04,2,False,3,0,3,19,8,2
1,00:03:43,2,False,3,3,0,36,5,2
1,00:03:06,1,True,3,3,0,48,10,2
2,00:13:06,1,True,3,4,-1,35,10,2
2,00:12:52,2,True,3,4,-1,35,10,2
2,00:09:59,1,False,4,3,1,22,10,2
2,00:07:08,2,True,6,4,2,33,13,2
2,00:03:00,1,False,7,6,1,45,10,2
2,00:02:48,2,False,7,6,1,45,10,2
3,00:11:45,1,False,7,9,-2,49,10,2
3,00:11:37,2,False,7,9,-2,49,10,2
3,00:09:42,1,False,7,9,-2,36,10,2
3,00:09:18,2,False,7,9,-2,36,10,2
3,00:05:51,1,True,9,7,2,51,10,2
3,00:04:18,1,False,7,9,-2,28,10,2
4,00:12:43,1,True,12,14,-2,51,15,2
4,00:09:33,2,False,14,12,2,47,17,2
4,00:09:07,1,True,12,14,-2,15,10,2
4,00:08:20,1,True,12,14,-2,25,10,2
4,00:03:02,1,True,15,14,1,51,10,2
4,00:02:02,2,True,15,14,1,34,5,2
4,00:01:16,1,True,15,17,-2,46,10,2
4,00:00:20,1,False,17,18,-1,50,10,2
4,00:00:11,2,False,17,18,-1,50,10,2
1,00:12:31,2,True,0,1,-1,52,12,2
1,00:12:02,1,True,0,1,-1,16,10,2
1,00:10:36,2,True,0,1,-1,28,10,2
1,00:09:08,2,True,0,1,-1,51,12,2
1,00:08:31,1,True,0,1,-1,15,10,2
1,00:06:46,2,True,0,1,-1,49,9,2
1,00:05:30,2,True,0,1,-1,15,10,2
1,00:04:26,1,True,0,1,-1,48,10,2
1,00:02:50,2,True,0,1,-1,35,11,2
1,00:02:05,1,True,0,4,-4,35,10,2
1,00:00:28,2,True,0,4,-4,49,8,2
2,00:13:49,2,True,0,4,-4,52,2,2
2,00:02:24,1,True,7,4,3,47,10,2
2,00:02:07,2,True,7,4,3,47,10,2
2,00:01:11,2,False,4,7,-3,41,7,2
3,00:12:28,1,True,7,4,3,45,10,2
3,00:12:06,2,True,7,4,3,45,10,2
3,00:09:19,2,True,7,4,3,53,9,2
3,00:05:15,2,True,7,4,3,6,21,2
3,00:03:57,1,True,7,4,3,22,15,2
3,00:03:33,2,True,7,4,3,22,15,2
4,00:14:06,1,True,7,7,0,39,10,2
4,00:11:29,2,True,7,7,0,53,4,2
4,00:09:24,1,True,7,7,0,54,10,2
4,00:08:08,1,False,7,7,0,40,10,2
4,00:03:12,1,True,10,7,3,13,10,2
1,00:14:54,1,True,0,0,0,37,10,2
1,00:12:40,1,False,0,0,0,23,10,2
1,00:12:22,2,False,0,0,0,23,10,2
1,00:11:39,1,False,0,3,-3,31,10,2
1,00:11:23,2,False,0,3,-3,31,10,2
1,00:04:57,2,True,10,0,10,35,10,2
1,00:02:06,2,False,3,10,-7,38,17,2
2,00:15:00,2,True,10,3,7,42,5,2
2,00:13:03,2,False,3,10,-7,23,23,2
2,00:09:28,2,False,3,10,-7,45,4,2
2,00:06:37,1,False,3,10,-7,35,10,2
2,00:04:48,1,False,3,10,-7,8,8,2
2,00:04:26,2,False,3,10,-7,8,8,2
2,00:02:35,2,True,13,3,10,52,8,2
2,00:01:19,2,False,3,20,-17,33,6,2
3,00:14:36,2,False,3,20,-17,25,9,2
3,00:09:40,1,False,3,20,-17,33,10,2
3,00:03:47,2,True,27,3,24,50,4,2
3,00:01:30,2,True,27,3,24,40,5,2
3,00:01:05,3,True,27,3,24,40,5,2
4,00:10:50,1,False,3,41,-38,48,10,2
4,00:09:10,2,True,41,3,38,22,7,2
4,00:07:30,1,True,41,3,38,44,10,2
4,00:05:30,2,True,41,3,38,5,6,2
4,00:04:00,2,True,41,5,36,51,6,2
4,00:03:50,3,True,41,5,36,51,6,2
4,00:01:20,2,True,41,5,36,28,3,2
4,00:01:00,3,True,41,5,36,28,3,2
1,00:14:54,1,False,0,0,0,44,10,2
1,00:14:32,2,False,0,0,0,44,10,2
1,00:13:43,1,True,0,0,0,32,15,2
1,00:08:10,1,True,3,3,0,23,10,2
1,00:07:18,1,True,3,3,0,35,10,2
1,00:05:10,2,True,3,10,-7,29,4,2
2,00:13:48,2,False,10,10,0,24,6,2
2,00:11:26,1,False,10,10,0,46,10,2
2,00:03:45,1,True,10,10,0,34,10,2
2,00:01:35,2,False,13,10,3,33,7,2
2,00:01:03,1,False,13,13,0,55,10,2
2,00:00:52,2,False,13,13,0,55,10,2
2,00:00:38,1,True,13,13,0,6,10,2
3,00:14:13,2,True,13,20,-7,37,6,2
3,00:13:00,2,False,20,13,7,29,6,2
3,00:11:25,1,True,13,20,-7,51,10,2
3,00:07:42,2,False,20,20,0,26,8,2
3,00:02:32,1,True,20,20,0,17,10,2
3,00:01:36,2,True,20,20,0,22,15,2
4,00:10:09,1,True,20,23,-3,23,10,2
4,00:09:30,2,True,20,23,-3,23,10,2
4,00:07:57,1,False,26,20,6,54,10,2
4,00:05:06,1,False,26,20,6,21,20,2
4,00:03:51,1,True,20,26,-6,46,10,2
4,00:03:41,2,True,20,26,-6,46,10,2
4,00:02:33,2,False,26,20,6,28,7,2
4,00:00:44,1,True,22,26,-4,35,10,2
4,00:00:39,2,True,22,26,-4,30,15,2
4,00:00:31,3,True,22,26,-4,30,15,2
1,00:14:15,2,False,0,0,0,43,7,2
1,00:11:35,2,True,0,0,0,36,12,2
1,00:01:51,2,True,0,6,-6,22,16,2
1,00:01:05,1,False,6,0,6,39,10,2
2,00:15:00,2,False,6,0,6,50,11,2
2,00:11:30,1,True,0,6,-6,27,10,2
2,00:08:48,2,True,0,9,-9,49,10,2
2,00:07:28,2,False,9,0,9,25,18,2
2,00:04:00,2,False,9,0,9,3,3,2
2,00:00:38,1,False,9,3,6,42,10,2
2,00:00:18,1,False,9,3,6,26,10,2
3,00:13:00,1,False,9,6,3,40,10,2
3,00:10:02,2,True,6,9,-3,44,12,2
3,00:03:59,1,True,6,20,-14,46,10,2
3,00:01:20,2,True,6,20,-14,42,8,2
4,00:11:34,1,True,6,23,-17,18,10,2
4,00:10:01,2,True,6,23,-17,24,20,2
4,00:07:45,1,True,6,23,-17,28,10,2
4,00:00:48,3,True,6,23,-17,49,17,2
1,00:11:43,1,True,7,0,7,50,10,2
1,00:08:08,1,True,7,0,7,10,10,2
1,00:06:54,1,True,7,7,0,29,10,2
1,00:04:46,2,False,7,14,-7,44,5,2
1,00:03:30,2,True,14,7,7,13,6,2
2,00:14:43,1,True,14,7,7,24,10,2
2,00:11:16,2,True,14,14,0,36,14,2
2,00:10:07,1,True,14,14,0,48,10,2
2,00:09:42,2,True,14,14,0,48,10,2
2,00:07:23,2,True,14,14,0,3,3,2
2,00:02:22,2,False,17,14,3,4,4,2
2,00:01:30,1,False,17,17,0,52,5,2
3,00:13:26,2,False,17,20,-3,50,10,2
3,00:12:37,1,True,20,17,3,17,10,2
3,00:09:53,2,True,20,17,3,30,3,2
3,00:07:39,1,False,20,20,0,10,10,2
3,00:06:52,2,False,20,20,0,10,10,2
3,00:01:34,2,False,20,23,-3,17,7,2
3,00:00:59,1,True,23,20,3,55,10,2
4,00:12:28,1,True,23,20,3,18,10,2
4,00:11:13,2,True,23,20,3,17,17,2
4,00:02:46,3,False,23,30,-7,55,2,2
4,00:00:48,2,False,23,33,-10,40,5,2
4,00:00:39,3,False,23,33,-10,40,5,2
1,00:12:12,1,False,0,7,-7,35,10,2
1,00:05:22,2,True,14,0,14,10,9,2
1,00:04:15,2,True,14,3,11,37,8,2
1,00:03:03,1,True,14,3,11,16,10,2
1,00:00:01,1,False,6,14,-8,40,10,2
2,00:12:36,1,False,6,14,-8,15,10,2
2,00:10:24,1,True,14,6,8,30,10,2
2,00:09:03,1,False,6,14,-8,17,10,2
2,00:03:22,1,False,6,21,-15,28,10,2
2,00:01:08,1,False,6,28,-22,55,10,2
2,00:00:45,1,False,6,28,-22,41,10,2
3,00:14:21,2,True,28,6,22,39,7,2
3,00:03:15,1,True,31,6,25,23,10,2
3,00:02:35,2,True,31,6,25,33,20,2
3,00:01:01,1,True,31,9,22,51,10,2
4,00:12:50,2,False,9,31,-22,31,6,2
4,00:08:53,2,False,9,34,-25,36,6,2
4,00:08:04,1,False,9,37,-28,35,10,2
4,00:06:23,2,True,37,9,28,29,11,2
4,00:03:52,1,True,37,9,28,35,10,2
4,00:02:33,1,True,37,9,28,24,10,2
4,00:00:01,1,True,37,9,28,29,10,2
1,00:14:27,1,False,0,0,0,33,10,2
1,00:10:09,1,True,0,3,-3,35,10,2
1,00:09:58,2,True,0,3,-3,35,10,2
1,00:06:08,2,True,0,3,-3,13,15,2
1,00:04:26,2,True,0,3,-3,18,4,2
1,00:01:14,2,False,6,0,6,23,5,2
2,00:15:00,1,False,6,0,6,30,10,2
2,00:13:49,1,False,6,6,0,34,10,2
2,00:12:20,2,False,6,6,0,55,7,2
2,00:09:31,2,True,6,6,0,39,19,2
2,00:06:41,2,True,6,6,0,52,9,2
2,00:01:14,1,True,6,13,-7,29,10,2
3,00:14:50,1,True,6,13,-7,10,10,2
3,00:14:32,2,True,6,13,-7,10,10,2
3,00:06:53,2,False,20,13,7,27,14,2
3,00:05:41,1,True,13,20,-7,19,20,2
3,00:05:22,2,True,13,20,-7,19,20,2
3,00:04:50,1,True,13,20,-7,53,10,2
3,00:04:32,2,True,13,20,-7,53,10,2
3,00:03:41,1,True,13,20,-7,24,10,2
3,00:01:05,1,False,20,13,7,44,10,2
4,00:11:57,2,False,20,27,-7,39,4,2
4,00:01:18,1,False,20,29,-9,45,10,2
4,00:00:31,1,True,29,20,9,24,10,2
1,00:12:15,1,False,0,1,-1,35,10,2
1,00:07:37,2,False,0,1,-1,42,15,2
1,00:04:58,2,True,4,0,4,31,13,2
1,00:03:05,2,True,4,0,4,18,18,2
1,00:01:01,1,True,4,0,4,27,10,2
2,00:12:40,2,False,3,4,-1,45,12,2
2,00:11:31,1,False,3,5,-2,45,10,2
2,00:08:33,2,False,3,5,-2,16,14,2
2,00:07:52,1,True,5,3,2,30,10,2
2,00:06:23,2,True,5,3,2,46,10,2
2,00:04:44,2,False,3,5,-2,23,10,2
2,00:04:14,1,True,5,3,2,34,10,2
2,00:02:47,1,True,5,3,2,41,10,2
2,00:02:36,2,True,5,3,2,41,10,2
2,00:02:26,1,True,5,3,2,25,10,2
2,00:02:19,2,True,5,3,2,25,10,2
2,00:01:34,1,False,3,5,-2,50,10,2
2,00:01:07,1,True,5,3,2,43,10,2
3,00:10:40,2,False,17,5,12,48,12,2
3,00:08:38,2,False,17,5,12,22,10,2
3,00:07:36,2,True,5,17,-12,54,8,2
3,00:06:46,1,False,17,5,12,39,10,2
3,00:06:30,2,False,17,5,12,39,10,2
3,00:05:51,1,True,5,17,-12,25,10,2
4,00:13:15,2,True,5,17,-12,5,8,2
4,00:11:54,2,False,19,5,14,44,7,2
4,00:10:27,2,True,5,19,-14,13,6,2
4,00:06:46,1,True,5,21,-16,48,10,2
4,00:06:35,2,True,5,21,-16,48,10,2
4,00:03:02,2,True,5,21,-16,11,22,2
4,00:01:17,2,True,5,31,-26,41,5,2
1,00:14:21,2,True,0,0,0,31,3,2
1,00:11:06,1,True,0,0,0,26,10,2
1,00:09:23,2,True,0,0,0,50,6,2
1,00:07:10,2,False,0,0,0,42,6,2
1,00:00:43,2,True,7,7,0,43,10,2
2,00:05:02,2,False,10,14,-4,47,5,2
2,00:03:43,1,False,10,14,-4,25,10,2
2,00:01:49,2,False,10,21,-11,48,5,2
3,00:13:42,1,False,10,21,-11,50,10,2
3,00:08:35,1,True,21,10,11,14,10,2
3,00:04:13,1,True,21,10,11,14,10,2
3,00:03:56,2,True,21,10,11,14,10,2
4,00:10:47,1,True,21,13,8,4,4,2
4,00:09:59,0,False,19,21,-2,5,0,2
4,00:03:52,1,True,24,19,5,29,10,2
4,00:01:32,0,False,25,24,1,5,0,2
4,00:00:58,1,False,25,24,1,53,10,2
4,00:00:04,1,True,24,25,-1,12,20,2
1,00:14:55,1,True,0,0,0,27,10,2
1,00:09:58,1,True,0,7,-7,15,15,2
1,00:09:11,1,True,0,7,-7,15,10,2
1,00:01:37,1,True,0,24,-24,28,10,2
1,00:00:53,1,True,0,24,-24,38,10,2
1,00:00:01,1,False,24,0,24,24,10,2
2,00:15:00,2,False,24,0,24,24,10,2
2,00:09:00,2,False,24,0,24,42,12,2
2,00:05:55,2,True,0,32,-32,53,3,2
2,00:03:03,3,False,32,7,25,54,2,2
2,00:02:05,2,False,32,7,25,39,6,2
2,00:01:26,1,False,32,7,25,48,10,2
2,00:01:20,2,False,32,7,25,48,10,2
2,00:00:54,1,True,7,32,-25,19,10,2
3,00:12:20,2,False,32,7,25,55,10,2
3,00:07:33,2,True,7,32,-25,17,11,2
3,00:00:20,1,False,35,7,28,40,10,2
4,00:15:00,2,False,35,7,28,40,10,2
4,00:12:35,1,True,7,35,-28,28,20,2
4,00:09:35,3,False,35,7,28,40,16,2
4,00:01:52,2,False,38,14,24,24,11,2
4,00:01:13,1,True,14,38,-24,30,10,2
1,00:02:24,1,False,3,0,3,26,10,2
1,00:01:12,1,False,3,3,0,35,10,2
2,00:15:00,1,True,3,3,0,47,10,2
2,00:13:39,2,True,3,3,0,55,13,2
2,00:12:24,2,False,3,3,0,50,9,2
2,00:11:01,1,True,3,3,0,40,10,2
2,00:08:42,1,False,3,3,0,40,10,2
2,00:03:30,2,True,10,3,7,41,8,2
2,00:02:13,2,True,10,3,7,5,13,2
2,00:01:14,2,True,10,3,7,45,20,2
2,00:00:50,2,True,10,3,7,54,4,2
2,00:00:30,2,False,3,10,-7,29,4,2
3,00:10:08,1,False,3,10,-7,51,10,2
3,00:09:48,2,False,3,10,-7,51,10,2
3,00:07:32,1,False,3,10,-7,23,20,2
3,00:06:07,2,True,10,3,7,44,5,2
4,00:06:40,1,True,11,16,-5,40,5,2
4,00:05:25,0,True,17,16,1,5,0,2
4,00:03:12,2,True,17,16,1,54,4,2
4,00:02:16,0,False,22,17,5,5,0,2
4,00:02:10,1,False,22,17,5,51,10,2
1,00:14:20,2,True,0,0,0,30,9,2
1,00:09:53,2,False,7,0,7,53,5,2
1,00:06:50,2,True,1,7,-6,22,12,2
1,00:03:41,2,False,10,1,9,53,6,2
1,00:02:53,1,False,10,2,8,35,10,2
1,00:01:18,2,False,10,2,8,23,10,2
2,00:14:34,1,True,5,10,-5,37,10,2
2,00:09:53,1,True,8,17,-9,15,10,2
2,00:09:37,2,True,8,17,-9,15,10,2
2,00:07:12,2,True,8,20,-12,40,5,2
2,00:02:07,2,True,8,27,-19,32,6,2
2,00:00:02,1,False,30,8,22,50,10,2
3,00:07:35,1,False,30,8,22,36,10,2
3,00:06:13,1,False,30,8,22,20,10,2
3,00:05:55,2,False,30,8,22,20,10,2
3,00:04:20,2,False,30,11,19,50,10,2
4,00:12:29,1,False,30,11,19,22,10,2
4,00:12:12,2,False,30,11,19,22,10,2
4,00:09:52,1,False,30,14,16,50,10,2
4,00:09:45,2,False,30,14,16,50,10,2
4,00:06:31,1,False,30,14,16,49,10,2
4,00:04:54,2,True,14,30,-16,40,4,2
4,00:04:29,1,False,30,14,16,25,10,2
4,00:04:10,2,False,30,14,16,25,10,2
4,00:02:14,1,True,17,30,-13,46,10,2
4,00:01:42,2,True,17,30,-13,35,5,2
4,00:01:00,1,False,33,17,16,50,10,2
4,00:00:30,1,False,33,23,10,5,0,2
1,00:10:55,1,False,0,3,-3,30,15,2
1,00:02:11,2,True,10,3,7,42,10,2
1,00:01:32,1,False,3,10,-7,25,10,2
2,00:11:25,2,True,17,6,11,45,4,2
2,00:09:23,2,True,17,6,11,50,5,2
2,00:08:12,1,True,17,6,11,45,10,2
2,00:07:50,2,True,17,6,11,45,10,2
2,00:05:25,2,True,17,13,4,36,12,2
2,00:03:07,2,True,17,13,4,24,4,2
3,00:14:20,2,False,19,17,2,40,4,2
3,00:10:46,2,False,19,17,2,39,4,2
3,00:00:53,2,True,27,26,1,35,8,2
4,00:10:52,1,False,26,27,-1,50,10,2
4,00:09:45,1,False,26,27,-1,25,10,2
4,00:09:20,2,False,26,27,-1,25,10,2
4,00:07:40,1,True,30,26,4,32,10,2
4,00:07:21,2,True,30,26,4,32,10,2
4,00:06:36,1,True,30,29,1,35,10,2
4,00:03:44,1,False,29,30,-1,4,4,2
4,00:02:27,2,False,29,33,-4,42,3,2
4,00:00:04,1,False,29,36,-7,35,10,2
1,00:14:18,2,False,0,0,0,36,8,2
1,00:12:55,2,True,0,0,0,40,3,2
1,00:11:09,2,False,0,0,0,35,7,2
1,00:08:43,1,False,0,0,0,16,10,2
1,00:05:08,1,True,7,0,7,27,25,2
1,00:04:41,2,True,7,0,7,27,25,2
1,00:00:01,1,False,0,7,-7,34,10,2
2,00:14:12,1,False,0,7,-7,44,10,2
2,00:02:15,2,False,0,21,-21,31,6,2
2,00:02:04,1,True,21,0,21,40,10,2
2,00:00:59,1,False,7,21,-14,17,10,2
3,00:12:58,1,False,7,28,-21,49,10,2
3,00:09:30,2,False,7,28,-21,5,5,2
4,00:08:13,3,False,17,35,-18,41,4,2
4,00:04:57,1,False,17,38,-21,47,10,2
4,00:02:27,3,True,38,17,21,16,16,2
1,00:12:28,2,True,0,0,0,43,4,2
1,00:07:40,1,True,0,7,-7,40,10,2
1,00:01:42,2,False,7,0,7,36,4,2
3,00:13:18,1,True,21,14,7,46,10,2
3,00:11:29,2,True,21,14,7,54,4,2
3,00:07:01,2,True,21,21,0,39,6,2
3,00:05:44,2,False,21,21,0,40,8,2
3,00:04:58,1,True,21,21,0,40,10,2
3,00:01:10,1,False,21,21,0,39,10,2
4,00:09:14,2,False,21,28,-7,11,7,2
4,00:08:19,1,False,21,31,-10,35,10,2
4,00:02:10,2,True,38,21,17,43,2,2
4,00:01:32,3,True,38,21,17,34,9,2
4,00:00:18,1,False,21,38,-17,47,10,2
4,00:00:03,1,True,38,21,17,15,10,2
1,00:13:50,1,True,0,0,0,53,10,2
1,00:12:32,1,False,0,0,0,38,10,2
1,00:11:52,2,False,0,0,0,33,5,2
1,00:10:27,1,True,1,0,1,51,10,2
1,00:10:05,2,True,1,0,1,51,10,2
1,00:07:34,2,False,0,1,-1,34,7,2
1,00:06:08,2,True,1,0,1,55,6,2
1,00:02:54,1,False,0,1,-1,10,10,2
1,00:02:30,2,False,0,1,-1,10,10,2
1,00:00:01,1,True,4,0,4,38,10,2
2,00:10:10,1,True,7,1,6,28,10,2
2,00:02:32,2,False,4,8,-4,11,7,2
2,00:01:52,2,True,8,4,4,51,11,2
2,00:00:32,2,True,8,4,4,43,5,2
3,00:04:56,1,True,8,4,4,26,10,2
3,00:03:02,2,True,8,7,1,41,4,2
4,00:00:14,1,True,8,10,-2,45,10,2
4,00:00:04,2,True,8,10,-2,45,10,2
1,00:11:50,2,True,0,0,0,42,23,2
1,00:07:46,1,True,0,0,0,14,10,2
1,00:02:17,2,True,7,7,0,12,4,2
2,00:15:00,2,True,7,10,-3,47,8,2
2,00:12:12,2,True,7,10,-3,42,3,2
2,00:10:12,2,False,10,7,3,50,12,2
2,00:05:05,2,False,10,7,3,40,4,2
2,00:02:34,1,True,7,17,-10,54,10,2
2,00:01:10,1,False,17,7,10,51,10,2
2,00:00:27,1,False,17,7,10,53,10,2
2,00:00:17,2,False,17,7,10,53,10,2
3,00:07:38,1,True,7,17,-10,24,10,2
3,00:03:17,1,False,20,10,10,35,10,2
3,00:01:08,1,False,20,10,10,45,10,2
4,00:12:08,2,True,17,20,-3,13,8,2
4,00:07:20,1,False,23,17,6,29,10,2
4,00:02:13,1,True,20,23,-3,23,10,2
1,00:14:12,2,True,0,0,0,35,7,2
1,00:08:50,2,True,0,0,0,21,7,2
1,00:05:22,1,True,0,0,0,22,10,2
1,00:02:20,2,False,0,0,0,50,13,2
2,00:10:44,1,False,1,1,0,23,10,2
2,00:10:17,2,False,1,1,0,23,10,2
2,00:08:12,1,False,1,4,-3,51,10,2
2,00:06:27,2,True,4,1,3,38,6,2
2,00:02:49,1,False,4,4,0,28,20,2
2,00:00:01,2,False,4,4,0,50,5,2
3,00:14:14,2,False,4,4,0,30,25,2
3,00:12:39,2,False,4,4,0,42,6,2
3,00:04:12,2,False,4,5,-1,47,4,2
3,00:03:19,1,True,5,4,1,35,10,2
3,00:03:05,2,True,5,4,1,35,10,2
3,00:01:46,2,False,4,5,-1,24,8,2
4,00:13:20,2,True,12,4,8,45,6,2
4,00:09:41,1,True,12,4,8,55,10,2
4,00:08:23,1,False,4,12,-8,17,10,2
4,00:05:16,1,False,4,12,-8,23,10,2
4,00:02:45,2,True,12,11,1,45,6,2
4,00:02:00,2,False,11,13,-2,46,4,2
1,00:14:52,1,False,0,0,0,43,10,2
1,00:10:43,1,True,0,0,0,41,10,2
1,00:10:12,2,True,0,0,0,41,10,2
1,00:07:35,2,True,0,7,-7,19,17,2
1,00:05:04,1,True,0,7,-7,23,10,2
1,00:04:35,2,True,0,7,-7,23,10,2
1,00:03:52,1,True,0,10,-10,35,10,2
1,00:01:34,1,True,0,10,-10,19,10,2
2,00:14:43,1,False,10,0,10,46,10,2
2,00:11:57,2,False,10,0,10,25,11,2
2,00:10:48,2,False,10,3,7,36,9,2
2,00:08:22,1,False,10,3,7,26,10,2
2,00:08:00,2,False,10,3,7,26,10,2
2,00:03:56,2,True,6,10,-4,26,12,2
2,00:02:30,1,True,6,10,-4,21,10,2
2,00:02:15,2,True,6,10,-4,21,10,2
3,00:02:30,1,True,10,13,-3,43,10,2
3,00:00:01,1,False,13,10,3,18,10,2
4,00:13:16,1,True,17,13,4,25,10,2
4,00:12:53,2,True,17,13,4,25,10,2
4,00:10:28,2,True,17,16,1,20,8,2
4,00:09:25,1,True,17,19,-2,25,10,2
4,00:05:21,2,True,17,26,-9,30,6,2
4,00:02:41,2,False,26,17,9,51,6,2
1,00:14:22,2,True,0,0,0,37,4,2
1,00:11:44,2,True,0,0,0,28,7,2
1,00:10:26,2,False,0,0,0,37,16,2
1,00:08:27,2,False,0,0,0,43,8,2
1,00:01:50,2,True,1,0,1,49,9,2
2,00:10:02,2,True,1,0,1,12,5,2
2,00:06:35,2,True,1,0,1,30,21,2
2,00:04:41,3,True,1,3,-2,40,6,2
2,00:02:16,2,True,1,3,-2,39,7,2
2,00:00:14,1,True,1,3,-2,12,10,2
3,00:14:53,1,False,6,1,5,22,10,2
3,00:14:34,2,False,6,1,5,22,10,2
3,00:12:11,1,False,6,8,-2,13,10,2
4,00:14:09,1,False,13,8,5,15,10,2
4,00:13:00,1,False,13,11,2,35,10,2
4,00:12:43,2,False,13,11,2,35,10,2
4,00:04:09,1,True,14,16,-2,36,10,2
4,00:02:02,1,False,16,21,-5,25,10,2
4,00:00:53,1,False,16,24,-8,35,10,2
1,00:14:55,1,False,0,0,0,24,10,2
1,00:13:18,2,False,0,0,0,31,16,2
1,00:10:30,2,True,0,0,0,52,7,2
1,00:00:01,2,False,7,7,0,16,19,2
2,00:14:44,1,False,7,7,0,49,10,2
2,00:14:31,2,False,7,7,0,49,10,2
2,00:13:53,1,False,7,7,0,18,10,2
2,00:11:23,1,False,7,14,-7,28,10,2
2,00:10:06,1,True,14,7,7,44,10,2
2,00:08:38,1,False,7,14,-7,37,10,2
2,00:08:28,2,False,7,14,-7,37,10,2
2,00:03:52,2,True,24,7,17,30,4,2
2,00:03:08,1,False,7,24,-17,21,10,2
2,00:01:32,1,False,7,24,-17,20,10,2
2,00:00:35,1,True,31,7,24,46,10,2
3,00:10:53,2,True,31,13,18,42,3,2
3,00:10:10,1,False,13,31,-18,28,10,2
3,00:08:39,1,True,31,13,18,45,10,2
3,00:08:08,1,True,31,13,18,35,10,2
3,00:07:54,2,True,31,13,18,35,10,2
4,00:11:57,1,True,31,24,7,47,10,2
4,00:10:00,2,False,24,31,-7,18,8,2
4,00:09:11,1,False,24,34,-10,35,10,2
4,00:07:56,1,True,34,24,10,22,10,2
4,00:07:36,2,True,34,24,10,22,10,2
4,00:06:53,1,False,24,34,-10,39,10,2
4,00:02:05,2,True,34,24,10,38,4,2
1,00:09:53,1,True,7,0,7,35,10,2
1,00:08:47,2,True,7,0,7,25,20,2
1,00:02:42,1,True,7,7,0,7,10,2
1,00:01:19,1,True,7,7,0,50,10,2
2,00:14:32,1,True,7,7,0,24,10,2
2,00:14:01,2,True,7,7,0,24,10,2
2,00:13:02,2,True,7,8,-1,35,10,2
2,00:08:32,1,True,7,8,-1,44,10,2
2,00:04:13,1,False,8,7,1,9,10,2
2,00:02:59,1,False,8,7,1,32,10,2
2,00:02:42,2,False,8,7,1,32,10,2
2,00:02:04,2,False,8,7,1,54,7,2
2,00:01:04,1,False,8,7,1,47,10,2
2,00:00:54,2,False,8,7,1,47,10,2
3,00:13:00,2,False,8,7,1,47,5,2
3,00:06:00,1,True,7,8,-1,38,15,2
3,00:04:28,2,True,7,8,-1,25,9,2
3,00:01:40,2,False,11,7,4,35,7,2
4,00:14:44,2,False,11,7,4,53,8,2
4,00:12:02,1,True,7,11,-4,34,10,2
4,00:11:23,2,True,7,11,-4,34,10,2
4,00:05:55,1,True,7,18,-11,35,10,2
4,00:03:43,2,True,7,25,-18,46,6,2
4,00:03:15,3,True,7,25,-18,46,6,2
4,00:02:03,1,True,7,32,-25,35,10,2
4,00:01:32,2,True,7,32,-25,51,5,2
4,00:01:01,2,False,32,7,25,45,26,2
1,00:07:17,2,True,10,0,10,45,6,2
1,00:00:14,2,True,10,0,10,34,4,2
2,00:13:55,2,True,10,3,7,35,6,2
2,00:11:41,2,True,10,3,7,47,6,2
2,00:05:12,1,True,13,3,10,38,10,2
2,00:02:54,2,True,13,3,10,5,5,2
2,00:02:18,2,True,13,6,7,47,8,2
2,00:00:11,1,True,13,6,7,38,20,2
3,00:14:49,1,False,9,13,-4,24,10,2
3,00:14:25,2,False,9,13,-4,24,10,2
3,00:13:45,1,False,9,13,-4,17,10,2
3,00:08:43,2,True,16,12,4,36,9,2
4,00:14:52,1,True,16,19,-3,39,10,2
4,00:13:52,1,True,16,19,-3,51,10,2
4,00:09:49,1,False,19,16,3,47,10,2
4,00:09:28,2,False,19,16,3,47,10,2
4,00:02:38,2,True,16,19,-3,45,4,2
4,00:02:00,1,True,16,20,-4,35,10,2
4,00:01:56,2,True,16,20,-4,35,10,2
4,00:00:16,2,True,16,20,-4,48,5,2
4,00:00:03,1,False,20,16,4,53,10,2
1,00:12:34,1,True,0,0,0,15,10,2
1,00:09:40,2,True,0,3,-3,53,7,2
1,00:09:00,1,False,3,0,3,25,10,2
2,00:13:44,2,False,3,7,-4,50,6,2
2,00:13:04,1,False,3,8,-5,35,10,2
2,00:11:40,1,True,8,3,5,32,10,2
2,00:04:59,1,False,3,8,-5,31,10,2
2,00:00:09,1,True,8,3,5,54,10,2
2,00:00:03,2,True,8,3,5,54,10,2
3,00:13:35,1,True,8,3,5,50,10,2
3,00:11:30,2,False,3,9,-6,38,7,2
3,00:08:55,2,True,9,3,6,46,6,2
3,00:04:23,1,False,3,9,-6,14,10,2
3,00:03:50,2,False,3,9,-6,14,10,2
3,00:00:36,1,False,3,13,-10,35,10,2
3,00:00:24,2,False,3,13,-10,35,10,2
4,00:14:19,1,False,3,13,-10,54,10,2
4,00:13:59,2,False,3,13,-10,54,10,2
4,00:12:51,1,False,3,13,-10,32,10,2
4,00:12:31,2,False,3,13,-10,32,10,2
4,00:03:40,1,True,20,10,10,51,10,2
4,00:03:03,2,False,10,20,-10,49,20,2
1,00:10:08,2,True,0,0,0,5,12,2
1,00:06:26,2,True,0,7,-7,44,7,2
1,00:05:40,1,False,7,0,7,30,10,2
1,00:05:15,2,False,7,0,7,30,10,2
2,00:14:34,2,False,7,0,7,41,6,2
2,00:11:23,1,True,2,7,-5,34,10,2
2,00:09:58,2,True,2,7,-5,50,5,2
2,00:08:44,2,False,7,2,5,5,8,2
2,00:04:19,2,False,7,11,-4,32,3,2
2,00:02:48,2,False,7,11,-4,43,0,2
2,00:01:19,2,False,7,11,-4,10,10,2
2,00:01:02,1,False,7,14,-7,35,10,2
3,00:04:10,1,True,21,14,7,18,10,2
3,00:03:49,2,True,21,14,7,18,10,2
4,00:12:27,2,True,21,21,0,26,14,2
4,00:10:27,1,False,24,21,3,51,10,2
4,00:09:32,2,False,24,21,3,46,5,2
4,00:02:58,1,True,28,30,-2,35,10,2
4,00:00:01,2,True,35,30,5,51,1,2
1,00:14:30,2,False,0,0,0,21,5,2
1,00:13:01,1,False,0,3,-3,40,10,2
1,00:12:25,2,False,0,3,-3,40,10,2
1,00:07:31,1,False,1,10,-9,42,10,2
1,00:07:12,2,False,1,10,-9,42,10,2
1,00:03:03,2,True,10,1,9,47,16,2
1,00:01:35,2,False,3,10,-7,48,7,2
2,00:07:45,2,False,3,10,-7,20,5,2
2,00:04:05,1,False,3,10,-7,16,10,2
2,00:03:25,2,False,3,10,-7,16,10,2
2,00:02:43,1,False,3,13,-10,35,10,2
2,00:02:30,2,False,3,13,-10,35,10,2
2,00:02:14,1,True,13,3,10,46,10,2
3,00:14:28,2,False,10,13,-3,31,12,2
3,00:13:09,2,True,13,10,3,3,11,2
3,00:12:18,1,False,12,13,-1,51,10,2
3,00:11:16,1,False,12,13,-1,40,10,2
3,00:06:53,2,True,13,12,1,54,8,2
3,00:05:43,2,False,12,13,-1,36,9,2
3,00:00:24,2,True,13,12,1,33,7,2
4,00:11:37,1,False,12,13,-1,27,10,2
4,00:08:19,2,True,13,12,1,49,7,2
4,00:05:33,1,True,13,12,1,38,10,2
1,00:14:29,1,True,0,0,0,55,10,2
1,00:06:43,1,True,8,7,1,27,10,2
1,00:01:03,2,False,7,8,-1,52,19,2
2,00:12:58,2,False,7,8,-1,50,8,2
2,00:08:18,1,False,7,15,-8,23,10,2
2,00:08:01,2,False,7,15,-8,23,10,2
2,00:06:58,2,True,15,7,8,30,8,2
2,00:03:41,1,True,15,7,8,7,7,2
2,00:03:26,2,True,15,7,8,7,7,2
2,00:02:59,1,True,15,10,5,35,10,2
2,00:02:36,2,True,15,10,5,35,10,2
3,00:11:11,2,False,10,15,-5,40,9,2
3,00:08:20,2,True,18,10,8,36,8,2
3,00:06:00,2,False,10,18,-8,45,15,2
3,00:02:11,2,True,18,10,8,50,12,2
4,00:12:34,2,False,10,18,-8,48,10,2
4,00:08:43,1,False,10,25,-15,33,10,2
4,00:07:34,1,True,25,10,15,43,10,2
4,00:05:10,2,True,25,10,15,37,17,2
4,00:03:10,2,False,13,25,-12,26,5,2
4,00:01:16,1,True,28,13,15,28,10,2
4,00:01:06,2,True,28,13,15,28,10,2
4,00:01:02,3,True,28,13,15,28,10,2
1,00:14:54,1,True,0,0,0,50,10,2
1,00:13:58,1,False,0,0,0,34,10,2
1,00:09:14,2,True,3,0,3,32,9,2
1,00:07:01,1,False,0,3,-3,51,10,2
1,00:06:58,2,False,0,3,-3,51,10,2
1,00:03:14,2,False,0,3,-3,39,4,2
2,00:14:18,1,False,0,3,-3,9,19,2
2,00:10:01,2,True,3,0,3,42,13,2
2,00:04:49,1,False,3,3,0,8,8,2
2,00:02:10,2,False,3,5,-2,52,15,2
3,00:11:06,2,False,6,5,1,51,4,2
3,00:05:25,2,True,5,6,-1,49,8,2
3,00:04:27,2,True,5,7,-2,37,8,2
3,00:03:36,1,False,7,5,2,47,10,2
4,00:14:45,1,False,7,5,2,30,10,2
4,00:13:03,2,True,5,7,-2,42,6,2
4,00:04:48,3,False,7,5,2,26,8,2
4,00:00:30,1,True,5,7,-2,20,10,2
4,00:00:14,2,True,5,7,-2,25,5,2
4,00:00:12,3,True,5,7,-2,25,5,2
1,00:14:20,2,True,0,0,0,41,9,2
1,00:12:28,2,False,0,0,0,52,4,2
1,00:11:48,1,True,0,0,0,14,10,2
1,00:07:26,1,True,0,0,0,34,10,2
1,00:07:02,2,True,0,0,0,34,10,2
1,00:04:28,1,True,0,3,-3,51,10,2
2,00:15:00,2,False,3,0,3,45,5,2
2,00:13:34,1,True,0,3,-3,33,10,2
2,00:13:14,2,True,0,3,-3,33,10,2
2,00:10:52,1,True,0,3,-3,38,10,2
2,00:09:00,1,False,3,0,3,26,10,2
2,00:04:43,2,True,7,10,-3,38,8,2
2,00:01:27,1,False,17,7,10,27,10,2
2,00:00:30,1,False,17,7,10,19,10,2
3,00:12:42,2,False,17,10,7,55,9,2
3,00:10:16,1,False,24,10,14,49,10,2
3,00:10:03,2,False,24,10,14,49,10,2
3,00:02:50,1,False,31,10,21,53,10,2
3,00:02:36,2,False,31,10,21,53,10,2
4,00:11:36,1,True,13,31,-18,21,10,2
4,00:11:28,2,True,13,31,-18,21,10,2
4,00:10:11,2,True,13,31,-18,44,6,2
4,00:08:50,2,True,13,31,-18,4,8,2
4,00:08:24,1,True,13,31,-18,33,10,2
4,00:07:00,1,True,13,34,-21,35,10,2
4,00:05:54,1,False,34,13,21,36,10,2
4,00:05:30,1,False,34,13,21,21,10,2
4,00:05:03,2,False,34,13,21,21,10,2
4,00:03:47,2,False,34,20,14,15,16,2
1,00:11:46,2,True,7,0,7,49,4,2
1,00:10:53,2,True,7,0,7,21,7,2
2,00:14:53,1,True,7,17,-10,25,10,2
2,00:11:44,2,True,7,17,-10,55,13,2
2,00:09:05,2,False,17,7,10,50,7,2
2,00:04:11,1,True,7,17,-10,54,15,2
2,00:02:12,2,True,7,17,-10,5,5,2
2,00:01:48,1,True,7,20,-13,50,10,2
2,00:01:42,2,True,7,20,-13,50,10,2
3,00:13:31,2,False,21,7,14,28,4,2
3,00:09:15,1,True,10,21,-11,16,10,2
3,00:08:54,2,True,10,21,-11,16,10,2
3,00:07:27,2,True,10,24,-14,41,5,2
3,00:05:50,1,False,24,10,14,4,4,2
4,00:13:15,1,False,24,31,-7,35,10,2
4,00:12:01,2,True,31,24,7,23,4,2
4,00:11:14,1,False,24,31,-7,44,10,2
4,00:02:32,1,False,24,38,-14,48,10,2
4,00:01:37,1,True,38,24,14,38,10,2
4,00:01:25,2,True,38,24,14,38,10,2
4,00:00:38,1,True,38,24,14,19,10,2
1,00:13:25,2,False,0,0,0,50,13,2
1,00:00:25,1,False,1,7,-6,38,10,2
1,00:00:01,2,False,1,7,-6,38,10,2
2,00:10:18,2,False,8,8,0,37,8,2
2,00:04:10,1,True,8,13,-5,25,20,2
3,00:03:53,1,False,30,15,15,52,10,2
4,00:14:26,1,True,16,30,-14,34,10,2
4,00:10:39,2,False,30,16,14,47,12,2
4,00:09:15,1,True,17,30,-13,53,10,2
4,00:08:52,2,True,17,30,-13,53,10,2
4,00:07:37,1,True,17,30,-13,37,10,2
4,00:07:13,2,True,17,30,-13,37,10,2
4,00:05:42,2,False,30,17,13,41,6,2
1,00:14:51,1,False,0,0,0,38,10,2
1,00:14:30,2,False,0,0,0,38,10,2
1,00:13:18,2,True,0,0,0,29,7,2
1,00:12:25,1,False,0,0,0,36,15,2
1,00:12:12,2,False,0,0,0,36,15,2
1,00:11:09,1,True,0,0,0,39,10,2
1,00:09:12,2,True,0,0,0,53,7,2
1,00:07:49,2,False,0,0,0,12,5,2
2,00:07:08,1,False,3,5,-2,24,10,2
2,00:04:00,1,False,3,6,-3,44,10,2
2,00:00:29,2,True,6,3,3,39,15,2
3,00:12:39,2,False,6,6,0,9,8,2
3,00:09:30,1,True,9,6,3,30,15,2
3,00:09:27,2,True,9,6,3,30,15,2
3,00:05:50,2,True,9,6,3,34,9,2
3,00:00:55,2,False,9,9,0,24,11,2
4,00:13:20,1,False,16,12,4,7,7,2
4,00:12:08,1,False,16,19,-3,36,10,2
4,00:11:48,2,False,16,19,-3,36,10,2
4,00:06:37,1,False,16,26,-10,36,10,2
4,00:01:01,1,True,33,16,17,45,10,2
4,00:00:50,2,True,33,16,17,45,10,2
1,00:10:09,2,True,3,7,-4,30,5,2
1,00:03:40,1,False,15,3,12,44,10,2
1,00:01:08,2,False,15,3,12,25,3,2
1,00:00:14,1,True,3,15,-12,36,10,2
2,00:15:00,2,True,3,15,-12,36,10,2
2,00:09:52,1,True,3,15,-12,2,2,2
2,00:07:09,2,True,3,22,-19,38,12,2
2,00:06:44,3,True,3,22,-19,38,12,2
2,00:05:18,1,True,3,22,-19,27,10,2
2,00:01:04,1,False,29,3,26,25,10,2
3,00:11:40,1,True,10,29,-19,36,10,2
3,00:10:15,1,True,10,32,-22,20,10,2
3,00:01:45,2,True,25,32,-7,34,10,2
4,00:11:20,2,True,25,33,-8,37,8,2
1,00:12:50,2,True,0,0,0,44,5,2
1,00:03:13,1,True,0,0,0,10,10,2
1,00:02:49,2,True,0,0,0,10,10,2
1,00:00:52,2,False,3,0,3,33,6,2
1,00:00:03,1,False,3,3,0,29,10,2
2,00:03:27,2,False,3,6,-3,20,10,2
3,00:14:54,1,True,15,3,12,50,10,2
3,00:09:29,2,True,15,3,12,35,10,2
3,00:06:02,2,False,6,15,-9,38,10,2
3,00:02:35,2,False,6,16,-10,55,20,2
3,00:01:53,1,True,16,6,10,28,10,2
3,00:01:30,2,True,16,6,10,28,10,2
3,00:00:43,1,False,6,16,-10,39,10,2
3,00:00:21,2,False,6,16,-10,39,10,2
4,00:14:08,2,True,16,6,10,13,4,2
4,00:12:48,2,True,16,6,10,41,6,2
4,00:06:12,2,True,19,9,10,48,5,2
4,00:04:53,2,False,9,19,-10,13,13,2
4,00:02:44,2,False,9,26,-17,27,19,2
1,00:10:50,2,False,0,3,-3,43,2,2
1,00:08:30,2,False,0,3,-3,44,4,2
2,00:08:29,2,True,13,0,13,17,8,2
2,00:05:16,1,True,13,0,13,25,10,2
2,00:03:40,2,True,13,0,13,3,3,2
2,00:02:47,2,True,13,3,10,41,4,2
2,00:02:12,1,False,3,13,-10,36,10,2
3,00:14:10,2,False,3,13,-10,20,12,2
3,00:06:33,1,False,3,20,-17,46,10,2
3,00:00:28,2,False,3,20,-17,19,16,2
4,00:15:00,1,False,3,20,-17,44,10,2
4,00:14:50,2,False,3,20,-17,44,10,2
4,00:13:28,2,False,3,20,-17,46,9,2
4,00:11:45,1,True,20,3,17,50,10,2
4,00:09:10,2,False,3,20,-17,31,5,2
4,00:00:35,1,False,3,28,-25,50,10,2
4,00:00:15,2,False,3,28,-25,50,10,2
1,00:10:43,2,False,0,0,0,52,5,2
1,00:09:24,2,True,0,1,-1,34,11,2
1,00:08:49,1,False,1,0,1,44,10,2
1,00:04:07,1,True,0,4,-4,49,10,2
1,00:03:46,2,True,0,4,-4,49,10,2
1,00:01:58,2,True,0,4,-4,36,6,2
1,00:00:58,1,False,4,0,4,44,10,2
2,00:11:41,2,False,11,0,11,34,14,2
2,00:07:17,1,False,18,1,17,20,10,2
2,00:01:58,1,False,18,8,10,28,10,2
2,00:01:41,2,False,18,8,10,28,10,2
2,00:00:50,1,True,9,18,-9,42,10,2
3,00:12:27,2,True,9,21,-12,31,9,2
3,00:11:57,1,False,21,9,12,29,10,2
3,00:09:06,1,True,9,28,-19,18,10,2
3,00:07:45,1,True,9,28,-19,54,10,2
3,00:01:23,2,False,28,9,19,48,7,2
4,00:12:33,2,True,9,28,-19,13,12,2
4,00:09:34,1,False,30,9,21,35,10,2
4,00:09:09,1,False,30,9,21,18,10,2
4,00:02:36,1,False,33,16,17,13,10,2
4,00:02:33,2,False,33,16,17,13,10,2
4,00:00:33,1,False,40,23,17,52,10,2
4,00:00:17,2,False,40,23,17,52,10,2
4,00:00:11,3,False,40,23,17,52,10,2
1,00:13:17,2,True,0,0,0,25,12,2
1,00:06:40,2,True,0,0,0,53,4,2
1,00:05:57,1,False,0,0,0,22,10,2
2,00:15:00,1,False,0,0,0,5,5,2
2,00:14:47,2,False,0,0,0,5,5,2
2,00:12:58,1,True,3,0,3,49,10,2
2,00:12:41,2,True,3,0,3,49,10,2
2,00:10:52,1,False,1,3,-2,40,10,2
2,00:06:21,1,False,1,3,-2,41,10,2
2,00:04:07,1,True,3,1,2,7,7,2
2,00:03:31,1,True,3,1,2,4,4,2
2,00:02:33,1,True,3,8,-5,25,10,2
2,00:01:11,1,False,15,3,12,28,10,2
2,00:00:26,2,False,15,3,12,51,14,2
3,00:12:06,2,False,15,3,12,12,3,2
3,00:05:27,1,False,15,6,9,45,10,2
3,00:04:05,1,False,15,7,8,35,10,2
3,00:01:45,1,False,15,7,8,41,10,2
4,00:15:00,1,False,15,10,5,48,10,2
4,00:08:43,2,False,15,17,-2,51,6,2
4,00:02:35,1,False,16,24,-8,42,10,2
4,00:02:29,2,False,16,24,-8,42,10,2
4,00:02:21,3,False,16,24,-8,42,10,2
4,00:01:16,1,False,16,25,-9,30,10,2
4,00:01:05,1,False,16,25,-9,41,10,2
4,00:00:42,1,True,25,16,9,53,10,2
1,00:13:48,2,True,0,0,0,50,4,2
1,00:09:28,2,True,0,0,0,19,10,2
1,00:08:44,1,False,0,0,0,53,10,2
1,00:06:03,2,True,0,0,0,34,6,2
1,00:04:17,1,True,0,0,0,54,10,2
1,00:03:59,2,True,0,0,0,54,10,2
1,00:00:08,1,False,0,0,0,25,10,2
2,00:09:36,1,False,0,8,-8,35,10,2
2,00:09:03,1,False,0,8,-8,45,10,2
2,00:08:44,2,False,0,8,-8,45,10,2
2,00:04:12,1,False,1,15,-14,43,10,2
3,00:14:52,1,True,15,8,7,27,10,2
3,00:14:33,2,True,15,8,7,27,10,2
3,00:13:49,1,True,15,8,7,54,10,2
3,00:07:44,1,False,15,15,0,33,10,2
3,00:06:31,1,True,15,15,0,45,10,2
3,00:00:01,2,False,15,18,-3,27,4,2
4,00:08:19,2,False,15,25,-10,27,8,2
4,00:07:25,2,False,15,28,-13,39,6,2
4,00:02:58,2,False,15,28,-13,20,5,2
4,00:01:35,1,False,15,31,-16,8,10,2
4,00:01:13,1,False,15,31,-16,35,10,2
1,00:03:44,2,False,7,0,7,33,8,2
1,00:02:32,1,False,7,3,4,36,5,2
1,00:02:18,2,False,7,3,4,36,5,2
1,00:00:23,1,False,7,3,4,50,10,2
2,00:10:29,1,True,3,8,-5,29,10,2
2,00:05:38,1,True,3,15,-12,52,10,2
2,00:05:27,2,True,3,15,-12,52,10,2
2,00:04:05,2,False,15,3,12,30,7,2
2,00:02:35,1,False,15,10,5,45,10,2
2,00:00:40,1,True,10,15,-5,21,10,2
2,00:00:09,1,True,10,22,-12,41,10,2
3,00:14:45,1,True,10,22,-12,36,10,2
3,00:06:42,2,True,17,29,-12,44,5,2
3,00:06:10,1,False,29,17,12,1,10,2
3,00:05:18,1,False,29,17,12,25,10,2
3,00:02:16,2,False,29,17,12,36,6,2
4,00:12:40,1,False,29,24,5,47,10,2
4,00:12:05,2,False,29,24,5,47,10,2
4,00:07:17,1,True,24,29,-5,23,10,2
4,00:07:03,2,True,24,29,-5,23,10,2
4,00:06:12,1,True,24,29,-5,19,10,2
4,00:04:34,2,True,24,29,-5,25,20,2
4,00:01:26,1,False,32,24,8,47,10,2
4,00:00:43,1,False,32,32,0,38,10,2
5,00:00:00,1,False,32,32,0,35,10,2
5,00:00:00,2,False,32,32,0,15,6,2
1,00:14:43,2,True,0,0,0,50,5,2
1,00:12:53,1,False,0,0,0,37,10,2
1,00:12:28,2,False,0,0,0,37,10,2
1,00:00:40,2,False,0,0,0,7,1,2
2,00:09:19,1,False,7,0,7,54,10,2
2,00:08:13,2,True,0,7,-7,46,20,2
2,00:06:13,1,True,0,7,-7,7,7,2
2,00:05:35,2,True,0,7,-7,7,7,2
2,00:00:33,1,False,10,7,3,27,10,2
3,00:14:48,1,False,10,7,3,45,10,2
3,00:13:55,1,True,7,10,-3,46,10,2
3,00:13:24,2,True,7,10,-3,46,10,2
3,00:09:37,2,False,11,7,4,55,6,2
3,00:08:13,2,True,7,12,-5,40,5,2
3,00:07:10,1,False,12,7,5,20,10,2
3,00:06:59,2,False,12,7,5,20,10,2
3,00:04:28,2,False,12,7,5,46,6,2
3,00:00:17,2,True,7,12,-5,50,15,2
4,00:07:03,2,True,7,12,-5,9,5,2
4,00:00:58,1,True,7,15,-8,43,10,2
1,00:14:53,1,True,0,0,0,35,10,2
1,00:11:32,1,False,0,7,-7,39,10,2
1,00:08:39,1,True,7,0,7,34,10,2
1,00:03:50,1,False,0,7,-7,20,10,2
1,00:03:20,2,False,0,7,-7,20,10,2
1,00:00:01,1,False,0,10,-10,53,10,2
2,00:13:45,2,False,0,10,-10,9,7,2
2,00:08:45,1,True,13,0,13,26,10,2
2,00:02:40,1,False,0,14,-14,33,10,2
3,00:11:49,1,False,0,14,-14,45,10,2
3,00:10:00,1,False,0,17,-17,50,10,2
3,00:09:40,2,False,0,17,-17,50,10,2
3,00:08:57,1,True,17,0,17,10,10,2
3,00:06:02,2,True,17,0,17,48,6,2
3,00:00:03,2,True,17,0,17,20,5,2
4,00:10:44,2,True,17,0,17,43,5,2
4,00:07:37,1,True,17,0,17,45,10,2
4,00:07:15,2,True,17,0,17,45,10,2
4,00:05:51,2,True,17,0,17,17,4,2
4,00:00:10,1,True,24,0,24,54,10,2
4,00:00:01,2,True,24,0,24,54,10,2
1,00:13:34,1,True,0,0,0,47,10,2
1,00:11:48,2,True,0,0,0,36,9,2
1,00:10:41,2,True,0,3,-3,19,6,2
1,00:09:56,1,True,0,3,-3,53,10,2
1,00:05:53,2,False,3,0,3,25,9,2
1,00:03:28,2,True,0,3,-3,47,12,2
1,00:02:20,2,False,3,0,3,47,6,2
2,00:13:49,1,True,2,3,-1,41,10,2
2,00:04:35,1,False,10,5,5,35,10,2
2,00:02:29,2,True,5,10,-5,34,4,2
2,00:01:33,1,False,10,5,5,50,10,2
2,00:01:04,1,True,5,10,-5,49,10,2
2,00:00:55,2,True,5,10,-5,49,10,2
2,00:00:40,2,True,5,10,-5,24,17,2
3,00:13:59,1,True,5,10,-5,42,20,2
3,00:11:46,2,True,5,13,-8,25,20,2
3,00:06:24,2,False,13,5,8,45,6,2
3,00:05:21,2,True,5,13,-8,22,9,2
3,00:00:35,2,True,5,13,-8,41,9,2
4,00:11:26,1,True,5,13,-8,32,10,2
4,00:11:12,2,True,5,13,-8,32,10,2
4,00:10:14,1,False,16,5,11,47,10,2
4,00:09:58,2,False,16,5,11,47,10,2
4,00:08:59,2,False,16,5,11,17,3,2
4,00:05:52,0,True,11,16,-5,5,0,2
4,00:04:48,2,False,16,11,5,15,4,2
4,00:02:38,2,False,16,11,5,51,6,2
4,00:01:43,1,True,11,16,-5,55,10,2
4,00:00:29,1,False,16,11,5,3,3,2
4,00:00:16,3,False,16,11,5,3,3,2
1,00:07:38,2,True,0,7,-7,51,4,2
1,00:05:14,1,False,7,0,7,47,10,2
1,00:03:07,1,False,7,0,7,32,10,2
2,00:14:27,2,False,7,0,7,45,7,2
2,00:08:18,2,True,0,7,-7,52,11,2
2,00:07:07,1,False,7,0,7,17,10,2
2,00:06:57,2,False,7,0,7,17,10,2
2,00:06:20,1,False,7,3,4,35,10,2
2,00:03:13,2,False,7,3,4,44,7,2
3,00:14:33,2,True,3,7,-4,38,4,2
3,00:11:46,2,False,7,3,4,38,13,2
3,00:10:27,2,False,7,3,4,13,5,2
3,00:07:42,1,False,7,8,-1,35,10,2
3,00:05:15,1,False,7,8,-1,46,10,2
3,00:02:00,1,False,7,11,-4,45,10,2
4,00:13:40,2,False,7,11,-4,16,6,2
4,00:12:23,1,False,7,11,-4,23,10,2
4,00:12:04,2,False,7,11,-4,23,10,2
4,00:09:40,1,False,7,14,-7,50,10,2
4,00:06:45,1,True,14,7,7,42,10,2
4,00:06:26,2,True,14,7,7,42,10,2
4,00:01:42,1,False,7,14,-7,50,10,2
1,00:14:54,1,False,0,0,0,25,10,2
1,00:13:10,2,False,0,7,-7,38,3,2
1,00:11:57,1,True,7,0,7,52,10,2
1,00:11:28,1,False,0,7,-7,46,10,2
1,00:08:21,2,True,7,7,0,30,7,2
1,00:05:40,2,False,7,7,0,37,3,2
2,00:01:07,1,True,21,17,4,43,10,2
2,00:00:54,2,True,21,17,4,38,5,2
2,00:00:49,3,True,21,17,4,38,5,2
3,00:07:06,2,True,31,17,14,15,5,2
4,00:08:08,1,True,42,20,22,26,10,2
4,00:07:41,2,True,42,20,22,26,10,2
4,00:03:10,3,False,20,42,-22,33,3,2
4,00:03:06,1,False,20,42,-22,33,10,2
1,00:12:03,2,True,0,0,0,34,5,2
1,00:01:57,1,True,0,2,-2,33,10,2
2,00:14:08,2,True,0,2,-2,54,8,2
2,00:12:52,2,True,0,2,-2,18,7,2
2,00:11:52,1,False,2,0,2,35,10,2
2,00:11:44,2,False,2,0,2,35,10,2
2,00:09:14,2,True,0,2,-2,43,7,2
2,00:06:50,1,True,0,2,-2,11,10,2
2,00:00:39,1,True,0,9,-9,26,10,2
3,00:11:07,1,True,0,9,-9,50,10,2
3,00:10:49,2,True,0,9,-9,50,10,2
3,00:09:33,2,True,0,10,-10,39,6,2
3,00:08:17,1,True,0,10,-10,7,7,2
3,00:04:51,1,True,0,17,-17,14,10,2
4,00:14:23,2,False,24,16,8,47,7,2
4,00:12:37,1,True,16,24,-8,20,10,2
4,00:08:17,1,False,24,24,0,49,10,2
4,00:05:10,1,True,24,24,0,50,10,2
1,00:14:50,1,True,0,0,0,42,10,2
1,00:13:02,2,False,0,0,0,48,4,2
1,00:12:00,2,False,0,0,0,6,9,2
2,00:14:01,1,True,17,7,10,36,5,2
2,00:03:19,1,True,20,21,-1,45,10,2
2,00:00:48,1,False,21,20,1,41,10,2
3,00:14:50,1,False,21,20,1,30,10,2
3,00:11:57,1,True,20,21,-1,35,10,2
3,00:08:03,1,False,21,20,1,6,6,2
3,00:07:36,2,False,21,20,1,6,6,2
3,00:00:16,1,False,21,23,-2,21,10,2
4,00:15:00,2,False,21,23,-2,21,10,2
4,00:14:26,1,False,21,26,-5,35,10,2
4,00:11:49,2,False,21,26,-5,20,16,2
4,00:05:28,2,False,24,29,-5,14,5,2
4,00:04:34,1,False,24,30,-6,35,10,2
4,00:00:48,1,True,33,24,9,30,10,2
1,00:13:40,1,False,0,0,0,40,10,2
1,00:12:12,1,False,0,0,0,55,10,2
1,00:09:56,2,True,0,0,0,45,7,2
1,00:07:38,2,True,0,0,0,52,10,2
1,00:04:02,2,False,0,0,0,37,4,2
1,00:01:48,1,True,0,0,0,28,10,2
2,00:15:00,1,False,10,0,10,50,10,2
2,00:13:40,2,False,10,0,10,27,8,2
2,00:05:55,2,False,10,3,7,8,6,2
2,00:05:02,1,True,6,10,-4,54,10,2
2,00:04:42,2,True,6,10,-4,54,10,2
2,00:04:08,1,True,6,10,-4,26,10,2
2,00:01:56,1,False,10,6,4,24,10,2
2,00:01:15,1,False,10,9,1,35,10,2
2,00:01:09,2,False,10,9,1,35,10,2
3,00:09:23,1,False,10,9,1,30,10,2
3,00:09:07,2,False,10,9,1,30,10,2
3,00:07:31,2,False,10,12,-2,40,9,2
3,00:05:55,1,True,12,10,2,24,10,2
3,00:05:35,2,True,12,10,2,24,10,2
4,00:13:29,1,True,12,17,-5,29,10,2
4,00:12:48,1,True,12,17,-5,39,10,2
4,00:12:22,2,True,12,17,-5,39,10,2
4,00:11:06,1,False,17,12,5,42,10,2
4,00:09:23,1,False,17,12,5,23,10,2
4,00:07:09,1,True,14,17,-3,49,10,2
4,00:01:09,2,True,19,17,2,51,12,2
4,00:01:04,3,True,19,17,2,51,12,2
4,00:00:21,1,False,17,19,-2,28,10,2
4,00:00:17,2,False,17,19,-2,28,10,2
1,00:02:44,1,False,7,0,7,45,10,2
2,00:11:35,1,True,0,10,-10,24,10,2
2,00:10:16,2,True,0,10,-10,13,8,2
2,00:02:47,1,True,7,13,-6,33,10,2
3,00:14:28,1,True,10,20,-10,52,10,2
3,00:11:27,2,True,10,20,-10,31,17,2
3,00:10:03,1,True,10,23,-13,25,20,2
3,00:04:28,1,True,13,23,-10,22,10,2
3,00:00:02,1,False,30,13,17,18,10,2
4,00:12:34,1,False,30,20,10,40,10,2
4,00:10:10,1,True,20,30,-10,53,10,2
4,00:09:33,2,True,20,30,-10,53,10,2
4,00:06:29,1,True,20,30,-10,33,10,2
4,00:04:45,1,True,20,33,-13,45,10,2
4,00:04:13,2,True,20,33,-13,45,10,2
4,00:03:31,1,False,33,20,13,50,10,2
4,00:01:53,2,False,33,27,6,26,8,2
4,00:00:59,2,False,33,34,-1,46,15,2
4,00:00:23,3,False,33,34,-1,7,7,2
1,00:12:45,2,False,0,0,0,54,9,2
1,00:10:24,1,False,0,0,0,33,10,2
1,00:09:40,1,False,0,0,0,22,10,2
1,00:09:19,2,False,0,0,0,22,10,2
1,00:05:54,1,True,3,0,3,44,10,2
1,00:05:30,2,True,3,0,3,44,10,2
1,00:03:49,2,True,3,0,3,37,4,2
1,00:00:45,2,True,3,0,3,51,19,2
2,00:13:40,2,True,3,0,3,26,16,2
2,00:11:49,1,True,3,0,3,48,10,2
2,00:04:23,2,True,10,0,10,27,4,2
2,00:02:49,1,True,10,3,7,50,10,2
2,00:02:20,2,False,3,17,-14,29,7,2
2,00:01:00,1,False,3,17,-14,50,10,2
2,00:00:44,2,False,3,17,-14,50,10,2
3,00:09:32,1,False,3,24,-21,44,10,2
3,00:05:45,2,False,3,24,-21,23,12,2
3,00:01:36,1,True,27,3,24,52,10,2
4,00:14:30,2,True,27,3,24,40,6,2
4,00:04:41,2,False,3,34,-31,47,4,2
4,00:02:39,1,False,3,41,-38,35,10,2
4,00:01:15,2,False,3,41,-38,53,9,2
4,00:00:51,3,False,3,41,-38,53,9,2
1,00:11:54,2,True,0,0,0,52,6,2
1,00:09:54,2,True,0,0,0,19,13,2
1,00:07:37,1,True,0,0,0,7,10,2
1,00:04:15,1,True,0,0,0,11,10,2
1,00:02:44,2,True,0,7,-7,39,6,2
2,00:12:06,2,True,0,7,-7,31,4,2
2,00:07:50,1,True,7,7,0,47,10,2
2,00:07:30,2,True,7,7,0,47,10,2
2,00:03:14,2,False,7,14,-7,20,8,2
2,00:00:59,1,False,7,14,-7,52,10,2
2,00:00:54,2,False,7,14,-7,52,10,2
2,00:00:43,1,False,7,14,-7,38,10,2
3,00:05:58,2,False,7,21,-14,18,3,2
3,00:05:02,1,False,7,24,-17,30,10,2
3,00:01:27,2,False,7,31,-24,34,7,2
4,00:15:00,1,True,34,7,27,32,10,2
4,00:14:49,2,True,34,7,27,32,10,2
4,00:13:34,2,True,34,7,27,49,12,2
4,00:02:50,1,True,37,9,28,49,10,2
1,00:12:32,2,True,0,0,0,34,4,2
1,00:11:30,2,False,0,0,0,31,5,2
1,00:07:12,1,False,0,0,0,11,10,2
1,00:04:02,1,False,0,7,-7,18,10,2
1,00:01:50,2,False,0,10,-10,40,5,2
2,00:13:52,2,False,0,10,-10,34,4,2
2,00:09:30,2,False,0,11,-11,26,6,2
2,00:07:36,2,False,0,14,-14,53,6,2
2,00:04:54,2,False,0,21,-21,10,8,2
2,00:02:35,1,False,0,28,-28,2,13,2
2,00:01:47,2,True,30,0,30,53,3,2
2,00:01:05,2,False,0,30,-30,33,2,2
2,00:00:19,1,False,0,30,-30,41,10,2
3,00:14:22,1,True,37,0,37,46,10,2
3,00:10:37,1,False,0,40,-40,35,10,2
3,00:09:20,2,True,40,0,40,45,3,2
3,00:08:06,2,True,40,0,40,36,9,2
3,00:07:36,1,True,40,3,37,35,10,2
3,00:07:25,2,True,40,3,37,35,10,2
3,00:04:05,3,False,3,40,-37,34,2,2
3,00:01:50,2,True,40,3,37,24,6,2
4,00:14:30,2,False,6,40,-34,39,13,2
4,00:13:05,1,False,6,41,-35,55,10,2
4,00:11:04,1,True,41,6,35,19,10,2
4,00:10:40,2,True,41,6,35,19,10,2
4,00:05:34,3,True,41,9,32,25,3,2
4,00:02:56,1,False,9,41,-32,45,10,2
4,00:02:31,1,False,9,41,-32,2,10,2
4,00:01:57,2,False,9,41,-32,38,3,2
4,00:01:27,1,True,41,9,32,49,10,2
4,00:01:18,2,True,41,9,32,49,10,2
4,00:00:01,2,False,9,41,-32,36,8,2
1,00:13:51,1,True,0,0,0,51,10,2
1,00:12:08,1,False,0,0,0,48,10,2
1,00:09:27,2,False,0,0,0,14,3,2
1,00:08:45,2,False,0,3,-3,34,11,2
1,00:07:05,2,True,3,0,3,43,13,2
1,00:05:50,1,False,0,3,-3,53,20,2
1,00:05:26,2,False,0,3,-3,53,20,2
1,00:04:49,1,False,0,4,-4,35,10,2
1,00:00:01,1,True,4,0,4,46,10,2
2,00:11:33,1,True,4,0,4,47,10,2
2,00:07:02,2,False,1,4,-3,30,19,2
2,00:05:16,1,True,4,1,3,48,10,2
2,00:02:59,1,True,4,1,3,18,10,2
2,00:02:44,2,True,4,1,3,18,10,2
3,00:14:01,1,False,1,7,-6,51,10,2
3,00:11:14,1,True,7,1,6,15,10,2
3,00:01:30,2,True,7,3,4,20,9,2
4,00:13:41,1,False,6,15,-9,35,10,2
4,00:13:23,2,False,6,15,-9,35,10,2
4,00:11:21,2,False,6,15,-9,53,3,2
4,00:09:51,2,False,6,15,-9,19,12,2
4,00:09:29,1,True,15,6,9,51,10,2
4,00:07:40,1,False,6,16,-10,51,10,2
4,00:07:11,2,False,6,16,-10,51,10,2
4,00:05:15,1,False,6,16,-10,29,10,2
4,00:04:56,2,False,6,16,-10,29,10,2
4,00:03:30,2,False,6,16,-10,33,2,2
1,00:09:00,1,False,0,0,0,23,10,2
1,00:08:30,2,False,0,0,0,23,10,2
1,00:02:08,1,True,3,3,0,44,5,2
2,00:14:54,1,True,3,10,-7,35,10,2
2,00:10:02,1,False,10,6,4,47,10,2
2,00:09:36,2,False,10,6,4,47,10,2
2,00:06:41,2,False,10,6,4,54,4,2
2,00:02:40,2,False,10,6,4,36,13,2
2,00:02:25,1,True,6,10,-4,37,10,2
2,00:00:31,2,True,6,10,-4,50,4,2
3,00:12:44,2,True,6,10,-4,44,8,2
3,00:12:00,1,True,6,10,-4,4,10,2
3,00:11:43,2,True,6,10,-4,4,10,2
3,00:10:17,1,True,6,10,-4,30,10,2
3,00:09:52,2,True,6,10,-4,30,10,2
3,00:08:14,2,True,6,13,-7,36,9,2
4,00:12:33,2,True,6,20,-14,55,7,2
4,00:06:00,2,True,9,20,-11,48,5,2
4,00:05:17,1,True,9,20,-11,52,10,2
4,00:04:01,1,False,20,9,11,44,10,2
4,00:02:49,2,False,20,12,8,40,5,2
4,00:01:47,1,False,20,12,8,44,10,2
1,00:10:06,1,True,0,0,0,20,10,2
1,00:08:52,1,True,0,7,-7,36,10,2
1,00:08:41,2,True,0,7,-7,36,10,2
1,00:02:50,1,False,14,0,14,28,10,2
2,00:13:20,1,False,15,3,12,22,10,2
2,00:13:00,2,False,15,3,12,22,10,2
2,00:03:55,1,False,16,6,10,49,10,2
2,00:03:33,2,False,16,6,10,49,10,2
2,00:01:57,2,True,6,16,-10,47,9,2
2,00:01:10,2,True,6,16,-10,47,5,2
2,00:00:52,1,False,16,6,10,26,10,2
3,00:13:45,2,False,16,6,10,50,5,2
3,00:06:47,1,False,23,7,16,30,10,2
3,00:06:31,2,False,23,7,16,30,10,2
3,00:05:44,1,False,23,7,16,25,10,2
3,00:05:27,2,False,23,7,16,25,10,2
3,00:04:04,2,True,7,23,-16,55,5,2
4,00:07:02,1,False,26,23,3,51,10,2
4,00:06:53,2,False,26,23,3,51,10,2
4,00:03:15,1,True,23,26,-3,37,10,2
4,00:01:16,2,True,23,33,-10,39,3,2
4,00:01:07,3,True,23,33,-10,39,3,2
1,00:14:56,1,True,0,0,0,27,10,2
1,00:13:00,2,True,0,0,0,35,10,2
1,00:09:47,2,True,0,0,0,33,9,2
1,00:08:47,2,False,0,0,0,36,7,2
1,00:01:54,1,True,3,0,3,48,10,2
2,00:12:50,1,True,3,0,3,35,10,2
2,00:09:04,1,True,3,3,0,33,10,2
2,00:02:52,2,False,4,3,1,34,6,2
2,00:02:24,1,True,3,4,-1,54,10,2
2,00:01:23,1,False,4,3,1,17,10,2
2,00:00:41,1,False,4,10,-6,10,10,2
2,00:00:35,2,False,4,10,-6,10,10,2
3,00:11:22,2,False,11,13,-2,20,4,2
3,00:08:58,1,True,13,11,2,54,20,2
3,00:08:29,2,True,13,11,2,54,20,2
3,00:07:42,1,False,11,13,-2,53,10,2
3,00:02:18,1,False,14,13,1,41,10,2
4,00:13:46,2,True,13,14,-1,22,21,2
4,00:13:10,1,True,13,17,-4,35,10,2
4,00:12:55,2,True,13,17,-4,35,10,2
4,00:06:00,1,True,13,24,-11,55,10,2
4,00:05:47,2,True,13,24,-11,55,10,2
4,00:02:46,3,True,13,24,-11,38,3,2
4,00:01:10,1,False,24,13,11,28,10,2
4,00:00:55,2,False,24,13,11,28,10,2
4,00:00:42,0,True,19,24,-5,5,0,2
4,00:00:01,3,True,19,24,-5,31,4,2
1,00:11:20,1,False,0,0,0,5,5,2
2,00:14:14,2,False,7,7,0,43,8,2
2,00:10:35,1,False,7,7,0,53,10,2
2,00:10:28,2,False,7,7,0,53,10,2
2,00:09:32,2,False,7,7,0,10,5,2
2,00:02:26,1,False,10,7,3,48,10,2
3,00:12:50,1,True,7,13,-6,11,10,2
3,00:09:51,1,True,7,20,-13,39,10,2
3,00:09:16,2,True,7,20,-13,39,10,2
3,00:03:31,1,False,23,7,16,10,10,2
4,00:14:45,1,False,23,10,13,53,10,2
4,00:11:12,2,False,23,17,6,34,11,2
4,00:10:30,1,True,17,23,-6,48,10,2
4,00:08:57,1,False,23,17,6,9,10,2
4,00:03:35,1,True,17,23,-6,49,10,2
4,00:02:57,2,True,17,23,-6,49,10,2
4,00:02:20,2,True,17,23,-6,17,3,2
4,00:01:15,1,True,17,23,-6,23,10,2
4,00:01:09,2,True,17,23,-6,23,10,2
1,00:11:22,1,False,0,0,0,30,10,2
1,00:11:03,2,False,0,0,0,30,10,2
1,00:10:21,1,False,0,1,-1,35,10,2
1,00:10:02,2,False,0,1,-1,35,10,2
1,00:04:45,1,True,1,0,1,28,10,2
2,00:14:30,2,False,3,8,-5,20,13,2
2,00:07:12,2,True,8,10,-2,33,9,2
2,00:03:30,2,True,8,10,-2,25,5,2
2,00:02:58,1,True,8,13,-5,35,10,2
2,00:02:17,1,False,13,8,5,29,10,2
2,00:01:42,1,False,13,8,5,51,10,2
2,00:01:17,2,False,13,8,5,51,10,2
3,00:07:16,2,True,15,27,-12,36,10,2
3,00:05:26,1,False,27,15,12,47,10,2
3,00:04:09,1,True,15,27,-12,25,10,2
3,00:01:44,1,False,27,15,12,24,10,2
3,00:01:23,2,False,27,15,12,24,10,2
4,00:12:08,0,True,21,27,-6,5,0,2
4,00:08:53,1,False,27,23,4,43,10,2
4,00:08:12,1,False,27,23,4,21,10,2
4,00:02:22,1,False,27,40,-13,35,10,2
4,00:01:58,2,False,27,40,-13,54,5,2
1,00:09:08,2,False,0,5,-5,44,11,2
1,00:05:22,2,False,0,5,-5,15,5,2
1,00:04:39,1,False,0,8,-8,35,10,2
1,00:04:25,2,False,0,8,-8,35,10,2
1,00:02:26,1,False,0,8,-8,32,10,2
2,00:11:40,1,True,15,0,15,55,20,2
2,00:03:50,2,True,15,7,8,49,11,2
2,00:02:21,1,True,15,7,8,33,10,2
2,00:02:00,2,True,15,7,8,33,10,2
2,00:01:43,1,False,7,15,-8,19,10,2
2,00:01:17,1,True,15,7,8,53,10,2
3,00:14:54,1,True,15,7,8,45,10,2
3,00:12:26,1,False,7,15,-8,30,10,2
3,00:11:30,1,False,7,15,-8,53,10,2
3,00:08:01,2,False,14,15,-1,45,7,2
3,00:00:57,1,False,21,15,6,47,10,2
4,00:12:32,2,False,21,15,6,22,8,2
4,00:07:01,1,False,21,18,3,3,3,2
4,00:02:56,1,True,25,21,4,38,10,2
4,00:02:41,2,True,25,21,4,38,10,2
4,00:00:21,1,False,24,26,-2,35,10,2
4,00:00:14,2,False,24,26,-2,35,10,2
1,00:14:20,2,True,0,0,0,42,7,2
1,00:09:20,1,False,0,3,-3,35,15,2
1,00:05:42,1,True,4,7,-3,30,10,2
1,00:03:13,1,True,4,7,-3,23,10,2
1,00:00:04,2,False,7,4,3,30,11,2
2,00:14:20,1,True,4,7,-3,54,10,2
2,00:12:36,2,False,7,4,3,42,8,2
2,00:10:24,2,False,7,4,3,40,7,2
2,00:06:39,2,False,7,7,0,24,13,2
2,00:01:20,1,True,14,7,7,15,10,2
2,00:00:55,2,True,14,7,7,15,10,2
3,00:15:00,1,False,13,14,-1,45,10,2
3,00:13:15,2,True,14,13,1,15,4,2
3,00:08:43,1,False,13,14,-1,34,10,2
3,00:04:12,1,False,13,17,-4,51,10,2
3,00:00:57,1,True,17,13,4,35,10,2
4,00:14:04,2,False,13,17,-4,22,7,2
4,00:06:51,2,True,17,20,-3,43,14,2
4,00:05:46,2,True,17,21,-4,29,16,2
4,00:02:27,0,True,23,28,-5,5,0,2
1,00:14:26,2,True,0,0,0,52,6,2
1,00:12:54,1,False,0,0,0,25,10,2
1,00:11:23,2,False,0,0,0,28,19,2
1,00:07:15,2,False,0,0,0,21,18,2
1,00:05:57,2,False,0,1,-1,43,2,2
1,00:03:04,1,False,0,1,-1,40,10,2
2,00:15:00,1,True,8,0,8,32,10,2
2,00:10:30,1,False,7,8,-1,42,10,2
2,00:06:55,2,True,15,14,1,41,4,2
2,00:04:15,2,True,15,14,1,42,9,2
2,00:02:04,1,True,15,14,1,44,10,2
2,00:00:51,2,True,15,14,1,44,33,2
3,00:11:16,1,True,15,14,1,15,10,2
3,00:10:53,2,True,15,14,1,15,10,2
3,00:03:21,1,True,22,24,-2,19,10,2
3,00:02:55,2,True,22,24,-2,19,10,2
4,00:12:37,1,True,22,24,-2,21,5,2
4,00:12:15,2,True,22,24,-2,21,5,2
4,00:11:16,1,True,22,27,-5,46,10,2
4,00:06:40,2,False,27,25,2,50,11,2
4,00:03:40,1,True,25,34,-9,46,10,2
4,00:02:42,1,False,34,25,9,36,10,2
1,00:09:41,2,False,0,7,-7,34,7,2
1,00:03:25,2,True,7,0,7,46,6,2
1,00:02:00,2,True,7,0,7,14,8,2
2,00:12:00,2,False,3,10,-7,45,7,2
2,00:08:55,2,True,10,3,7,40,12,2
2,00:01:22,2,False,3,10,-7,55,5,2
2,00:00:14,1,True,10,3,7,7,7,2
3,00:10:15,1,True,10,9,1,41,10,2
3,00:08:34,1,False,9,10,-1,40,10,2
3,00:08:13,2,False,9,10,-1,40,10,2
3,00:07:26,1,False,9,11,-2,35,10,2
3,00:06:54,2,False,9,11,-2,30,15,2
3,00:05:10,2,True,11,9,2,47,12,2
3,00:00:57,2,True,11,9,2,35,8,2
4,00:14:07,1,True,11,9,2,40,20,2
4,00:11:00,1,False,9,11,-2,51,10,2
4,00:07:35,2,True,11,9,2,3,3,2
4,00:06:08,2,True,11,12,-1,23,8,2
4,00:02:52,1,True,11,18,-7,20,20,2
4,00:01:18,2,False,18,11,7,17,14,2
4,00:00:56,3,False,18,11,7,17,14,2
1,00:14:05,2,False,0,0,0,35,11,2
1,00:13:28,1,True,0,0,0,38,10,2
1,00:11:55,2,False,0,0,0,40,11,2
1,00:08:15,1,True,3,0,3,35,10,2
1,00:05:24,1,False,0,10,-10,34,10,2
1,00:05:06,2,False,0,10,-10,34,10,2
1,00:01:22,1,True,10,3,7,31,10,2
1,00:00:52,2,True,10,3,7,31,10,2
2,00:15:00,2,False,3,10,-7,29,9,2
2,00:09:05,2,False,3,17,-14,47,4,2
2,00:07:06,2,True,17,3,14,40,4,2
2,00:06:12,1,False,3,17,-14,27,10,2
2,00:01:15,2,False,3,20,-17,15,7,2
2,00:00:55,1,False,3,20,-17,53,10,2
3,00:14:14,2,True,20,3,17,30,3,2
3,00:06:15,1,True,27,3,24,21,10,2
3,00:02:16,2,False,3,27,-24,8,6,2
3,00:00:02,1,False,3,30,-27,46,10,2
4,00:15:00,2,False,3,30,-27,46,10,2
4,00:07:37,1,True,37,3,34,43,10,2
4,00:07:22,1,True,37,3,34,43,10,2
4,00:02:23,1,False,3,37,-34,26,10,2
4,00:02:18,2,False,3,37,-34,26,10,2
1,00:13:42,1,False,0,0,0,46,10,2
1,00:13:10,2,False,0,0,0,46,10,2
1,00:10:36,1,False,0,0,0,38,10,2
1,00:10:18,2,False,0,0,0,38,10,2
1,00:06:48,1,True,0,0,0,36,10,2
1,00:06:39,2,True,0,0,0,36,10,2
1,00:01:44,1,False,3,0,3,38,10,2
1,00:01:31,2,False,3,0,3,38,10,2
2,00:14:50,2,False,3,0,3,23,18,2
2,00:04:57,1,True,7,4,3,35,10,2
2,00:04:36,2,True,7,4,3,35,10,2
2,00:03:21,2,False,4,7,-3,52,6,2
2,00:01:06,1,True,7,4,3,27,10,2
2,00:00:01,1,True,7,11,-4,43,10,2
3,00:10:51,3,True,7,11,-4,25,12,2
3,00:09:32,2,False,11,7,4,48,5,2
3,00:08:13,2,True,7,11,-4,46,4,2
4,00:15:00,1,False,14,7,7,38,10,2
4,00:14:43,2,False,14,7,7,38,10,2
4,00:13:25,1,False,14,10,4,30,10,2
4,00:06:52,2,True,17,14,3,47,10,2
4,00:05:05,2,False,14,17,-3,40,10,2
4,00:03:23,2,True,17,14,3,51,7,2
4,00:02:03,1,False,14,17,-3,51,10,2
4,00:01:59,2,False,14,17,-3,51,10,2
4,00:01:55,3,False,14,17,-3,51,10,2
1,00:13:52,2,False,0,0,0,42,14,2
1,00:12:40,1,True,0,0,0,51,10,2
1,00:08:00,1,False,0,14,-14,20,20,2
1,00:05:00,1,False,0,14,-14,37,10,2
1,00:03:50,1,False,0,14,-14,25,10,2
1,00:00:30,2,False,0,14,-14,32,7,2
2,00:11:03,2,True,17,0,17,53,11,2
2,00:04:40,1,False,0,17,-17,7,7,2
2,00:02:50,2,False,0,20,-20,29,16,2
2,00:01:53,1,True,20,0,20,45,10,2
2,00:00:27,1,False,0,20,-20,29,10,2
3,00:11:02,1,False,1,20,-19,34,10,2
3,00:08:08,2,False,1,20,-19,45,11,2
3,00:03:17,2,True,20,1,19,46,8,2
3,00:02:07,2,True,20,2,18,40,5,2
4,00:12:43,1,True,20,2,18,14,10,2
4,00:12:17,2,True,20,2,18,14,10,2
4,00:04:11,1,True,23,5,18,14,10,2
4,00:03:09,3,True,23,5,18,7,3,2
4,00:02:12,1,False,5,23,-18,47,10,2
4,00:02:01,3,False,5,23,-18,52,6,2
4,00:01:39,1,False,5,23,-18,52,10,2
4,00:00:59,1,False,5,23,-18,7,10,2
4,00:00:31,1,False,5,23,-18,44,10,2
1,00:14:03,1,True,0,0,0,35,10,2
1,00:12:10,1,True,0,0,0,5,5,2
1,00:11:52,2,True,0,0,0,5,5,2
1,00:07:44,2,False,3,0,3,11,6,2
1,00:04:42,2,True,3,3,0,43,11,2
1,00:01:30,1,False,3,3,0,49,10,2
1,00:01:10,2,False,3,3,0,49,10,2
2,00:10:22,1,False,10,3,7,29,10,2
2,00:03:48,1,True,6,10,-4,13,10,2
3,00:12:09,2,False,24,13,11,43,8,2
3,00:10:39,2,False,24,13,11,24,5,2
3,00:09:49,1,False,24,13,11,45,10,2
3,00:08:20,2,False,24,13,11,18,11,2
3,00:03:47,1,True,16,24,-8,24,10,2
4,00:13:14,1,True,16,27,-11,33,10,2
4,00:11:18,1,True,16,30,-14,35,10,2
4,00:02:25,2,True,16,30,-14,7,6,2
4,00:01:58,1,True,16,33,-17,45,10,2
1,00:12:59,1,False,0,0,0,11,10,2
1,00:12:37,2,False,0,0,0,11,10,2
1,00:06:25,2,False,0,4,-4,48,8,2
1,00:02:35,1,False,0,4,-4,47,10,2
2,00:14:10,1,False,0,4,-4,35,10,2
2,00:10:30,2,False,0,4,-4,40,5,2
2,00:06:35,2,True,11,0,11,16,7,2
2,00:04:40,1,True,11,3,8,37,10,2
2,00:02:58,2,True,11,3,8,23,6,2
2,00:01:21,1,False,6,11,-5,41,10,2
3,00:14:54,1,False,6,11,-5,32,10,2
3,00:11:52,2,False,6,11,-5,41,14,2
3,00:09:35,1,False,6,14,-8,35,10,2
3,00:09:27,2,False,6,14,-8,35,10,2
3,00:08:26,1,True,14,6,8,34,10,2
3,00:05:20,2,True,14,6,8,55,13,2
3,00:03:45,2,False,6,14,-8,27,6,2
4,00:09:05,1,True,21,6,15,21,10,2
4,00:07:40,2,True,21,6,15,5,5,2
4,00:03:02,1,False,9,28,-19,13,10,2
4,00:02:32,1,False,9,28,-19,27,15,2
4,00:01:57,3,False,9,28,-19,50,7,2
4,00:01:02,1,False,9,29,-20,35,10,2
4,00:00:19,0,False,15,29,-14,5,0,2
1,00:12:10,2,True,0,0,0,30,4,2
1,00:11:05,1,True,0,1,-1,47,10,2
1,00:08:57,1,False,1,0,1,16,10,2
1,00:08:30,2,False,1,0,1,16,10,2
2,00:12:26,1,True,7,1,6,51,10,2
2,00:11:21,2,True,7,1,6,29,5,2
2,00:08:03,1,True,7,1,6,18,10,2
2,00:06:41,1,True,7,4,3,41,10,2
2,00:03:57,1,False,4,7,-3,31,10,2
2,00:03:42,2,False,4,7,-3,31,10,2
2,00:02:55,2,False,4,10,-6,35,10,2
2,00:02:31,2,True,10,4,6,47,9,2
2,00:01:24,1,False,4,10,-6,40,10,2
2,00:00:45,0,True,16,4,12,5,0,2
3,00:13:19,2,True,16,4,12,47,10,2
3,00:12:27,2,False,4,16,-12,30,4,2
4,00:10:41,2,True,24,7,17,50,7,2
4,00:07:14,1,True,24,7,17,17,10,2
4,00:06:58,2,True,24,7,17,17,10,2
4,00:06:20,1,True,24,10,14,35,10,2
4,00:05:02,1,False,10,24,-14,50,10,2
4,00:04:55,2,False,10,24,-14,50,10,2
4,00:00:40,2,False,17,24,-7,20,8,2
4,00:00:18,1,False,17,24,-7,31,10,2
1,00:09:25,2,True,0,0,0,37,7,2
1,00:08:55,1,False,0,0,0,37,10,2
1,00:05:31,2,False,0,0,0,44,11,2
1,00:03:52,1,False,0,1,-1,49,10,2
1,00:03:33,2,False,0,1,-1,49,10,2
1,00:00:50,2,True,1,0,1,50,2,2
1,00:00:09,1,False,0,1,-1,32,10,2
2,00:13:08,2,False,0,1,-1,34,6,2
2,00:09:52,2,False,0,1,-1,27,9,2
2,00:04:17,1,False,0,8,-8,55,10,2
2,00:02:58,1,True,8,0,8,22,10,2
2,00:02:44,2,True,8,0,8,22,10,2
2,00:01:31,1,False,3,8,-5,32,10,2
2,00:01:19,1,False,3,8,-5,16,10,2
2,00:01:03,1,False,3,15,-12,22,10,2
2,00:00:57,2,False,3,15,-12,22,10,2
2,00:00:36,2,False,3,15,-12,47,3,2
3,00:03:34,1,False,3,29,-26,8,15,2
3,00:01:20,1,False,3,36,-33,29,10,2
4,00:06:05,2,False,3,50,-47,37,3,2
4,00:00:53,1,True,50,11,39,8,8,2
1,00:14:12,2,True,0,0,0,30,11,2
1,00:13:34,1,False,0,0,0,17,10,2
1,00:08:44,2,True,7,0,7,17,11,2
1,00:07:39,2,True,7,0,7,45,9,2
1,00:00:30,2,True,7,1,6,48,13,2
2,00:15:00,1,True,7,1,6,19,10,2
2,00:11:55,1,False,1,14,-13,31,10,2
2,00:10:22,2,False,1,15,-14,41,4,2
2,00:09:40,1,True,15,1,14,32,10,2
2,00:07:17,2,False,1,22,-21,42,8,2
2,00:04:32,1,False,1,22,-21,31,10,2
2,00:03:51,1,False,1,22,-21,45,10,2
2,00:03:03,1,False,1,22,-21,55,10,2
2,00:02:26,1,True,22,1,21,35,10,2
2,00:02:01,2,True,22,1,21,35,10,2
3,00:12:22,1,False,4,29,-25,47,10,2
3,00:06:50,1,True,36,4,32,3,3,2
3,00:02:17,2,True,36,18,18,33,7,2
4,00:15:00,2,False,18,36,-18,48,18,2
4,00:08:05,1,False,18,36,-18,27,10,2
4,00:05:43,2,False,18,36,-18,49,6,2
4,00:04:55,1,False,18,36,-18,10,10,2
4,00:04:07,3,False,18,36,-18,16,4,2
4,00:02:06,1,False,18,43,-25,42,10,2
4,00:02:00,2,False,18,43,-25,42,10,2
4,00:00:48,1,True,43,18,25,43,10,2
1,00:11:55,2,False,0,0,0,54,7,2
1,00:10:24,2,True,0,0,0,17,15,2
1,00:04:14,2,False,0,7,-7,27,12,2
2,00:12:31,2,False,0,14,-14,50,7,2
2,00:10:39,2,True,14,0,14,33,6,2
2,00:06:24,2,True,14,0,14,19,4,2
2,00:02:47,1,False,0,14,-14,9,9,2
3,00:04:55,2,False,7,17,-10,12,5,2
3,00:01:05,2,True,20,7,13,28,8,2
4,00:12:21,2,True,20,7,13,18,5,2
4,00:11:55,1,True,20,10,10,35,10,2
4,00:09:50,1,True,20,10,10,39,10,2
4,00:04:59,2,True,20,13,7,38,7,2
4,00:02:40,1,True,20,13,7,24,10,2
4,00:02:05,1,True,20,16,4,35,10,2
4,00:00:06,1,False,16,20,-4,54,10,2
1,00:07:14,1,True,3,0,3,38,10,2
1,00:04:23,2,False,0,3,-3,34,5,2
1,00:02:52,1,True,6,0,6,55,10,2
1,00:00:28,1,False,0,6,-6,35,10,2
1,00:00:07,2,False,0,6,-6,35,10,2
2,00:08:49,2,False,0,7,-7,14,6,2
2,00:07:14,2,False,0,10,-10,38,8,2
2,00:02:05,1,False,0,17,-17,52,10,2
2,00:01:45,2,False,0,17,-17,52,10,2
2,00:01:27,2,True,17,0,17,16,10,2
2,00:01:02,1,True,17,0,17,54,10,2
3,00:14:22,1,True,17,7,10,45,10,2
3,00:14:06,2,True,17,7,10,45,10,2
3,00:11:24,2,True,17,7,10,50,5,2
3,00:10:30,2,True,17,7,10,15,8,2
3,00:07:26,2,False,7,17,-10,31,4,2
3,00:06:36,1,False,7,18,-11,35,10,2
3,00:05:27,1,False,7,18,-11,47,10,2
3,00:02:09,2,True,18,7,11,23,5,2
4,00:14:41,3,True,18,10,8,51,1,2
4,00:12:17,1,False,10,18,-8,50,10,2
4,00:11:59,2,False,10,18,-8,50,10,2
4,00:09:55,1,True,18,10,8,24,10,2
4,00:08:05,2,False,10,18,-8,35,15,2
4,00:02:14,1,True,18,10,8,54,20,2
1,00:14:53,1,False,0,0,0,35,10,2
1,00:14:31,2,False,0,0,0,35,10,2
1,00:12:07,2,True,0,0,0,38,8,2
1,00:04:58,2,False,7,0,7,38,7,2
1,00:02:31,2,False,7,0,7,25,8,2
2,00:02:20,1,False,14,10,4,41,10,2
2,00:01:29,2,False,14,10,4,13,4,2
2,00:01:09,1,False,14,13,1,50,10,2
2,00:00:53,2,False,14,13,1,50,10,2
3,00:12:46,2,False,14,20,-6,40,20,2
3,00:10:30,1,True,20,14,6,33,10,2
3,00:01:15,2,True,27,14,13,26,10,2
3,00:00:01,2,True,27,17,10,37,7,2
4,00:14:39,1,False,17,27,-10,49,10,2
4,00:12:44,2,True,27,17,10,35,8,2
4,00:06:40,1,False,24,27,-3,35,10,2
4,00:06:15,2,False,24,27,-3,35,10,2
4,00:03:35,1,False,24,37,-13,38,10,2
4,00:00:05,1,True,40,24,16,27,10,2
1,00:14:11,1,False,0,0,0,53,10,2
1,00:12:25,2,True,0,0,0,24,4,2
1,00:03:42,3,True,7,0,7,40,3,2
2,00:13:55,2,False,0,7,-7,35,10,2
2,00:11:50,1,False,0,7,-7,43,10,2
2,00:10:34,2,False,0,7,-7,24,6,2
2,00:08:01,2,False,0,10,-10,42,4,2
2,00:05:42,2,False,0,10,-10,29,8,2
2,00:03:05,1,False,0,13,-13,23,10,2
2,00:02:16,1,False,0,20,-20,48,10,2
2,00:01:01,2,False,0,20,-20,25,5,2
3,00:08:36,1,False,0,34,-34,25,10,2
3,00:04:48,1,False,0,34,-34,9,9,2
3,00:00:48,2,True,34,0,34,50,3,2
4,00:11:03,2,False,7,34,-27,25,4,2
4,00:07:37,2,True,37,7,30,36,10,2
4,00:01:06,1,True,37,10,27,33,10,2
4,00:00:53,3,True,37,10,27,31,8,2
1,00:14:25,2,True,0,0,0,33,6,2
1,00:07:47,1,True,0,0,0,49,10,2
1,00:07:03,1,False,0,0,0,36,10,2
1,00:04:20,2,False,0,6,-6,48,6,2
2,00:08:56,2,True,6,6,0,50,24,2
2,00:07:01,2,True,6,6,0,35,7,2
2,00:03:16,1,False,6,6,0,46,10,2
2,00:02:53,2,False,6,6,0,46,10,2
2,00:01:53,1,False,6,6,0,53,10,2
3,00:14:44,1,False,13,6,7,24,10,2
3,00:12:05,2,False,13,6,7,50,11,2
3,00:11:14,2,False,13,7,6,31,14,2
3,00:07:56,1,True,7,13,-6,21,10,2
3,00:04:46,1,False,20,14,6,21,10,2
3,00:04:27,2,False,20,14,6,21,10,2
3,00:02:29,1,True,14,20,-6,42,10,2
4,00:14:40,1,True,14,27,-13,41,10,2
4,00:12:10,2,True,14,27,-13,50,13,2
4,00:05:32,0,True,20,34,-14,3,0,2
4,00:03:40,2,False,34,20,14,30,12,2
4,00:01:14,1,False,34,27,7,52,10,2
4,00:01:14,2,False,34,27,7,52,10,2
1,00:09:15,1,False,0,0,0,21,10,2
1,00:08:58,2,False,0,0,0,21,10,2
1,00:04:59,2,True,3,0,3,5,5,2
1,00:04:28,1,True,3,3,0,29,10,2
1,00:00:00,1,False,3,3,0,20,10,2
2,00:14:46,2,False,3,3,0,25,15,2
2,00:12:55,2,False,3,6,-3,38,9,2
2,00:11:43,1,True,6,3,3,42,10,2
2,00:11:00,2,True,6,3,3,42,10,2
2,00:09:32,2,False,3,6,-3,49,6,2
2,00:06:31,2,False,3,6,-3,26,7,2
2,00:03:15,1,True,6,3,3,54,10,2
2,00:02:33,1,True,6,3,3,22,10,2
2,00:01:30,1,True,6,6,0,47,10,2
3,00:12:50,2,False,6,6,0,34,4,2
3,00:07:06,2,False,6,9,-3,21,10,2
3,00:05:52,2,False,6,12,-6,39,6,2
3,00:03:06,1,True,12,6,6,43,10,2
3,00:01:27,1,False,6,12,-6,48,10,2
4,00:01:13,1,False,6,20,-14,22,10,2
1,00:14:54,1,True,0,0,0,30,10,2
1,00:08:03,2,False,0,0,0,33,4,2
1,00:12:40,1,False,0,0,0,32,10,2
1,00:09:33,2,False,0,0,0,32,5,2
1,00:08:19,1,False,0,0,0,25,10,2
1,00:07:35,2,False,0,0,0,30,15,2
1,00:05:37,1,False,0,0,0,50,10,2
1,00:05:19,2,False,0,0,0,50,10,2
1,00:03:40,1,True,0,0,0,49,10,2
1,00:03:26,2,True,0,0,0,49,10,2
2,00:10:04,2,True,0,1,-1,21,6,2
2,00:09:17,1,True,0,4,-4,35,10,2
2,00:04:24,2,False,4,0,4,28,4,2
2,00:02:49,1,False,4,0,4,33,10,2
2,00:02:38,2,False,4,0,4,33,10,2
2,00:02:22,1,False,4,3,1,40,10,2
3,00:12:39,2,False,12,3,9,53,14,2
3,00:10:55,2,True,3,12,-9,34,7,2
3,00:10:09,1,False,12,3,9,40,10,2
3,00:07:07,1,True,3,12,-9,38,10,2
3,00:06:48,2,True,3,12,-9,38,10,2
3,00:01:56,1,True,3,19,-16,48,10,2
4,00:14:04,1,False,19,3,16,55,10,2
1,00:00:37,1,True,7,3,4,42,10,2
1,00:00:16,2,True,7,3,4,42,10,2
2,00:13:25,1,False,3,7,-4,49,10,2
2,00:10:36,1,True,7,10,-3,22,10,2
2,00:08:40,1,True,7,10,-3,26,10,2
2,00:03:37,2,True,7,20,-13,42,5,2
2,00:01:28,1,True,7,20,-13,3,10,2
2,00:01:23,2,True,7,20,-13,3,10,2
2,00:00:50,1,False,22,7,15,33,10,2
2,00:00:35,2,False,22,7,15,2,2,2
2,00:00:10,3,False,22,7,15,2,2,2
3,00:11:30,2,True,7,22,-15,7,7,2
4,00:11:52,2,True,10,30,-20,50,16,2
4,00:10:32,1,False,30,10,20,42,10,2
4,00:10:18,2,False,30,10,20,42,10,2
4,00:08:58,2,False,30,10,20,15,8,2
4,00:03:30,3,True,10,30,-20,20,4,2
4,00:02:41,2,True,10,30,-20,20,10,2
4,00:00:40,1,True,10,30,-20,46,10,2
1,00:07:27,1,False,7,7,0,48,10,2
1,00:05:31,2,True,7,7,0,42,13,2
1,00:03:24,2,True,7,10,-3,39,12,2
2,00:13:15,2,True,7,10,-3,12,3,2
2,00:11:21,2,True,7,13,-6,45,7,2
2,00:04:56,1,True,7,20,-13,39,10,2
2,00:04:35,2,True,7,20,-13,39,10,2
2,00:04:06,1,False,20,7,13,29,10,2
2,00:03:44,2,False,20,7,13,29,10,2
2,00:01:51,1,False,20,7,13,34,10,2
2,00:01:33,2,True,7,20,-13,54,4,2
2,00:00:21,1,False,20,7,13,22,10,2
3,00:13:47,1,True,7,20,-13,42,10,2
3,00:12:44,1,False,20,7,13,40,10,2
3,00:11:28,2,True,7,20,-13,52,6,2
3,00:10:20,2,True,7,20,-13,19,8,2
3,00:07:09,2,True,7,20,-13,13,6,2
3,00:06:14,1,True,7,23,-16,38,10,2
3,00:04:00,1,False,23,7,16,47,10,2
3,00:03:40,2,False,23,7,16,47,10,2
3,00:02:26,2,False,23,7,16,18,6,2
4,00:12:11,2,True,13,23,-10,9,4,2
4,00:09:42,1,False,26,13,13,46,10,2
4,00:09:27,2,False,26,13,13,46,10,2
4,00:05:20,1,False,26,13,13,50,10,2
4,00:03:00,1,False,26,13,13,17,10,2
4,00:02:49,2,False,26,13,13,17,10,2
4,00:01:37,1,True,15,26,-11,35,10,2
4,00:00:32,2,False,26,15,11,33,6,2
1,00:14:50,1,True,0,0,0,35,10,2
1,00:14:38,2,True,0,0,0,35,10,2
1,00:13:57,1,False,0,0,0,53,10,2
1,00:07:54,2,True,6,0,6,7,3,2
1,00:06:22,2,True,6,3,3,37,8,2
1,00:05:15,2,False,3,6,-3,30,5,2
1,00:03:50,2,True,6,3,3,44,7,2
1,00:02:41,2,False,3,6,-3,32,4,2
2,00:06:38,2,False,10,16,-6,35,19,2
2,00:05:34,1,False,10,19,-9,52,10,2
2,00:00:37,1,False,10,19,-9,48,20,2
3,00:07:26,2,False,16,19,-3,32,9,2
3,00:06:34,1,False,16,19,-3,22,10,2
3,00:06:19,2,False,16,19,-3,22,10,2
3,00:00:58,2,True,27,16,11,46,7,2
4,00:07:40,1,True,30,23,7,22,10,2
4,00:06:40,1,True,30,23,7,9,9,2
4,00:05:01,2,True,30,30,0,24,9,2
4,00:00:23,1,True,30,37,-7,48,10,2
1,00:12:36,1,False,0,0,0,10,10,2
1,00:07:41,1,True,6,0,6,27,10,2
1,00:07:29,2,True,6,0,6,27,10,2
1,00:04:54,2,True,6,0,6,50,7,2
1,00:03:44,2,True,6,0,6,14,6,2
1,00:02:45,1,False,0,6,-6,46,10,2
1,00:02:45,1,False,0,6,-6,46,10,2
1,00:02:31,2,False,0,6,-6,46,10,2
1,00:01:22,1,True,6,0,6,21,15,2
1,00:01:08,2,True,6,0,6,21,15,2
2,00:13:51,1,False,0,6,-6,53,10,2
2,00:11:10,2,True,6,0,6,33,5,2
2,00:10:26,1,True,6,3,3,8,10,2
2,00:02:59,2,True,13,5,8,29,7,2
2,00:01:27,1,True,13,5,8,30,10,2
2,00:01:01,1,True,13,5,8,45,10,2
2,00:00:43,2,True,13,5,8,45,10,2
3,00:09:10,1,True,13,5,8,13,10,2
3,00:07:20,2,True,13,13,0,29,9,2
3,00:06:19,2,False,13,13,0,26,6,2
3,00:05:12,1,True,13,13,0,37,10,2
3,00:01:13,1,False,13,16,-3,30,15,2
4,00:09:48,1,True,16,20,-4,35,10,2
4,00:08:05,1,False,20,16,4,44,10,2
4,00:07:13,1,False,20,16,4,55,10,2
4,00:04:56,1,True,16,20,-4,50,10,2
4,00:04:34,2,True,16,20,-4,50,10,2
1,00:06:36,1,False,7,0,7,30,10,2
1,00:02:31,1,True,7,7,0,23,10,2
2,00:14:49,1,True,7,15,-8,43,15,2
2,00:07:45,2,True,9,15,-6,44,27,2
2,00:01:57,1,True,10,15,-5,34,10,2
2,00:01:37,1,True,10,15,-5,13,10,2
2,00:01:17,2,True,10,15,-5,13,10,2
2,00:00:55,2,True,10,18,-8,24,21,2
3,00:13:17,2,False,18,10,8,27,17,2
3,00:11:35,1,False,18,10,8,16,10,2
3,00:05:45,2,False,18,18,0,23,16,2
3,00:01:32,1,True,18,18,0,40,10,2
3,00:00:50,1,True,18,18,0,27,10,2
4,00:13:46,1,True,18,21,-3,48,10,2
4,00:11:07,2,True,18,21,-3,42,18,2
4,00:04:31,1,False,22,18,4,6,15,2
4,00:02:55,1,False,22,18,4,36,10,2
4,00:02:45,2,False,22,18,4,36,10,2
4,00:01:20,2,True,21,22,-1,45,9,2
4,00:00:36,1,True,21,23,-2,45,10,2
1,00:09:29,1,False,0,2,-2,17,10,2
1,00:08:57,2,False,0,2,-2,17,10,2
1,00:05:59,2,False,0,2,-2,53,10,2
1,00:01:40,2,False,1,3,-2,42,7,2
2,00:12:38,2,False,7,10,-3,55,5,2
2,00:06:45,1,False,7,10,-3,24,10,2
2,00:03:13,2,True,10,7,3,32,12,2
2,00:00:26,1,True,10,10,0,28,10,2
3,00:14:40,1,False,10,10,0,36,10,2
3,00:11:40,1,True,10,10,0,49,10,2
3,00:06:27,0,True,16,10,6,1,0,2
3,00:04:29,1,True,16,10,6,41,10,2
4,00:13:00,2,False,11,24,-13,14,6,2
4,00:11:44,2,False,11,24,-13,38,11,2
4,00:10:45,1,True,25,11,14,49,10,2
4,00:09:58,2,True,25,11,14,44,5,2
4,00:03:07,1,True,26,11,15,33,10,2
4,00:02:50,2,True,26,11,15,43,20,2
4,00:01:40,2,False,11,26,-15,48,2,2
4,00:01:36,3,False,11,26,-15,48,2,2
1,00:09:51,2,False,0,0,0,48,7,2
1,00:05:42,1,True,0,0,0,18,10,2
1,00:01:40,1,True,0,0,0,6,6,2
1,00:00:01,1,False,7,0,7,53,10,2
2,00:02:01,1,True,7,15,-8,45,10,2
2,00:01:05,2,True,14,15,-1,51,3,2
2,00:00:43,2,True,14,15,-1,39,2,2
3,00:07:49,1,False,15,22,-7,33,10,2
3,00:07:17,2,False,15,22,-7,33,10,2
3,00:03:59,1,True,23,15,8,14,10,2
4,00:11:18,1,False,23,23,0,25,15,2
4,00:03:40,1,True,26,30,-4,48,10,2
1,00:07:54,1,False,3,1,2,26,10,2
1,00:03:51,1,True,7,3,4,22,20,2
1,00:02:26,2,True,7,3,4,3,3,2
2,00:14:30,1,True,7,17,-10,27,20,2
2,00:14:11,2,True,7,17,-10,27,20,2
2,00:11:53,1,True,7,17,-10,16,10,2
2,00:06:13,1,False,31,7,24,52,10,2
2,00:05:16,1,True,7,31,-24,48,10,2
2,00:00:52,1,False,38,7,31,44,5,2
3,00:14:55,1,True,13,38,-25,34,10,2
3,00:14:19,2,True,13,38,-25,29,15,2
3,00:10:53,2,True,13,38,-25,25,12,2
3,00:10:12,1,True,13,41,-28,35,10,2
3,00:09:44,2,True,13,41,-28,35,10,2
3,00:08:52,2,False,41,13,28,10,15,2
3,00:05:16,2,False,41,15,26,24,20,2
3,00:03:44,1,False,41,18,23,55,10,2
4,00:04:13,1,False,52,26,26,52,10,2
4,00:04:02,2,False,52,26,26,52,10,2
1,00:14:40,1,False,0,0,0,10,10,2
1,00:10:00,2,True,0,0,0,54,10,2
1,00:01:54,1,True,7,0,7,47,10,2
2,00:13:50,1,False,0,7,-7,27,10,2
2,00:10:26,2,False,0,7,-7,16,9,2
2,00:08:45,2,False,0,10,-10,40,5,2
2,00:07:26,2,True,10,0,10,42,6,2
2,00:06:10,2,False,0,10,-10,33,7,2
2,00:02:51,1,False,0,10,-10,23,10,2
2,00:01:53,1,False,0,16,-16,31,10,2
2,00:01:18,1,True,16,0,16,29,10,2
2,00:01:10,2,True,16,0,16,29,10,2
3,00:01:41,1,True,22,3,19,48,10,2
4,00:09:49,1,True,25,11,14,28,10,2
4,00:05:32,3,False,11,25,-14,28,3,2
4,00:02:53,1,False,11,28,-17,35,10,2
1,00:08:02,1,True,0,0,0,4,4,2
1,00:07:31,2,True,0,0,0,4,4,2
1,00:02:38,1,False,3,0,3,13,15,2
1,00:02:33,2,False,3,0,3,13,15,2
1,00:01:49,1,False,3,0,3,42,10,2
1,00:01:42,2,False,3,0,3,42,10,2
2,00:14:24,2,False,3,0,3,50,5,2
2,00:07:50,2,True,0,3,-3,5,5,2
2,00:02:17,1,True,7,6,1,51,10,2
2,00:00:14,1,True,7,7,0,51,10,2
3,00:04:19,1,True,13,9,4,26,10,2
3,00:00:26,1,False,16,13,3,44,10,2
4,00:13:22,1,True,20,16,4,50,10,2
4,00:13:12,2,True,20,16,4,50,10,2
4,00:07:46,1,False,16,27,-11,16,10,2
4,00:07:05,1,False,16,27,-11,41,10,2
4,00:04:29,2,True,27,16,11,47,5,2
4,00:03:46,1,False,16,27,-11,42,10,2
1,00:10:53,2,True,0,0,0,43,17,2
1,00:04:08,1,False,3,3,0,40,10,2
2,00:08:41,1,False,10,3,7,29,10,2
2,00:06:43,2,False,10,3,7,23,18,2
2,00:06:23,1,False,10,6,4,35,10,2
2,00:04:58,2,False,10,6,4,42,4,2
3,00:06:31,1,True,20,10,10,30,10,2
3,00:03:48,2,True,20,11,9,48,9,2
4,00:12:55,1,True,21,11,10,34,10,2
4,00:04:27,1,True,21,18,3,36,10,2
4,00:00:34,1,True,28,21,7,35,10,2
5,00:00:00,1,True,34,28,6,35,10,2
5,00:00:00,0,True,40,42,-2,3,0,2
1,00:14:54,1,False,0,0,0,27,10,2
1,00:12:33,1,False,0,0,0,55,10,2
1,00:11:34,1,True,0,0,0,39,10,2
1,00:09:16,2,True,0,0,0,28,7,2
1,00:04:33,1,False,0,7,-7,9,9,2
1,00:03:10,2,False,0,14,-14,35,10,2
1,00:00:01,2,False,0,14,-14,1,1,2
2,00:13:41,2,False,0,20,-20,15,15,2
2,00:11:38,1,False,0,20,-20,15,10,2
2,00:09:02,1,False,0,26,-26,41,10,2
2,00:08:45,2,False,0,26,-26,41,10,2
2,00:07:25,2,False,0,26,-26,37,18,2
2,00:06:41,1,False,0,29,-29,35,10,2
2,00:04:05,1,True,29,0,29,33,10,2
2,00:02:07,1,False,8,29,-21,9,9,2
2,00:00:57,1,True,36,8,28,50,10,2
2,00:00:54,2,True,36,8,28,50,10,2
2,00:00:15,2,True,36,8,28,35,7,2
3,00:14:20,2,True,36,11,25,32,6,2
3,00:13:39,1,False,11,36,-25,43,10,2
3,00:13:10,1,True,36,11,25,52,10,2
3,00:11:35,1,True,36,11,25,28,10,2
3,00:09:39,1,True,36,11,25,13,10,2
3,00:03:50,1,False,14,43,-29,42,10,2
3,00:03:28,2,False,14,43,-29,42,10,2
4,00:15:00,3,True,43,14,29,8,6,2
4,00:08:27,1,False,17,43,-26,27,10,2
4,00:06:26,2,False,17,46,-29,50,5,2
4,00:05:04,2,True,46,17,29,17,15,2
4,00:04:20,1,True,46,17,29,18,10,2
4,00:03:02,2,True,46,17,29,29,6,2
4,00:01:44,2,False,17,46,-29,55,10,2
1,00:03:09,2,False,0,3,-3,14,8,2
2,00:12:26,1,False,3,6,-3,50,20,2
2,00:06:55,1,True,12,3,9,2,2,2
2,00:03:48,2,True,12,10,2,23,12,2
2,00:01:17,2,True,12,10,2,54,3,2
3,00:12:33,2,True,19,10,9,15,3,2
3,00:10:19,1,False,13,19,-6,34,10,2
3,00:07:40,2,False,13,19,-6,33,3,2
3,00:02:24,1,False,13,19,-6,17,10,2
3,00:02:10,2,False,13,19,-6,17,10,2
4,00:10:07,1,False,20,25,-5,35,10,2
4,00:09:01,1,True,25,20,5,29,10,2
4,00:06:28,2,True,25,20,5,45,5,2
4,00:03:49,1,True,25,20,5,38,10,2
4,00:01:45,2,False,23,25,-2,26,8,2
4,00:01:26,3,False,23,25,-2,26,8,2
1,00:09:13,2,True,0,0,0,36,11,2
1,00:05:26,1,True,0,7,-7,34,10,2
2,00:11:10,1,False,7,3,4,11,10,2
2,00:02:47,1,False,7,6,1,44,20,2
2,00:01:06,1,True,6,7,-1,48,10,2
2,00:00:43,1,False,7,6,1,52,10,2
3,00:13:19,1,False,7,6,1,53,10,2
3,00:10:45,2,False,7,6,1,4,4,2
3,00:09:44,2,False,7,9,-2,40,5,2
3,00:06:01,1,True,9,7,2,10,10,2
3,00:02:42,2,False,15,9,6,35,6,2
4,00:12:53,1,True,12,22,-10,34,10,2
4,00:11:06,2,False,22,12,10,43,7,2
4,00:00:43,1,False,29,26,3,48,10,2
5,00:00:00,1,True,29,29,0,40,15,2
1,00:05:22,1,True,0,0,0,40,10,2
1,00:02:30,1,True,0,0,0,42,10,2
1,00:01:07,1,True,0,0,0,8,8,2
2,00:15:00,2,True,0,7,-7,22,6,2
2,00:13:30,2,False,7,0,7,45,12,2
2,00:09:24,1,False,7,0,7,31,10,2
2,00:05:30,2,False,7,14,-7,15,3,2
3,00:08:56,2,True,22,14,8,34,5,2
3,00:07:08,1,True,22,14,8,49,10,2
3,00:03:18,2,False,17,22,-5,46,11,2
3,00:01:28,1,True,22,17,5,26,10,2
4,00:11:15,1,False,20,22,-2,37,10,2
4,00:11:04,2,False,20,22,-2,37,10,2
4,00:10:00,1,True,22,20,2,31,10,2
4,00:08:34,2,True,22,20,2,46,5,2
4,00:07:07,2,False,20,22,-2,43,7,2
4,00:03:00,1,False,20,22,-2,34,10,2
4,00:01:22,2,False,20,25,-5,42,3,2
4,00:01:02,1,False,20,25,-5,46,10,2
4,00:00:55,2,False,20,25,-5,46,10,2
4,00:00:50,3,False,20,25,-5,46,10,2
1,00:13:57,2,False,0,0,0,45,13,2
1,00:11:12,1,True,1,0,1,10,10,2
1,00:09:35,2,True,1,0,1,43,12,2
1,00:07:13,1,False,0,1,-1,34,10,2
1,00:07:13,2,False,0,1,-1,34,10,2
2,00:15:00,1,False,0,4,-4,50,10,2
2,00:02:01,1,False,7,4,3,35,10,2
2,00:01:44,2,False,7,4,3,35,10,2
3,00:12:55,1,False,10,7,3,45,10,2
3,00:12:33,2,False,10,7,3,45,10,2
3,00:07:06,1,False,10,14,-4,31,10,2
3,00:05:59,1,True,14,10,4,45,10,2
3,00:05:27,2,True,14,10,4,45,10,2
3,00:04:49,1,True,14,10,4,23,10,2
3,00:03:00,1,False,10,14,-4,52,10,2
3,00:02:38,2,False,10,14,-4,52,10,2
3,00:00:53,1,False,10,14,-4,34,20,2
3,00:00:21,1,True,14,10,4,53,10,2
4,00:13:50,1,True,14,10,4,29,10,2
4,00:13:32,2,True,14,10,4,29,10,2
4,00:06:15,1,False,13,14,-1,20,10,2
4,00:05:54,2,False,13,14,-1,20,10,2
4,00:02:38,1,False,13,17,-4,45,10,2
4,00:00:29,1,True,17,13,4,43,10,2
1,00:14:35,1,False,0,0,0,49,10,2
1,00:12:55,2,True,0,0,0,10,9,2
1,00:09:22,1,True,0,2,-2,27,10,2
1,00:08:45,1,True,0,2,-2,15,10,2
1,00:06:30,1,True,0,2,-2,51,10,2
1,00:05:09,1,True,0,2,-2,16,10,2
1,00:04:45,2,True,0,2,-2,16,10,2
1,00:03:45,2,True,0,5,-5,38,7,2
1,00:03:08,1,False,5,0,5,26,10,2
1,00:02:54,2,False,5,0,5,26,10,2
1,00:02:05,1,True,0,5,-5,22,10,2
1,00:01:43,2,True,0,5,-5,22,10,2
2,00:13:27,1,True,0,5,-5,19,10,2
2,00:10:29,1,True,0,5,-5,38,10,2
3,00:10:15,1,False,8,6,2,45,20,2
3,00:09:57,2,False,8,6,2,45,20,2
3,00:07:25,2,True,6,11,-5,35,10,2
4,00:11:45,0,True,12,11,1,3,0,2
4,00:09:44,0,False,17,12,5,3,0,2
4,00:07:43,2,True,12,17,-5,51,9,2
4,00:06:34,1,False,17,12,5,41,10,2
4,00:04:59,2,True,12,17,-5,32,4,2
1,00:13:20,1,False,0,0,0,28,10,2
1,00:07:10,2,False,7,0,7,49,6,2
1,00:03:26,2,False,7,0,7,29,12,2
2,00:11:11,1,False,8,0,8,38,10,2
2,00:08:33,2,False,8,0,8,42,7,2
2,00:07:38,1,False,8,3,5,35,10,2
2,00:06:28,1,True,3,9,-6,35,10,2
2,00:05:53,1,True,3,9,-6,50,10,2
2,00:04:19,1,False,9,3,6,29,10,2
2,00:04:01,2,False,9,3,6,29,10,2
2,00:02:50,2,False,9,4,5,37,8,2
2,00:01:08,2,False,9,4,5,55,2,2
3,00:12:32,1,True,4,17,-13,50,10,2
3,00:09:17,1,False,17,11,6,30,10,2
3,00:05:20,2,True,11,17,-6,7,13,2
3,00:04:38,1,True,11,20,-9,35,10,2
3,00:03:07,2,False,20,11,9,43,5,2
3,00:00:01,1,True,11,20,-9,2,2,2
4,00:12:43,1,False,27,11,16,45,10,2
4,00:10:40,1,False,27,11,16,35,10,2
4,00:06:15,1,True,14,27,-13,33,10,2
4,00:04:12,1,False,27,14,13,29,10,2
4,00:01:10,1,False,27,17,10,16,10,2
4,00:00:53,1,False,27,17,10,1,1,2
1,00:14:20,2,True,0,1,-1,40,5,2
1,00:09:39,2,True,0,8,-8,22,7,2
1,00:05:03,1,True,0,16,-16,35,10,2
2,00:12:43,2,False,16,8,8,19,5,2
2,00:11:35,2,False,16,9,7,35,10,2
2,00:09:34,2,False,16,16,0,46,10,2
2,00:07:31,1,True,16,16,0,18,10,2
2,00:05:03,2,True,16,16,0,38,9,2
2,00:04:06,1,True,16,16,0,44,10,2
3,00:13:38,2,False,16,16,0,47,8,2
3,00:11:05,1,True,16,16,0,38,10,2
3,00:10:41,2,True,16,16,0,38,10,2
4,00:14:13,2,True,23,22,1,30,6,2
1,00:14:55,1,True,0,0,0,27,10,2
1,00:13:50,2,True,0,0,0,46,6,2
1,00:12:48,1,False,0,0,0,43,10,2
1,00:12:30,2,False,0,0,0,43,10,2
1,00:11:42,1,True,0,0,0,28,10,2
1,00:11:17,2,True,0,0,0,28,10,2
1,00:04:42,1,True,0,11,-11,35,10,2
1,00:03:35,1,False,11,0,11,54,10,2
1,00:02:25,1,False,11,0,11,37,10,2
2,00:15:00,1,False,11,8,3,36,10,2
2,00:10:45,2,True,8,19,-11,43,3,2
2,00:05:45,1,False,19,11,8,35,10,2
2,00:05:27,2,False,19,11,8,35,10,2
2,00:02:48,1,False,19,11,8,6,6,2
2,00:02:13,1,False,19,17,2,29,10,2
2,00:01:13,1,True,17,19,-2,51,10,2
2,00:01:09,2,True,17,19,-2,51,10,2
2,00:00:29,1,False,19,17,2,43,5,2
2,00:00:24,2,False,19,17,2,43,5,2
3,00:14:28,1,False,19,17,2,23,20,2
3,00:12:45,2,True,17,19,-2,52,8,2
3,00:11:49,1,True,17,19,-2,4,10,2
3,00:11:33,2,True,17,19,-2,4,10,2
3,00:09:50,2,True,17,19,-2,16,6,2
3,00:08:30,1,True,17,22,-5,35,10,2
3,00:06:37,2,False,22,17,5,37,7,2
3,00:03:50,1,True,20,22,-2,51,10,2
3,00:03:23,2,True,20,22,-2,51,10,2
4,00:10:09,1,False,23,20,3,54,10,2
4,00:10:02,2,False,23,20,3,54,10,2
4,00:07:46,1,False,23,26,-3,24,10,2
4,00:00:19,1,False,26,26,0,47,15,2
4,00:00:14,2,False,26,26,0,47,15,2
1,00:14:54,1,True,0,0,0,24,10,2
1,00:05:31,1,True,7,0,7,54,10,2
2,00:07:45,2,True,21,7,14,49,11,2
2,00:05:28,1,True,21,7,14,29,10,2
2,00:04:07,1,False,7,21,-14,25,10,2
2,00:03:43,2,False,7,21,-14,25,10,2
2,00:02:24,2,True,21,7,14,55,5,2
3,00:11:55,2,True,21,7,14,26,11,2
3,00:10:35,2,True,21,10,11,36,9,2
3,00:09:57,1,False,10,21,-11,30,10,2
3,00:08:00,1,True,21,10,11,55,10,2
3,00:06:45,3,False,10,21,-11,49,4,2
3,00:03:03,2,True,21,18,3,19,6,2
4,00:14:00,1,True,21,18,3,39,20,2
4,00:11:52,2,True,21,21,0,35,10,2
4,00:08:45,1,False,21,21,0,48,10,2
4,00:06:20,1,False,21,24,-3,35,10,2
4,00:03:08,1,False,27,24,3,35,10,2
4,00:02:47,2,False,27,24,3,35,10,2
4,00:00:36,2,True,27,30,-3,42,3,2
4,00:00:32,3,True,27,30,-3,42,3,2
1,00:12:40,2,True,0,0,0,35,12,2
1,00:08:33,1,False,0,0,0,6,10,2
1,00:06:11,1,False,0,0,0,41,10,2
1,00:06:03,2,False,0,0,0,41,10,2
1,00:00:49,1,False,3,1,2,54,10,2
1,00:00:22,2,False,3,1,2,54,10,2
2,00:14:35,2,True,1,3,-2,54,6,2
2,00:12:46,1,False,3,1,2,47,10,2
2,00:10:30,2,False,3,1,2,28,11,2
2,00:07:06,1,True,4,3,1,23,10,2
2,00:06:04,1,False,3,4,-1,29,10,2
2,00:03:00,2,False,3,4,-1,43,7,2
2,00:01:51,2,False,3,4,-1,54,14,2
3,00:13:34,1,False,3,4,-1,52,10,2
3,00:13:24,2,False,3,4,-1,52,10,2
3,00:10:34,1,False,3,4,-1,17,10,2
3,00:10:06,2,False,3,4,-1,17,10,2
3,00:07:59,2,False,3,4,-1,9,15,2
3,00:00:01,1,False,3,18,-15,47,10,2
4,00:13:40,2,True,18,3,15,26,7,2
4,00:12:20,1,False,3,18,-15,44,10,2
4,00:10:49,2,False,3,18,-15,42,6,2
4,00:07:35,1,True,25,3,22,44,10,2
4,00:07:07,2,True,25,3,22,44,10,2
4,00:04:32,1,False,3,32,-29,27,10,2
4,00:03:50,2,False,3,32,-29,22,15,2
4,00:03:00,2,False,3,32,-29,40,6,2
4,00:01:28,1,False,3,32,-29,55,10,2
1,00:13:25,2,True,0,0,0,50,3,2
1,00:08:42,1,False,0,0,0,22,10,2
1,00:08:28,2,False,0,0,0,22,10,2
1,00:04:31,1,True,3,7,-4,32,10,2
2,00:15:00,2,True,3,7,-4,36,11,2
2,00:10:54,1,False,10,3,7,23,10,2
2,00:10:07,2,False,10,3,7,33,20,2
2,00:06:23,1,True,6,10,-4,32,10,2
2,00:03:25,1,True,6,11,-5,49,10,2
2,00:03:06,2,True,6,11,-5,49,10,2
2,00:01:38,2,True,6,11,-5,14,2,2
2,00:01:20,1,True,6,14,-8,35,10,2
2,00:01:03,1,False,14,6,8,49,10,2
2,00:00:01,2,False,14,14,0,45,13,2
3,00:14:03,1,False,14,14,0,51,10,2
3,00:08:33,2,True,21,14,7,42,6,2
4,00:14:42,2,True,21,17,4,18,18,2
4,00:08:08,1,True,21,20,1,18,15,2
4,00:06:30,1,True,21,28,-7,21,10,2
4,00:01:04,3,True,21,31,-10,44,1,2
1,00:08:12,2,True,7,0,7,41,5,2
1,00:05:54,2,True,7,3,4,45,2,2
1,00:04:21,2,False,3,7,-4,15,7,2
1,00:01:55,2,False,3,7,-4,30,18,2
2,00:14:38,2,True,7,3,4,34,9,2
2,00:09:34,2,False,6,7,-1,37,8,2
2,00:05:25,2,True,7,6,1,52,6,2
2,00:04:40,1,False,6,7,-1,8,10,2
2,00:01:43,2,True,7,13,-6,38,15,2
2,00:00:54,2,False,13,7,6,36,18,2
3,00:07:17,2,False,15,10,5,19,8,2
3,00:05:02,2,True,10,15,-5,40,19,2
3,00:03:58,1,True,10,15,-5,46,10,2
3,00:00:01,1,True,10,15,-5,34,10,2
4,00:15:00,2,True,10,15,-5,34,10,2
4,00:10:35,1,True,10,18,-8,25,10,2
4,00:08:55,2,False,18,10,8,42,7,2
4,00:03:00,2,False,18,13,5,33,5,2
4,00:02:14,2,False,18,13,5,50,3,2
1,00:08:54,2,False,0,0,0,54,10,9
2,00:02:01,1,True,3,7,-4,15,10,9
2,00:11:53,2,True,7,13,-6,30,10,9
2,00:00:40,2,True,10,16,-6,32,10,9
4,00:00:09,1,False,33,26,7,49,10,9
4,00:03:35,2,True,29,19,10,47,0,9
1,00:01:00,1,True,7,3,4,21,10,9
2,00:11:25,2,True,7,10,-3,25,9,9
4,00:00:24,1,True,24,24,0,48,10,9
4,00:02:32,1,False,25,41,-16,30,15,9
2,00:05:14,2,True,10,7,3,45,10,9
1,00:04:28,1,False,0,10,-10,36,10,9
3,00:12:29,2,True,8,17,-9,50,7,9
3,00:10:42,1,True,8,17,-9,44,10,9
2,00:09:33,1,False,7,1,6,35,10,9
4,00:07:41,1,False,22,34,-12,44,10,9
2,00:11:18,1,True,13,2,11,26,10,9
2,00:10:41,2,True,13,2,11,36,10,9
3,00:03:56,1,False,15,23,-8,54,10,9
4,00:09:25,1,True,30,29,1,35,10,9
1,00:10:43,2,False,0,0,0,33,6,9
2,00:00:00,3,True,28,0,28,3,3,9
3,00:05:06,2,False,0,41,-41,35,10,9
4,00:08:44,1,True,44,0,44,38,10,9
1,00:13:50,2,True,0,0,0,37,8,9
1,00:11:22,1,False,7,0,7,50,10,9
3,00:11:53,2,True,13,15,-2,48,12,9
4,00:07:34,2,True,19,22,-3,20,14,9
4,00:00:01,1,True,26,22,4,34,10,9
1,00:03:33,2,True,8,0,8,19,7,9
2,00:04:44,2,True,8,14,-6,6,6,9
2,00:00:51,2,False,14,8,6,50,2,9
1,00:03:44,2,False,0,10,-10,25,20,9
1,00:13:48,1,True,0,0,0,33,10,9
1,00:03:13,2,False,14,3,11,21,10,9
2,00:12:34,1,True,11,14,-3,12,10,9
4,00:00:18,2,True,33,38,-5,35,10,9
1,00:11:59,2,True,0,1,-1,40,5,9
2,00:00:57,2,False,12,20,-8,49,10,9
4,00:10:25,2,True,23,23,0,34,10,9
3,00:07:31,2,True,15,0,15,35,11,9
4,00:13:16,1,False,7,22,-15,52,10,9
4,00:10:16,1,False,7,22,-15,29,10,9
2,00:11:58,2,True,16,0,16,53,2,9
3,00:09:52,1,True,31,13,18,36,10,9
2,00:00:00,2,True,1,15,-14,12,6,9
3,00:02:31,1,True,6,36,-30,48,10,9
1,00:11:03,1,False,0,0,0,19,10,9
4,00:09:02,1,True,4,9,-5,55,10,9
4,00:00:05,1,False,19,11,8,50,10,9
3,00:03:20,1,True,17,3,14,14,10,9
4,00:00:01,2,True,36,21,15,34,10,9
3,00:09:45,2,True,13,16,-3,5,10,9
4,00:00:51,3,True,20,30,-10,38,20,9
2,00:08:40,2,False,7,10,-3,54,10,9
1,00:12:19,2,True,0,0,0,16,11,9
3,00:08:05,1,False,22,25,-3,6,6,9
2,00:00:18,2,True,7,13,-6,32,11,9
2,00:07:13,1,True,7,15,-8,18,10,9
2,00:04:00,1,False,18,7,11,36,10,9
3,00:13:34,1,True,14,33,-19,21,10,9
1,00:05:30,3,False,0,7,-7,42,5,9
1,00:00:49,2,False,0,1,-1,37,5,9
2,00:13:17,2,True,1,7,-6,34,11,9
2,00:02:29,2,True,1,14,-13,44,10,9
4,00:10:12,1,True,11,34,-23,44,10,9
4,00:03:40,2,False,35,11,24,15,10,9
4,00:03:00,2,False,35,11,24,9,4,9
2,00:08:19,1,True,6,7,-1,38,10,9
2,00:11:31,1,True,1,3,-2,23,10,9
3,00:00:24,2,False,4,11,-7,51,13,9
4,00:00:20,3,True,17,12,5,33,15,9
1,00:07:54,2,True,0,7,-7,28,3,9
1,00:10:15,2,False,0,0,0,24,5,9
4,00:04:30,2,False,14,24,-10,9,9,9
2,00:11:33,2,False,0,3,-3,41,17,9
2,00:11:32,2,False,3,10,-7,23,10,9
4,00:09:53,1,False,34,17,17,45,10,9
1,00:01:19,1,False,3,0,3,40,10,9
2,00:05:18,1,True,15,1,14,35,10,9
4,00:00:40,1,False,27,22,5,51,10,9
1,00:12:20,2,False,0,0,0,38,15,9
2,00:02:42,2,True,3,15,-12,19,5,9
2,00:05:38,1,False,9,10,-1,37,15,9
2,00:08:19,1,False,7,3,4,12,10,9
2,00:02:59,2,True,3,15,-12,36,10,9
4,00:00:25,2,True,17,31,-14,35,10,9
2,00:07:36,2,True,0,21,-21,10,5,9
1,00:05:00,2,False,7,0,7,27,7,9
2,00:02:09,2,True,3,24,-21,40,19,9
3,00:03:34,1,True,3,32,-29,55,10,9
3,00:00:01,1,True,3,32,-29,3,10,9
4,00:04:19,1,True,17,40,-23,51,10,9
4,00:00:59,1,True,24,47,-23,53,10,9
3,00:12:00,2,True,7,17,-10,42,10,9
4,00:07:45,2,True,11,27,-16,35,10,9
3,00:12:06,2,True,25,4,21,52,10,9
3,00:10:23,1,False,10,9,1,35,10,9
4,00:02:27,1,False,14,14,0,48,10,9
4,00:12:44,1,False,18,26,-8,38,10,9
4,00:01:07,2,True,33,26,7,53,10,9
1,00:06:17,2,True,7,0,7,40,9,9
2,00:00:07,2,True,21,16,5,53,4,9
4,00:02:47,1,False,22,24,-2,37,10,9
2,00:07:33,2,True,14,3,11,52,4,9
2,00:01:00,1,True,14,3,11,6,6,9
3,00:05:08,2,True,14,4,10,40,10,9
3,00:04:36,1,False,4,14,-10,50,10,9
1,00:12:07,1,True,0,0,0,18,10,9
2,00:13:40,2,False,10,0,10,36,7,9
2,00:05:44,1,False,10,7,3,54,10,9
4,00:00:23,1,True,27,34,-7,35,10,9
1,00:11:59,2,True,0,0,0,52,10,9
3,00:13:35,1,False,21,14,7,37,10,9
4,00:08:46,2,True,27,31,-4,26,19,9
4,00:02:54,1,True,36,38,-2,47,10,9
4,00:02:02,2,True,36,38,-2,49,10,9
2,00:00:42,1,False,21,14,7,50,10,9
4,00:05:51,3,True,14,29,-15,47,3,9
4,00:01:19,3,True,24,18,6,37,10,9
2,00:12:01,1,False,0,17,-17,46,10,9
3,00:05:00,1,False,7,24,-17,52,10,9
4,00:08:29,1,False,14,27,-13,40,15,9
2,00:00:20,1,False,12,10,2,54,10,9
4,00:06:10,2,False,29,27,2,4,4,9
1,00:10:31,1,True,3,0,3,24,10,9
2,00:13:08,2,False,7,13,-6,40,9,9
2,00:03:34,1,False,7,27,-20,15,10,9
3,00:11:36,2,True,31,7,24,49,8,9
4,00:08:11,2,True,32,14,18,52,10,9
4,00:00:49,1,False,21,36,-15,19,10,9
2,00:04:24,2,False,12,1,11,55,4,9
4,00:13:59,2,False,15,29,-14,39,14,9
1,00:04:28,2,True,0,7,-7,55,10,9
2,00:12:30,1,True,0,14,-14,25,10,9
4,00:12:42,2,False,23,10,13,52,20,9
1,00:08:31,2,False,3,0,3,28,20,9
4,00:01:14,3,False,25,29,-4,25,14,9
1,00:11:34,2,True,0,0,0,50,10,9
1,00:09:03,1,True,0,3,-3,33,10,9
4,00:07:15,3,False,30,7,23,19,5,9
4,00:00:29,2,True,7,37,-30,12,10,9
1,00:06:35,1,True,0,3,-3,49,10,9
3,00:02:46,2,False,16,13,3,45,10,9
1,00:01:17,1,True,0,2,-2,26,20,9
3,00:01:09,2,False,9,6,3,35,10,9
1,00:13:35,2,False,0,0,0,45,9,9
2,00:01:01,1,True,6,22,-16,46,10,9
2,00:06:05,2,False,10,21,-11,43,10,9
3,00:06:26,2,False,6,31,-25,51,8,9
2,00:00:50,1,False,4,7,-3,42,15,9
4,00:09:50,2,True,11,4,7,25,5,9
4,00:05:56,1,False,4,11,-7,52,10,9
1,00:10:09,1,True,0,0,0,26,10,9
2,00:04:33,1,True,7,10,-3,28,10,9
3,00:14:00,2,True,7,17,-10,43,10,9
4,00:00:09,2,False,23,28,-5,17,4,9
3,00:14:21,2,False,14,10,4,37,8,9
4,00:08:41,2,True,17,21,-4,52,10,9
4,00:03:51,2,True,17,21,-4,35,8,9
4,00:07:06,2,True,17,20,-3,34,10,9
4,00:05:41,2,True,17,20,-3,5,5,9
2,00:04:01,2,False,6,21,-15,48,10,9
4,00:06:02,2,True,35,16,19,17,11,9
3,00:06:33,2,True,14,16,-2,51,11,9
1,00:11:03,1,False,0,0,0,28,20,9
2,00:02:29,2,True,21,10,11,52,10,9
3,00:09:20,2,False,13,24,-11,43,5,9
3,00:09:00,1,False,13,24,-11,44,10,9
3,00:02:56,2,False,13,24,-11,6,9,9
3,00:05:23,2,True,31,14,17,37,10,9
2,00:13:42,2,False,0,11,-11,54,12,9
1,00:09:04,2,True,7,0,7,35,6,9
3,00:09:01,2,False,13,17,-4,47,3,9
3,00:06:46,2,False,13,17,-4,12,10,9
3,00:04:22,2,True,17,13,4,47,9,9
4,00:01:14,3,False,27,20,7,33,3,9
4,00:15:00,1,False,3,31,-28,48,10,9
4,00:13:20,2,True,31,3,28,18,10,9
3,00:03:15,2,True,20,22,-2,37,10,9
4,00:13:55,2,True,20,3,17,11,7,9
1,00:10:26,1,False,0,0,0,3,10,9
2,00:00:40,1,True,10,10,0,55,10,9
3,00:00:43,1,False,17,13,4,41,10,9
4,00:01:30,1,False,24,25,-1,35,10,9
1,00:06:31,1,True,7,0,7,30,10,9
4,00:02:22,1,True,41,15,26,4,4,9
4,00:08:37,2,True,30,22,8,27,5,9
4,00:00:17,2,True,27,11,16,29,6,9
4,00:03:14,2,False,26,13,13,34,10,9
1,00:06:26,2,True,0,7,-7,46,6,9
3,00:06:25,1,False,7,9,-2,54,10,9
4,00:00:05,3,False,17,18,-1,50,10,9
2,00:04:31,1,True,7,4,3,30,10,9
4,00:13:10,2,False,3,34,-31,30,11,9
2,00:05:32,2,True,10,10,0,33,7,9
3,00:11:48,1,False,9,6,3,26,10,9
4,00:01:53,2,False,23,6,17,48,10,9
2,00:01:25,2,False,17,17,0,52,5,9
3,00:02:20,2,False,20,23,-3,22,4,9
1,00:14:23,2,False,0,0,0,47,5,9
1,00:08:05,2,True,14,0,14,45,7,9
4,00:01:33,1,True,5,24,-19,35,10,9
1,00:06:19,1,True,0,0,0,27,10,9
2,00:06:00,2,True,7,10,-3,50,4,9
1,00:07:37,2,True,0,10,-10,39,6,9
1,00:11:41,2,True,0,0,0,55,17,9
4,00:02:16,2,True,17,16,1,25,4,9
4,00:02:05,2,False,22,17,5,51,10,9
1,00:02:40,2,False,10,2,8,35,10,9
2,00:02:22,2,True,17,16,1,42,3,9
3,00:13:04,1,True,17,19,-2,52,10,9
2,00:07:22,2,False,0,14,-14,50,20,9
2,00:02:00,2,True,21,0,21,35,15,9
3,00:10:49,2,False,7,28,-21,32,5,9
1,00:04:42,2,False,0,1,-1,22,11,9
3,00:03:06,2,False,20,10,10,35,10,9
4,00:01:49,2,True,20,23,-3,23,10,9
3,00:09:49,1,True,5,4,1,48,10,9
4,00:01:56,1,True,17,26,-9,18,10,9
4,00:01:21,2,True,17,33,-16,17,17,9
2,00:14:33,2,False,0,1,-1,42,8,9
2,00:01:47,1,False,3,1,2,12,10,9
1,00:11:16,2,False,0,0,0,52,12,9
2,00:12:20,2,False,7,7,0,37,6,9
3,00:13:34,2,True,31,10,21,36,11,9
4,00:00:11,1,False,27,34,-7,5,10,9
1,00:13:26,1,False,0,0,0,48,10,9
3,00:05:40,2,True,7,8,-1,38,15,9
2,00:08:00,1,False,3,8,-5,30,10,9
4,00:01:47,2,False,12,13,-1,17,18,9
2,00:12:50,1,True,3,0,3,51,10,9
1,00:06:45,1,True,7,3,4,34,10,9
3,00:06:22,2,False,24,10,14,35,9,9
4,00:00:34,3,True,24,30,-6,36,9,9
4,00:00:18,1,True,40,33,7,32,15,9
1,00:04:38,2,True,6,0,6,36,7,9
3,00:02:27,1,False,3,20,-17,24,5,9
1,00:13:09,1,False,0,0,0,23,10,9
1,00:03:43,1,False,0,0,0,48,10,9
3,00:07:21,1,False,15,6,9,52,10,9
4,00:14:51,2,False,15,10,5,48,10,9
4,00:10:33,2,False,15,25,-10,31,11,9
5,00:00:00,1,True,32,32,0,35,10,9
1,00:06:59,1,False,0,0,0,38,10,9
2,00:13:43,2,False,0,0,0,8,8,9
4,00:04:30,1,True,17,0,17,35,10,9
1,00:04:57,2,False,7,0,7,47,10,9
4,00:01:26,1,True,14,7,7,46,10,9
1,00:14:03,2,False,0,0,0,25,10,9
4,00:02:06,2,True,42,20,22,50,15,9
2,00:15:00,2,False,2,0,2,45,10,9
2,00:10:50,2,True,0,2,-2,48,7,9
2,00:07:33,2,True,0,2,-2,33,9,9
4,00:07:25,1,True,24,24,0,47,10,9
2,00:01:37,1,False,21,20,1,18,10,9
3,00:11:15,1,True,20,21,-1,25,10,9
1,00:00:13,1,True,0,3,-3,35,10,9
1,00:02:15,2,False,7,0,7,45,10,9
3,00:00:03,1,True,34,7,27,46,10,9
4,00:10:02,1,True,34,9,25,42,10,9
3,00:05:45,2,False,3,40,-37,46,11,9
4,00:02:42,2,False,9,41,-32,45,10,9
2,00:05:38,2,True,4,1,3,43,6,9
4,00:00:17,1,True,12,20,-8,46,10,9
2,00:04:19,2,False,16,6,10,27,12,9
2,00:00:38,1,True,6,16,-10,51,10,9
2,00:03:54,2,False,4,3,1,37,8,9
1,00:00:27,2,False,7,7,0,32,8,9
2,00:13:00,2,True,7,7,0,36,14,9
3,00:11:17,1,True,7,20,-13,32,10,9
2,00:00:54,1,True,8,13,-5,8,10,9
4,00:05:18,2,False,27,30,-3,29,7,9
4,00:04:15,2,False,27,37,-10,37,6,9
4,00:00:57,1,True,40,27,13,17,10,9
2,00:11:18,2,True,15,0,15,55,20,9
4,00:14:43,2,False,21,15,6,42,3,9
3,00:00:44,2,True,17,13,4,35,10,9
4,00:14:45,2,True,17,13,4,39,18,9
4,00:10:25,1,True,17,13,4,40,20,9
2,00:01:33,1,True,15,14,1,54,10,9
3,00:03:49,2,True,22,17,5,22,13,9
4,00:04:30,2,True,25,27,-2,6,12,9
4,00:01:47,3,False,34,25,9,19,7,9
1,00:04:29,1,True,10,0,10,35,10,9
1,00:09:29,1,False,0,7,-7,26,15,9
1,00:04:27,1,False,0,14,-14,20,10,9
2,00:06:50,1,False,10,6,4,43,10,9
4,00:15:00,1,False,27,16,11,22,10,9
2,00:14:40,1,False,0,4,-4,16,10,9
2,00:12:15,2,True,7,1,6,51,10,9
4,00:12:45,1,True,24,7,17,34,10,9
2,00:15:00,2,False,0,1,-1,32,10,9
2,00:14:05,2,False,0,1,-1,21,8,9
3,00:07:15,2,True,22,3,19,45,4,9
2,00:12:24,2,False,1,14,-13,39,6,9
4,00:11:33,2,True,20,10,10,35,10,9
1,00:05:34,1,False,0,3,-3,40,10,9
1,00:03:50,1,False,0,6,-6,35,10,9
2,00:13:58,2,False,0,7,-7,33,12,9
2,00:04:34,2,False,0,17,-17,38,18,9
2,00:04:04,1,False,0,17,-17,30,10,9
3,00:09:00,2,False,7,17,-10,52,19,9
2,00:12:59,2,False,7,3,4,12,11,9
4,00:01:46,1,False,24,40,-16,35,10,9
3,00:04:13,2,False,0,34,-34,9,9,9
2,00:14:35,2,True,6,3,3,35,10,9
2,00:01:34,2,False,6,6,0,53,10,9
3,00:14:26,2,False,6,6,0,31,5,9
2,00:01:40,1,True,3,4,-1,42,20,9
2,00:11:01,2,True,7,3,4,20,7,9
2,00:05:58,1,True,7,13,-6,23,10,9
4,00:11:00,2,False,30,10,20,13,7,9
2,00:00:30,2,False,10,19,-9,48,20,9
2,00:13:13,1,True,6,0,6,47,10,9
2,00:12:44,1,False,0,6,-6,47,10,9
2,00:09:19,1,False,5,6,-1,34,10,9
2,00:01:58,1,True,13,5,8,30,10,9
4,00:14:03,1,False,13,16,-3,42,10,9
1,00:09:56,2,False,0,0,0,42,7,9
3,00:11:23,2,False,18,10,8,16,10,9
3,00:06:51,2,True,10,18,-8,14,5,9
4,00:13:25,2,True,18,21,-3,48,10,9
4,00:02:45,3,True,26,11,15,43,20,9
3,00:02:08,1,False,23,23,0,43,10,9
2,00:09:32,2,True,7,24,-17,31,7,9
4,00:00:45,2,True,29,11,18,30,15,9
1,00:10:51,1,False,0,0,0,23,10,9
2,00:06:01,2,False,10,6,4,35,10,9
4,00:09:50,1,True,21,11,10,17,10,9
1,00:07:33,2,True,0,0,0,53,4,9
2,00:03:18,1,False,0,29,-29,41,10,9
4,00:04:02,2,True,46,17,29,18,10,9
1,00:10:11,1,True,0,0,0,24,10,9
2,00:10:07,2,False,3,6,-3,36,4,9
1,00:03:21,2,False,7,0,7,55,11,9
3,00:04:40,1,False,17,22,-5,50,10,9
1,00:03:07,1,False,0,1,-1,25,25,9
2,00:09:15,1,False,7,4,3,49,10,9
4,00:01:34,1,False,13,17,-4,32,10,9
2,00:11:12,1,True,0,5,-5,13,10,9
2,00:03:02,2,True,0,8,-8,53,4,9
3,00:05:06,2,True,6,11,-5,36,6,9
2,00:01:38,2,False,9,4,5,51,5,9
4,00:00:33,1,False,25,26,-1,37,10,9
1,00:11:18,1,True,0,0,0,43,10,9
1,00:05:10,2,True,7,0,7,54,10,9
2,00:00:25,1,True,21,7,14,53,10,9
3,00:05:20,1,False,3,11,-8,53,10,9
4,00:10:16,1,False,3,18,-15,3,10,9
3,00:00:01,2,True,21,17,4,22,6,9
4,00:12:30,1,True,10,18,-8,46,10,9
4,00:11:04,2,True,10,18,-8,14,7,9
3,00:09:37,0,True,31,20,11,35,0,68
1,00:07:20,0,True,7,14,-7,35,0,68
3,00:14:59,0,False,13,12,1,35,0,68
3,00:03:11,0,False,19,12,7,5,0,68
2,00:04:25,0,False,10,20,-10,35,0,68
3,00:13:00,0,False,7,9,-2,50,0,68
1,00:14:58,0,True,0,0,0,35,0,68
3,00:06:04,0,True,6,19,-13,50,0,68
2,00:07:49,0,True,0,31,-31,50,0,68
1,00:10:10,0,False,0,7,-7,35,0,68
1,00:05:38,0,True,3,14,-11,35,0,68
3,00:02:23,0,False,20,38,-18,45,0,68
4,00:13:41,0,False,6,14,-8,35,0,68
3,00:14:56,0,True,20,0,20,50,0,68
1,00:00:36,0,False,13,7,6,25,0,68
2,00:02:06,0,True,7,14,-7,35,0,68
1,00:14:58,0,False,0,0,0,35,0,68
3,00:14:13,0,True,4,16,-12,35,0,68
1,00:14:58,0,True,0,0,0,35,0,68
1,00:05:03,0,False,14,0,14,25,0,68
2,00:10:31,0,False,16,15,1,35,0,68
1,00:15:00,0,True,0,0,0,35,0,5
1,00:01:46,0,False,0,3,-3,35,0,5
2,00:01:37,0,True,3,14,-11,35,0,5
3,00:15:00,0,False,14,3,11,35,0,5
3,00:10:33,0,True,3,17,-14,35,0,5
3,00:03:33,0,False,17,6,11,35,0,5
4,00:15:00,0,True,6,24,-18,35,0,5
1,00:15:00,0,True,0,0,0,35,0,5
1,00:12:25,0,False,0,7,-7,35,0,5
1,00:06:32,0,True,7,3,4,35,0,5
1,00:00:15,0,True,7,6,1,35,0,5
2,00:12:23,0,True,7,13,-6,35,0,5
2,00:08:55,0,True,7,16,-9,35,0,5
2,00:00:15,0,True,10,23,-13,35,0,5
3,00:15:00,0,False,23,10,13,35,0,5
3,00:09:50,0,True,12,23,-11,25,0,5
4,00:13:20,0,True,12,33,-21,30,0,5
4,00:11:56,0,False,33,19,14,35,0,5
4,00:04:15,0,False,33,26,7,35,0,5
1,00:15:00,0,True,0,0,0,35,0,5
1,00:08:18,0,False,0,7,-7,35,0,5
2,00:07:58,0,True,7,7,0,35,0,5
2,00:07:11,0,False,7,14,-7,35,0,5
2,00:00:07,0,False,9,14,-5,25,0,5
3,00:15:00,0,False,9,14,-5,35,0,5
3,00:09:14,0,False,9,21,-12,35,0,5
3,00:04:01,0,True,21,16,5,35,0,5
4,00:09:39,0,True,22,19,3,35,0,5
4,00:05:37,0,False,19,29,-10,35,0,5
4,00:00:25,0,True,29,26,3,35,0,5
1,00:08:35,0,True,0,3,-3,35,0,5
1,00:02:45,0,False,3,7,-4,35,0,5
1,00:00:53,0,True,7,10,-3,35,0,5
3,00:15:00,0,False,11,14,-3,35,0,5
3,00:04:59,0,True,14,14,0,35,0,5
3,00:01:03,0,False,14,21,-7,35,0,5
4,00:00:54,0,True,24,24,0,35,0,5
4,00:00:24,0,True,24,31,-7,35,0,5
1,00:15:00,0,False,0,0,0,35,0,5
1,00:06:19,0,False,2,0,2,25,0,5
1,00:00:28,0,False,2,7,-5,35,0,5
2,00:09:46,0,True,7,10,-3,35,0,5
2,00:02:01,0,True,7,17,-10,35,0,5
2,00:01:30,0,False,17,14,3,35,0,5
3,00:15:00,0,True,14,18,-4,35,0,5
3,00:10:47,0,False,18,21,-3,35,0,5
4,00:13:05,0,False,18,31,-13,35,0,5
4,00:11:02,0,True,31,25,6,35,0,5
4,00:05:24,0,False,25,38,-13,35,0,5
4,00:02:07,0,False,25,48,-23,35,0,5
1,00:15:00,0,True,0,0,0,35,0,5
1,00:05:51,0,False,0,3,-3,35,0,5
2,00:15:00,0,True,3,7,-4,35,0,5
2,00:11:20,0,False,7,10,-3,35,0,5
2,00:01:13,0,False,7,17,-10,35,0,5
2,00:01:13,0,True,17,14,3,35,0,5
3,00:15:00,0,False,17,17,0,35,0,5
4,00:12:55,0,True,17,26,-9,35,0,5
4,00:03:09,0,False,26,27,-1,35,0,5
4,00:01:13,0,True,27,29,-2,35,0,5
1,00:15:00,0,True,0,0,0,35,0,5
3,00:15:00,0,False,7,17,-10,35,0,5
3,00:04:51,0,False,7,30,-23,35,0,5
4,00:10:42,0,False,7,37,-30,35,0,5
4,00:07:46,0,True,37,13,24,25,0,5
4,00:04:11,0,True,37,20,17,35,0,5
4,00:02:58,0,True,37,27,10,35,0,5
4,00:02:17,0,True,37,34,3,35,0,5
1,00:14:53,0,True,0,0,0,30,0,5
1,00:04:46,0,False,0,8,-8,35,0,5
2,00:11:23,0,True,8,3,5,35,0,5
2,00:05:58,0,True,8,10,-2,35,0,5
2,00:01:29,0,True,8,17,-9,50,0,5
3,00:15:00,0,False,17,8,9,35,0,5
1,00:15:00,0,False,0,0,0,35,0,5
1,00:05:49,0,True,2,0,2,25,0,5
1,00:00:10,0,True,2,7,-5,35,0,5
2,00:10:53,0,False,7,9,-2,35,0,5
3,00:15:00,0,True,9,10,-1,35,0,5
3,00:08:49,0,True,10,17,-7,35,0,5
3,00:03:11,0,False,17,17,0,35,0,5
4,00:02:31,0,False,20,24,-4,35,0,5
1,00:15:00,0,True,0,0,0,35,0,5
1,00:11:03,0,True,0,7,-7,35,0,5
2,00:07:40,0,False,7,8,-1,35,0,5
3,00:15:00,0,False,10,9,1,35,0,5
1,00:15:00,0,False,0,0,0,35,0,5
1,00:08:48,0,False,0,3,-3,35,0,5
1,00:02:07,0,False,2,3,-1,25,0,5
2,00:14:21,0,True,3,5,-2,35,0,5
2,00:11:44,0,False,5,10,-5,35,0,5
2,00:06:15,0,False,5,17,-12,35,0,5
3,00:15:00,0,True,17,8,9,35,0,5
3,00:12:22,0,False,8,24,-16,35,0,5
3,00:11:13,0,False,8,31,-23,35,0,5
3,00:07:53,0,False,8,34,-26,35,0,5
4,00:14:05,0,True,34,15,19,35,0,5
4,00:08:56,0,True,34,22,12,35,0,5
4,00:01:57,0,True,37,29,8,35,0,5
1,00:15:00,0,False,0,0,0,35,0,5
1,00:03:05,0,False,1,10,-9,35,0,5
2,00:01:58,0,True,13,5,8,35,0,5
3,00:15:00,0,False,5,16,-11,35,0,5
3,00:06:51,0,False,8,23,-15,35,0,5
3,00:05:12,0,True,23,15,8,35,0,5
3,00:03:32,0,True,23,21,2,35,0,5
3,00:01:21,0,True,23,28,-5,35,0,5
4,00:14:38,0,False,28,30,-2,35,0,5
4,00:01:17,0,True,30,37,-7,35,0,5
1,00:15:00,0,False,0,0,0,35,0,5
1,00:06:58,0,False,0,7,-7,35,0,5
2,00:15:00,0,False,0,14,-14,35,0,5
3,00:15:00,0,True,35,0,35,35,0,5
4,00:05:05,0,False,0,51,-51,35,0,5
1,00:15:00,0,True,0,0,0,35,0,5
1,00:08:26,0,True,0,3,-3,35,0,5
1,00:08:13,0,False,3,7,-4,35,0,5
3,00:15:00,0,False,12,10,2,35,0,5
3,00:09:54,0,False,12,17,-5,35,0,5
1,00:11:45,0,False,0,7,-7,35,0,5
1,00:01:57,0,True,7,10,-3,35,0,5
3,00:15:00,0,True,7,14,-7,35,0,5
3,00:11:40,0,True,9,14,-5,25,0,5
3,00:04:21,0,False,14,23,-9,35,0,5
4,00:14:02,0,True,23,21,2,35,0,5
1,00:15:00,0,False,0,0,0,35,0,5
1,00:12:50,0,True,0,7,-7,35,0,5
1,00:08:28,0,False,7,3,4,35,0,5
2,00:09:06,0,False,8,13,-5,40,0,5
2,00:00:17,0,True,13,15,-2,35,0,5
3,00:15:00,0,True,13,15,-2,35,0,5
3,00:07:50,0,True,13,22,-9,45,0,5
4,00:01:18,0,False,22,26,-4,35,0,5
1,00:15:00,0,False,0,0,0,35,0,5
1,00:09:49,0,False,0,7,-7,35,0,5
1,00:01:29,0,True,8,7,1,35,0,5
2,00:09:53,0,True,8,14,-6,35,0,5
3,00:08:17,0,False,17,15,2,35,0,5
3,00:04:59,0,True,15,20,-5,35,0,5
4,00:11:41,0,True,15,27,-12,35,0,5
4,00:09:43,0,False,27,22,5,35,0,5
1,00:15:00,0,True,0,0,0,35,0,5
1,00:09:13,0,False,0,7,-7,35,0,5
1,00:01:23,0,False,0,17,-17,35,0,5
2,00:00:58,0,False,3,24,-21,35,0,5
3,00:15:00,0,False,3,24,-21,35,0,5
1,00:15:00,0,False,0,0,0,35,0,5
1,00:11:39,0,True,0,7,-7,35,0,5
1,00:09:58,0,True,0,14,-14,35,0,5
1,00:07:43,0,False,14,3,11,35,0,5
1,00:01:43,0,False,14,10,4,50,0,5
2,00:09:55,0,True,11,17,-6,35,0,5
2,00:08:07,0,True,11,20,-9,35,0,5
2,00:04:02,0,True,13,20,-7,25,0,5
3,00:15:00,0,True,13,23,-10,35,0,5
3,00:13:28,0,False,23,20,3,35,0,5
3,00:11:32,0,False,23,27,-4,35,0,5
4,00:10:17,0,True,33,31,2,35,0,5
1,00:15:00,0,False,0,0,0,35,0,5
1,00:10:13,0,True,0,8,-8,35,0,5
2,00:05:44,0,False,11,10,1,35,0,5
2,00:02:24,0,False,11,20,-9,35,0,5
3,00:15:00,0,True,20,12,8,35,0,5
4,00:10:30,0,True,23,23,0,35,0,5
4,00:07:47,0,True,23,30,-7,35,0,5
4,00:00:14,0,False,31,29,2,35,0,5
1,00:15:00,0,True,0,0,0,35,0,5
1,00:11:54,0,False,0,7,-7,35,0,5
1,00:11:38,0,True,7,7,0,40,0,5
1,00:04:14,0,True,8,14,-6,35,0,5
1,00:00:50,0,True,8,21,-13,35,0,5
2,00:08:47,0,True,15,24,-9,35,0,5
2,00:07:58,0,False,24,22,2,35,0,5
2,00:03:12,0,False,24,25,-1,35,0,5
2,00:01:12,0,True,25,31,-6,30,0,5
3,00:15:00,0,False,31,25,6,35,0,5
3,00:09:53,0,False,34,32,2,35,0,5
4,00:05:01,0,False,34,39,-5,35,0,5
1,00:15:00,0,True,0,0,0,35,0,5
1,00:12:35,0,True,2,0,2,25,0,5
2,00:02:47,0,False,0,15,-15,35,0,5
3,00:15:00,0,False,0,15,-15,35,0,5
3,00:02:48,0,True,15,7,8,35,0,5
4,00:15:00,0,False,7,22,-15,35,0,5
4,00:08:29,0,False,7,29,-22,35,0,5
4,00:06:40,0,True,29,14,15,25,0,5
4,00:02:34,0,False,14,36,-22,25,0,5
1,00:15:00,0,True,0,0,0,35,0,5
1,00:09:30,0,False,0,7,-7,35,0,5
1,00:03:18,0,False,0,14,-14,35,0,5
1,00:02:11,0,True,16,0,16,25,0,5
2,00:09:39,0,True,16,6,10,35,0,5
2,00:05:56,0,False,6,23,-17,35,0,5
2,00:01:40,0,False,6,31,-25,35,0,5
3,00:15:00,0,False,6,31,-25,35,0,5
3,00:10:25,0,True,31,13,18,35,0,5
3,00:01:57,0,False,21,38,-17,35,0,5
4,00:00:01,0,True,44,32,12,35,0,5
1,00:15:00,0,True,0,0,0,35,0,5
1,00:09:32,0,False,0,7,-7,35,0,5
2,00:00:23,0,True,20,11,9,35,0,5
3,00:15:00,0,False,11,20,-9,35,0,5
3,00:14:16,0,False,11,27,-16,35,0,5
4,00:05:35,0,True,27,24,3,35,0,5
4,00:00:23,0,True,27,27,0,35,0,5
1,00:15:00,0,False,0,0,0,35,0,5
1,00:10:09,0,True,0,7,-7,35,0,5
1,00:00:49,0,True,0,14,-14,35,0,5
3,00:09:42,0,True,1,36,-35,35,0,5
3,00:07:49,0,False,36,4,32,35,0,5
3,00:02:36,0,True,6,36,-30,25,0,5
4,00:06:07,0,False,39,12,27,45,0,5
1,00:15:00,0,False,0,0,0,35,0,5
2,00:12:34,0,True,3,7,-4,35,0,5
3,00:15:00,0,True,3,8,-5,35,0,5
4,00:05:49,0,True,4,16,-12,35,0,5
4,00:02:10,0,False,16,11,5,35,0,5
1,00:15:00,0,False,0,0,0,35,0,5
1,00:06:00,0,False,0,7,-7,35,0,5
2,00:04:54,0,True,13,3,10,35,0,5
3,00:15:00,0,True,14,3,11,35,0,5
3,00:00:07,0,True,17,6,11,35,0,5
4,00:12:13,0,True,17,9,8,35,0,5
4,00:04:14,0,False,9,24,-15,35,0,5
1,00:11:41,0,True,0,7,-7,35,0,5
2,00:14:23,0,True,3,14,-11,35,0,5
2,00:09:00,0,False,14,11,3,35,0,5
2,00:00:14,0,True,14,21,-7,35,0,5
3,00:15:00,0,True,14,21,-7,35,0,5
4,00:12:57,0,False,21,28,-7,35,0,5
4,00:05:08,0,False,21,35,-14,35,0,5
1,00:15:00,0,False,0,0,0,35,0,5
1,00:09:30,0,False,9,0,9,25,0,5
1,00:06:31,0,True,0,16,-16,35,0,5
1,00:03:46,0,False,16,7,9,35,0,5
3,00:15:00,0,True,13,16,-3,35,0,5
3,00:07:36,0,True,13,23,-10,50,0,5
4,00:09:27,0,True,13,30,-17,35,0,5
4,00:06:22,0,False,30,20,10,35,0,5
1,00:15:00,0,False,0,0,0,35,0,5
1,00:05:46,0,False,0,3,-3,35,0,5
1,00:01:12,0,True,3,7,-4,35,0,5
2,00:14:23,0,False,7,10,-3,35,0,5
2,00:02:25,0,True,10,10,0,35,0,5
3,00:15:00,0,False,10,13,-3,35,0,5
3,00:10:56,0,True,13,16,-3,35,0,5
4,00:14:35,0,True,15,19,-4,25,0,5
4,00:10:34,0,False,19,22,-3,35,0,5
4,00:00:28,0,True,28,26,2,35,0,5
1,00:15:00,0,True,0,0,0,35,0,5
1,00:11:13,0,False,0,3,-3,35,0,5
1,00:02:23,0,True,4,7,-3,35,0,5
2,00:15:00,0,False,7,11,-4,35,0,5
2,00:07:21,0,True,11,14,-3,35,0,5
3,00:15:00,0,False,21,14,7,35,0,5
3,00:07:53,0,True,14,29,-15,35,0,5
4,00:09:59,0,False,32,21,11,35,0,5
4,00:02:15,0,True,21,39,-18,35,0,5
4,00:00:23,0,False,39,28,11,35,0,5
1,00:15:00,0,True,0,0,0,35,0,5
1,00:11:00,0,True,0,7,-7,35,0,5
1,00:04:57,0,False,7,10,-3,35,0,5
2,00:08:50,0,False,8,18,-10,35,0,5
2,00:05:30,0,True,18,15,3,35,0,5
3,00:15:00,0,True,18,15,3,35,0,5
3,00:12:41,0,False,15,25,-10,35,0,5
3,00:10:19,0,True,25,22,3,35,0,5
3,00:03:42,0,True,25,25,0,35,0,5
4,00:07:42,0,True,25,32,-7,35,0,5
1,00:15:00,0,False,0,0,0,35,0,5
1,00:07:00,0,False,0,7,-7,35,0,5
2,00:03:42,0,True,7,13,-6,35,0,5
3,00:15:00,0,True,7,13,-6,35,0,5
4,00:03:33,0,False,19,14,5,35,0,5
1,00:15:00,0,True,0,0,0,35,0,5
1,00:14:13,0,True,0,7,-7,35,0,5
1,00:11:52,0,False,7,7,0,35,0,5
2,00:05:36,0,True,7,18,-11,35,0,5
2,00:03:42,0,True,7,25,-18,35,0,5
2,00:01:02,0,False,33,14,19,35,0,5
3,00:15:00,0,False,33,14,19,35,0,5
3,00:10:18,0,True,14,40,-26,35,0,5
3,00:00:26,0,True,14,47,-33,35,0,5
1,00:15:00,0,True,0,0,0,35,0,5
1,00:12:38,0,False,0,7,-7,35,0,5
2,00:13:17,0,True,9,6,3,35,0,5
4,00:05:50,0,False,13,25,-12,50,0,5
1,00:15:00,0,True,0,0,0,35,0,5
3,00:15:00,0,False,1,3,-2,35,0,5
3,00:03:52,0,True,3,15,-12,35,0,5
1,00:15:00,0,True,0,0,0,35,0,5
2,00:13:49,0,True,1,7,-6,35,0,5
2,00:11:57,0,True,1,14,-13,35,0,5
2,00:00:32,0,False,17,4,13,35,0,5
3,00:15:00,0,False,17,4,13,35,0,5
3,00:09:11,0,True,4,20,-16,35,0,5
3,00:03:06,0,True,4,27,-23,35,0,5
4,00:15:00,0,False,27,11,16,35,0,5
4,00:13:00,0,True,11,34,-23,35,0,5
1,00:15:00,0,True,0,0,0,35,0,5
1,00:12:09,0,False,0,3,-3,35,0,5
1,00:06:39,0,True,3,7,-4,35,0,5
2,00:14:50,0,False,7,6,1,35,0,5
2,00:07:07,0,True,6,14,-8,35,0,5
3,00:15:00,0,False,21,6,15,35,0,5
3,00:10:31,0,True,6,28,-22,35,0,5
3,00:05:19,0,True,6,31,-25,35,0,5
4,00:01:33,0,True,11,35,-24,25,0,5
4,00:00:29,0,False,35,19,16,35,0,5
1,00:15:00,0,True,0,0,0,35,0,5
2,00:13:39,0,False,3,1,2,25,0,5
3,00:01:31,0,False,4,11,-7,35,0,5
4,00:11:44,0,True,11,11,0,35,0,5
4,00:08:42,0,False,11,14,-3,35,0,5
1,00:15:00,0,False,0,0,0,35,0,5
1,00:08:34,0,True,0,7,-7,35,0,5
1,00:03:01,0,True,0,17,-17,35,0,5
2,00:15:00,0,True,0,24,-24,35,0,5
2,00:00:02,0,False,24,19,5,35,0,5
3,00:15:00,0,True,19,24,-5,35,0,5
3,00:04:38,0,False,24,28,-4,35,0,5
3,00:00:56,0,False,24,35,-11,35,0,5
4,00:04:06,0,False,27,38,-11,35,0,5
1,00:15:00,0,True,0,0,0,35,0,5
1,00:05:17,0,True,0,3,-3,35,0,5
2,00:08:22,0,False,3,10,-7,35,0,5
2,00:03:12,0,True,10,10,0,35,0,5
3,00:15:00,0,False,10,10,0,35,0,5
3,00:11:10,0,False,10,17,-7,35,0,5
3,00:04:59,0,False,10,24,-14,35,0,5
4,00:14:45,0,True,24,13,11,35,0,5
4,00:02:00,0,False,14,31,-17,35,0,5
4,00:01:09,0,True,31,21,10,35,0,5
2,00:00:01,0,False,6,9,-3,35,0,5
3,00:15:00,0,False,6,9,-3,35,0,5
3,00:05:29,0,True,12,13,-1,35,0,5
4,00:00:38,0,False,21,22,-1,35,0,5
1,00:15:00,0,False,0,0,0,35,0,5
2,00:03:38,0,False,0,13,-13,35,0,5
3,00:15:00,0,False,0,16,-16,35,0,5
4,00:15:00,0,False,0,23,-23,35,0,5
4,00:12:32,0,False,0,30,-30,35,0,5
4,00:05:38,0,False,0,37,-37,35,0,5
1,00:15:00,0,True,0,0,0,35,0,5
1,00:01:01,0,False,3,10,-7,35,0,5
2,00:00:46,0,False,6,20,-14,35,0,5
3,00:15:00,0,False,6,20,-14,35,0,5
3,00:10:08,0,True,20,13,7,35,0,5
4,00:12:22,0,True,26,20,6,35,0,5
4,00:11:08,0,True,26,27,-1,35,0,5
1,00:15:00,0,True,0,0,0,35,0,5
1,00:02:22,0,True,0,8,-8,35,0,5
2,00:15:00,0,False,8,7,1,35,0,5
2,00:11:13,0,False,8,14,-6,35,0,5
3,00:15:00,0,False,17,14,3,35,0,5
3,00:09:26,0,True,14,24,-10,35,0,5
4,00:14:46,0,False,27,17,10,35,0,5
4,00:12:36,0,True,17,34,-17,35,0,5
4,00:01:19,0,False,37,24,13,35,0,5
1,00:15:00,0,True,0,0,0,35,0,5
1,00:07:52,0,False,0,10,-10,35,0,5
1,00:01:48,0,True,10,3,7,35,0,5
2,00:13:37,0,False,5,10,-5,25,0,5
2,00:11:15,0,True,10,12,-2,35,0,5
2,00:07:15,0,False,12,17,-5,35,0,5
2,00:04:21,0,True,17,19,-2,35,0,5
2,00:02:08,0,True,17,26,-9,35,0,5
3,00:15:00,0,False,26,17,9,35,0,5
1,00:15:00,0,False,0,0,0,35,0,5
1,00:07:48,0,True,0,3,-3,35,0,5
2,00:12:56,0,False,3,7,-4,35,0,5
2,00:08:33,0,True,7,6,1,35,0,5
2,00:04:00,0,False,6,14,-8,35,0,5
3,00:15:00,0,True,14,6,8,35,0,5
4,00:15:00,0,True,21,12,9,35,0,5
4,00:00:56,0,False,12,38,-26,35,0,5
1,00:15:00,0,False,0,0,0,35,0,5
1,00:00:08,0,False,1,8,-7,35,0,5
2,00:07:35,0,False,1,15,-14,35,0,5
3,00:15:00,0,False,1,15,-14,4,0,5
3,00:08:41,0,False,1,22,-21,35,0,5
3,00:00:35,0,True,22,11,11,35,0,5
4,00:10:26,0,True,22,19,3,35,0,5
4,00:03:00,0,True,22,27,-5,35,0,5
4,00:00:40,0,True,22,34,-12,35,0,5
1,00:15:00,0,False,0,0,0,35,0,5
1,00:08:55,0,False,0,3,-3,35,0,5
2,00:11:12,0,False,3,6,-3,35,0,5
2,00:06:43,0,True,6,10,-4,35,0,5
3,00:15:00,0,True,6,17,-11,35,0,5
3,00:10:10,0,True,8,17,-9,25,0,5
3,00:01:06,0,False,20,15,5,35,0,5
4,00:12:17,0,True,15,27,-12,35,0,5
4,00:05:12,0,False,27,22,5,35,0,5
4,00:01:23,0,False,30,28,2,35,0,5
1,00:15:00,0,False,0,0,0,35,0,5
1,00:10:36,0,True,0,7,-7,35,0,5
2,00:14:45,0,False,8,3,5,35,0,5
2,00:07:46,0,True,3,15,-12,35,0,5
2,00:01:58,0,True,3,22,-19,35,0,5
2,00:00:32,0,False,22,6,16,35,0,5
3,00:15:00,0,True,6,22,-16,35,0,5
3,00:10:05,0,False,22,9,13,35,0,5
3,00:08:09,0,False,22,16,6,35,0,5
1,00:15:00,0,False,0,0,0,35,0,5
1,00:11:16,0,False,0,3,-3,35,0,5
1,00:01:10,0,True,3,8,-5,35,0,5
2,00:07:06,0,False,9,10,-1,35,0,5
2,00:04:06,0,False,9,17,-8,50,0,5
2,00:01:50,0,True,17,16,1,35,0,5
3,00:15:00,0,True,17,16,1,35,0,5
4,00:10:36,0,True,19,17,2,25,0,5
4,00:06:10,0,False,17,26,-9,35,0,5
1,00:15:00,0,False,0,0,0,35,0,5
1,00:05:35,0,False,0,3,-3,35,0,5
2,00:11:08,0,True,3,7,-4,35,0,5
2,00:03:29,0,True,3,15,-12,35,0,5
3,00:12:46,0,False,16,10,6,35,0,5
3,00:10:21,0,True,10,23,-13,35,0,5
3,00:00:06,0,False,25,10,15,25,0,5
4,00:02:13,0,False,28,17,11,35,0,5
1,00:15:00,0,True,0,0,0,35,0,5
1,00:13:32,0,True,0,7,-7,35,0,5
1,00:06:31,0,True,0,14,-14,35,0,5
1,00:03:49,0,True,0,21,-21,35,0,5
2,00:03:27,0,True,0,28,-28,35,0,5
3,00:15:00,0,False,31,3,28,35,0,5
4,00:14:08,0,False,32,10,22,35,0,5
1,00:15:00,0,True,0,0,0,35,0,5
1,00:12:02,0,False,0,7,-7,35,0,5
1,00:05:23,0,False,0,13,-13,35,0,5
2,00:09:45,0,True,16,7,9,35,0,5
2,00:02:06,0,False,7,23,-16,20,0,5
3,00:15:00,0,False,7,26,-19,35,0,5
3,00:08:07,0,True,26,17,9,35,0,5
4,00:08:10,0,False,20,35,-15,35,0,5
4,00:05:01,0,True,35,27,8,35,0,5
4,00:02:34,0,False,27,42,-15,25,0,5
1,00:15:00,0,True,0,0,0,35,0,5
1,00:09:17,0,True,0,7,-7,35,0,5
1,00:03:01,0,True,0,14,-14,35,0,5
2,00:10:06,0,True,3,21,-18,35,0,5
2,00:01:22,0,True,3,31,-28,35,0,5
3,00:15:00,0,False,31,3,28,35,0,5
4,00:04:24,0,False,40,17,23,35,0,5
4,00:03:00,0,False,40,24,16,35,0,5
4,00:01:24,0,True,24,47,-23,35,0,5
1,00:15:00,0,False,0,0,0,35,0,5
2,00:08:19,0,False,10,7,3,35,0,5
3,00:00:48,0,True,7,24,-17,35,0,5
4,00:11:44,0,False,24,11,13,35,0,5
4,00:05:24,0,True,11,34,-23,35,0,5
4,00:02:39,0,False,34,18,16,35,0,5
1,00:15:00,0,True,0,0,0,35,0,5
1,00:06:37,0,False,0,10,-10,35,0,5
1,00:04:38,0,True,10,3,7,35,0,5
1,00:01:23,0,False,3,17,-14,35,0,5
2,00:01:19,0,False,4,25,-21,35,0,5
3,00:15:00,0,False,4,25,-21,35,0,5
3,00:09:04,0,False,4,28,-24,35,0,5
3,00:02:29,0,False,4,35,-31,35,0,5
3,00:02:12,0,True,35,11,24,35,0,5
1,00:15:00,0,False,0,0,0,35,0,5
1,00:09:02,0,True,0,3,-3,35,0,5
1,00:06:13,0,False,3,7,-4,35,0,5
3,00:15:00,0,True,8,7,1,35,0,5
3,00:02:28,0,True,11,11,0,25,0,5
4,00:14:28,0,False,11,14,-3,35,0,5
4,00:01:45,0,True,14,21,-7,35,0,5
1,00:15:00,0,True,0,0,0,35,0,5
1,00:03:41,0,False,0,10,-10,50,0,5
2,00:13:27,0,True,13,3,10,35,0,5
2,00:11:08,0,False,3,16,-13,35,0,5
2,00:03:01,0,False,4,19,-15,35,0,5
2,00:01:45,0,True,19,11,8,35,0,5
3,00:15:00,0,False,11,19,-8,35,0,5
3,00:09:33,0,False,11,26,-15,35,0,5
3,00:04:56,0,True,26,18,8,35,0,5
4,00:07:58,0,True,26,26,0,35,0,5
4,00:05:14,0,False,26,33,-7,35,0,5
4,00:01:07,0,False,26,40,-14,35,0,5
1,00:15:00,0,True,0,0,0,35,0,5
1,00:12:22,0,False,0,7,-7,35,0,5
1,00:01:30,0,True,7,7,0,35,0,5
1,00:01:13,0,False,7,14,-7,35,0,5
2,00:06:43,0,True,14,16,-2,35,0,5
2,00:02:43,0,False,16,21,-5,35,0,5
3,00:15:00,0,False,16,21,-5,35,0,5
3,00:03:40,0,True,21,19,2,35,0,5
1,00:15:00,0,False,0,0,0,35,0,5
2,00:14:14,0,False,3,7,-4,35,0,5
2,00:09:16,0,False,3,14,-11,35,0,5
3,00:15:00,0,False,3,14,-11,35,0,5
1,00:15:00,0,True,0,0,0,35,0,5
1,00:11:37,0,False,0,7,-7,35,0,5
1,00:08:07,0,True,7,3,4,25,0,5
2,00:10:17,0,False,9,14,-5,35,0,5
2,00:01:42,0,True,14,16,-2,35,0,5
3,00:15:00,0,False,16,17,-1,35,0,5
3,00:04:54,0,True,26,16,10,25,0,5
3,00:02:31,0,False,16,33,-17,25,0,5
4,00:05:32,0,True,33,23,10,35,0,5
4,00:00:01,0,True,36,33,3,35,0,5
1,00:15:00,0,False,0,0,0,35,0,5
1,00:00:12,0,True,0,10,-10,35,0,5
2,00:07:00,0,False,10,7,3,35,0,5
2,00:02:09,0,False,10,14,-4,35,0,5
2,00:01:29,0,False,10,17,-7,35,0,5
2,00:00:09,0,True,17,17,0,35,0,5
3,00:15:00,0,True,17,17,0,35,0,5
3,00:10:20,0,False,17,20,-3,35,0,5
3,00:05:26,0,True,20,24,-4,35,0,5
3,00:01:54,0,False,24,23,1,35,0,5
4,00:11:05,0,False,24,26,-2,35,0,5
4,00:08:02,0,True,26,31,-5,35,0,5
1,00:15:00,0,False,0,0,0,35,0,5
1,00:06:53,0,False,5,0,5,25,0,5
1,00:04:04,0,True,0,12,-12,35,0,5
2,00:06:42,0,True,0,15,-15,35,0,5
2,00:03:22,0,False,15,7,8,35,0,5
3,00:15:00,0,True,7,21,-14,35,0,5
3,00:13:43,0,False,21,14,7,35,0,5
3,00:08:58,0,False,28,21,7,35,0,5
3,00:02:42,0,False,28,24,4,35,0,5
4,00:07:11,0,True,27,38,-11,35,0,5
4,00:06:37,0,False,38,33,5,35,0,5
1,00:15:00,0,False,0,0,0,35,0,5
1,00:03:03,0,False,4,7,-3,25,0,5
2,00:07:10,0,True,7,14,-7,35,0,5
2,00:01:52,0,False,14,14,0,35,0,5
2,00:01:16,0,True,14,21,-7,35,0,5
3,00:15:00,0,False,21,14,7,11,0,5
4,00:10:42,0,True,14,29,-15,35,0,5
1,00:15:00,0,False,0,0,0,35,0,5
1,00:04:49,0,True,2,1,1,25,0,5
1,00:00:36,0,False,1,9,-8,35,0,5
2,00:07:15,0,False,1,16,-15,35,0,5
2,00:01:19,0,True,16,8,8,35,0,5
3,00:15:00,0,True,16,8,8,35,0,5
3,00:10:40,0,False,8,23,-15,35,0,5
3,00:00:14,0,True,24,11,13,35,0,5
4,00:08:00,0,True,24,18,6,35,0,5
1,00:15:00,0,False,0,0,0,35,0,5
1,00:11:26,0,False,0,7,-7,35,0,5
1,00:05:27,0,False,0,10,-10,35,0,5
2,00:15:00,0,True,17,0,17,5,0,5
2,00:07:20,0,False,0,24,-24,20,0,5
2,00:02:06,0,True,24,3,21,35,0,5
3,00:15:00,0,True,24,6,18,35,0,5
4,00:14:23,0,False,7,27,-20,35,0,5
4,00:11:11,0,True,27,14,13,35,0,5
4,00:02:08,0,False,14,34,-20,35,0,5
1,00:15:00,0,True,0,0,0,35,0,5
2,00:11:21,0,False,6,10,-4,35,0,5
3,00:15:00,0,False,12,10,2,35,0,5
3,00:06:50,0,False,15,17,-2,35,0,5
3,00:03:04,0,True,17,22,-5,35,0,5
3,00:00:40,0,False,22,24,-2,35,0,5
4,00:08:00,0,True,27,29,-2,35,0,5
1,00:15:00,0,False,0,0,0,35,0,5
2,00:11:56,0,False,3,3,0,35,0,5
2,00:09:36,0,True,3,10,-7,35,0,5
2,00:00:01,0,False,20,10,10,35,0,5
1,00:15:00,0,True,0,0,0,35,0,5
1,00:11:39,0,False,0,3,-3,35,0,5
1,00:09:08,0,True,3,3,0,35,0,5
1,00:00:52,0,True,3,10,-7,35,0,5
2,00:11:46,0,True,3,17,-14,35,0,5
3,00:15:00,0,True,3,23,-20,35,0,5
3,00:09:10,0,False,23,10,13,35,0,5
4,00:09:42,0,False,23,17,6,35,0,5
1,00:15:00,0,False,0,0,0,35,0,5
1,00:08:24,0,True,0,7,-7,35,0,5
1,00:02:47,0,False,7,3,4,35,0,5
1,00:01:27,0,False,7,10,-3,35,0,5
2,00:13:50,0,False,7,13,-6,35,0,5
2,00:11:38,0,False,7,20,-13,35,0,5
2,00:07:51,0,False,7,27,-20,35,0,5
3,00:15:00,0,False,7,31,-24,35,0,5
1,00:15:00,0,False,0,0,0,35,0,5
1,00:06:46,0,False,0,7,-7,35,0,5
1,00:03:03,0,False,0,14,-14,35,0,5
2,00:00:32,0,False,3,31,-28,35,0,5
3,00:15:00,0,True,31,3,28,35,0,5
4,00:14:02,0,False,5,34,-29,25,0,5
1,00:15:00,0,True,0,0,0,35,0,5
1,00:09:09,0,False,0,7,-7,35,0,5
1,00:00:46,0,True,10,7,3,35,0,5
2,00:13:16,0,False,7,13,-6,35,0,5
2,00:08:47,0,True,13,10,3,35,0,5
2,00:00:27,0,False,17,21,-4,35,0,5
3,00:15:00,0,False,17,21,-4,35,0,5
4,00:03:56,0,True,29,21,8,25,0,5
4,00:02:44,0,False,21,36,-15,35,0,5
1,00:15:00,0,False,0,0,0,35,0,5
1,00:14:12,0,True,0,7,-7,35,0,5
1,00:07:42,0,True,0,10,-10,35,0,5
2,00:14:47,0,False,12,1,11,25,0,5
2,00:03:31,0,False,12,8,4,35,0,5
2,00:01:44,0,True,8,15,-7,35,0,5
2,00:00:27,0,False,15,15,0,35,0,5
3,00:15:00,0,True,15,15,0,35,0,5
3,00:13:07,0,False,15,22,-7,35,0,5
4,00:09:18,0,False,15,36,-21,35,0,5
4,00:05:16,0,True,36,22,14,35,0,5
4,00:02:01,0,False,22,43,-21,35,0,5
4,00:00:48,0,True,43,29,14,35,0,5
1,00:15:00,0,True,0,0,0,35,0,5
1,00:08:24,0,True,0,7,-7,35,0,5
1,00:04:10,0,True,0,14,-14,35,0,5
2,00:10:20,0,False,16,0,16,25,0,5
3,00:15:00,0,False,16,3,13,35,0,5
3,00:08:51,0,False,16,10,6,35,0,5
3,00:06:04,0,True,10,23,-13,35,0,5
4,00:03:43,0,False,23,27,-4,35,0,5
1,00:15:00,0,True,0,0,0,35,0,5
1,00:11:28,0,True,0,3,-3,35,0,5
2,00:11:11,0,False,3,10,-7,35,0,5
2,00:00:36,0,True,10,15,-5,35,0,5
3,00:07:17,0,False,15,19,-4,20,0,5
4,00:04:52,0,True,22,25,-3,35,0,5
4,00:01:48,0,False,25,29,-4,35,0,5
1,00:15:00,0,True,0,0,0,35,0,5
1,00:11:14,0,False,0,7,-7,35,0,5
2,00:12:36,0,True,10,7,3,35,0,5
2,00:09:22,0,True,10,14,-4,35,0,5
4,00:14:52,0,True,19,15,4,25,0,5
4,00:02:47,0,True,20,23,-3,35,0,5
1,00:15:00,0,False,0,0,0,35,0,5
1,00:09:10,0,True,0,3,-3,35,0,5
1,00:01:32,0,False,3,7,-4,35,0,5
2,00:08:37,0,False,4,10,-6,35,0,5
2,00:02:45,0,False,4,17,-13,35,0,5
3,00:15:00,0,True,17,4,13,35,0,5
3,00:03:21,0,True,17,7,10,35,0,5
1,00:15:00,0,True,0,0,0,35,0,5
1,00:07:58,0,False,0,3,-3,35,0,5
1,00:01:16,0,True,3,3,0,35,0,5
2,00:11:59,0,False,3,6,-3,30,0,5
2,00:05:58,0,True,6,10,-4,35,0,5
2,00:00:43,0,True,6,17,-11,50,0,5
3,00:15:00,0,False,17,6,11,35,0,5
3,00:09:27,0,True,6,27,-21,50,0,5
4,00:03:56,0,True,7,37,-30,35,0,5
1,00:15:00,0,False,0,0,0,35,0,5
1,00:06:22,0,True,0,10,-10,35,0,5
2,00:03:57,0,False,10,10,0,35,0,5
3,00:15:00,0,True,10,13,-3,35,0,5
3,00:01:38,0,False,16,20,-4,35,0,5
4,00:15:00,0,True,20,23,-3,35,0,5
4,00:10:25,0,False,23,23,0,35,0,5
4,00:01:06,0,True,26,30,-4,35,0,5
1,00:15:00,0,False,0,0,0,35,0,5
3,00:15:00,0,True,0,2,-2,35,0,5
3,00:04:12,0,True,6,9,-3,35,0,5
4,00:01:04,0,False,10,13,-3,35,0,5
1,00:15:00,0,True,0,0,0,35,0,5
2,00:14:32,0,True,3,7,-4,25,0,5
2,00:13:06,0,False,7,6,1,35,0,5
2,00:04:26,0,True,6,14,-8,35,0,5
2,00:02:41,0,False,14,13,1,35,0,5
3,00:15:00,0,False,17,16,1,35,0,5
3,00:10:16,0,True,16,24,-8,35,0,5
4,00:13:02,0,False,25,23,2,35,0,5
1,00:15:00,0,True,0,0,0,35,0,5
1,00:02:40,0,True,3,7,-4,35,0,5
2,00:08:40,0,True,6,14,-8,35,0,5
2,00:02:43,0,True,6,22,-16,35,0,5
3,00:15:00,0,True,6,22,-16,35,0,5
3,00:09:23,0,False,22,13,9,35,0,5
4,00:01:12,0,True,13,35,-22,35,0,5
1,00:15:00,0,True,0,0,0,35,0,5
1,00:11:36,0,True,0,3,-3,35,0,5
1,00:07:47,0,False,3,7,-4,35,0,5
1,00:00:29,0,True,7,10,-3,35,0,5
2,00:13:10,0,False,10,14,-4,25,0,5
2,00:06:43,0,False,10,21,-11,35,0,5
2,00:00:24,0,True,24,17,7,35,0,5
3,00:14:52,0,False,17,24,-7,30,0,5
1,00:15:00,0,False,0,0,0,35,0,5
1,00:06:38,0,False,3,7,-4,35,0,5
2,00:08:49,0,False,3,17,-14,35,0,5
2,00:05:22,0,False,3,24,-21,35,0,5
2,00:01:56,0,False,6,31,-25,35,0,5
3,00:15:00,0,False,6,31,-25,35,0,5
4,00:03:48,0,False,16,45,-29,35,0,5
4,00:01:56,0,True,45,23,22,35,0,5
1,00:15:00,0,True,0,0,0,35,0,5
1,00:08:48,0,False,0,3,-3,35,0,5
1,00:03:14,0,True,3,7,-4,35,0,5
2,00:11:42,0,True,3,14,-11,35,0,5
2,00:06:23,0,False,14,10,4,35,0,5
2,00:02:54,0,False,14,13,1,35,0,5
3,00:15:00,0,False,14,13,1,35,0,5
3,00:00:22,0,True,13,17,-4,35,0,5
4,00:06:46,0,True,16,24,-8,35,0,5
4,00:02:22,0,False,24,22,2,35,0,5
1,00:15:00,0,False,0,0,0,35,0,5
1,00:05:38,0,False,0,7,-7,35,0,5
3,00:15:00,0,True,10,4,6,35,0,5
4,00:02:43,0,True,11,11,0,35,0,5
1,00:15:00,0,False,0,0,0,35,0,5
1,00:05:09,0,True,0,7,-7,35,0,5
2,00:15:00,0,False,7,7,0,35,0,5
2,00:04:40,0,True,7,10,-3,35,0,5
3,00:15:00,0,True,7,17,-10,35,0,5
3,00:08:08,0,False,20,14,6,40,0,5
3,00:02:10,0,False,20,21,-1,35,0,5
4,00:05:16,0,False,23,28,-5,35,0,5
1,00:15:00,0,False,0,0,0,35,0,5
1,00:13:05,0,False,0,7,-7,35,0,5
1,00:03:51,0,False,0,10,-10,35,0,5
1,00:00:58,0,True,10,7,3,35,0,5
2,00:09:04,0,True,10,14,-4,35,0,5
3,00:15:00,0,False,14,10,4,35,0,5
3,00:10:22,0,True,10,21,-11,35,0,5
3,00:01:55,0,False,21,17,4,35,0,5
1,00:15:00,0,True,0,0,0,35,0,5
1,00:12:22,0,False,0,7,-7,35,0,5
1,00:00:17,0,False,0,14,-14,35,0,5
2,00:11:38,0,True,14,3,11,35,0,5
2,00:06:38,0,False,3,17,-14,35,0,5
2,00:00:27,0,True,17,7,10,35,0,5
3,00:15:00,0,False,7,17,-10,35,0,5
3,00:09:59,0,True,17,10,7,35,0,5
3,00:03:10,0,True,17,17,0,35,0,5
4,00:07:25,0,True,17,20,-3,35,0,5
1,00:15:00,0,True,0,0,0,35,0,5
1,00:06:05,0,False,3,7,-4,35,0,5
1,00:03:09,0,False,3,14,-11,35,0,5
2,00:09:53,0,False,6,21,-15,35,0,5
2,00:00:54,0,True,21,13,8,35,0,5
3,00:15:00,0,False,13,21,-8,35,0,5
3,00:08:58,0,False,13,28,-15,35,0,5
3,00:01:58,0,False,13,35,-22,35,0,5
4,00:05:41,0,True,35,23,12,35,0,5
1,00:15:00,0,False,0,0,0,35,0,5
1,00:02:27,0,True,1,7,-6,35,0,5
2,00:14:05,0,True,4,14,-10,35,0,5
2,00:01:22,0,False,15,7,8,35,0,5
2,00:00:07,0,True,7,22,-15,35,0,5
3,00:15:00,0,True,7,22,-15,35,0,5
3,00:06:03,0,False,23,10,13,35,0,5
1,00:15:00,0,False,0,0,0,35,0,5
2,00:14:34,0,False,0,7,-7,35,0,5
2,00:07:40,0,False,0,14,-14,35,0,5
3,00:15:00,0,False,2,14,-12,35,0,5
3,00:12:28,0,True,14,9,5,35,0,5
3,00:08:34,0,True,14,16,-2,35,0,5
1,00:15:00,0,False,0,0,0,35,0,5
1,00:10:07,0,False,0,7,-7,35,0,5
1,00:08:09,0,False,0,14,-14,35,0,5
2,00:09:54,0,True,18,3,15,35,0,5
2,00:05:56,0,True,18,10,8,35,0,5
2,00:02:49,0,False,10,21,-11,35,0,5
3,00:15:00,0,True,21,13,8,35,0,5
3,00:10:09,0,False,13,24,-11,35,0,5
3,00:02:49,0,False,13,31,-18,35,0,5
1,00:15:00,0,True,0,0,0,35,0,5
1,00:11:17,0,False,0,7,-7,35,0,5
1,00:03:47,0,False,0,14,-14,35,0,5
2,00:02:54,0,False,0,24,-24,35,0,5
2,00:02:06,0,True,24,7,17,35,0,5
3,00:15:00,0,False,7,24,-17,35,0,5
3,00:10:42,0,False,7,31,-24,35,0,5
3,00:05:46,0,True,31,14,17,35,0,5
4,00:03:22,0,True,45,21,24,35,0,5
1,00:15:00,0,True,0,0,0,35,0,5
2,00:15:00,0,False,0,11,-11,35,0,5
3,00:15:00,0,True,11,0,11,20,0,5
4,00:13:15,0,False,1,22,-21,35,0,5
4,00:07:26,0,False,1,29,-28,35,0,5
1,00:15:00,0,True,0,0,0,35,0,5
1,00:13:02,0,False,0,7,-7,35,0,5
1,00:06:10,0,True,7,7,0,35,0,5
1,00:00:46,0,False,7,14,-7,35,0,5
2,00:12:13,0,True,14,10,4,35,0,5
2,00:07:29,0,True,14,13,1,35,0,5
3,00:14:54,0,False,13,17,-4,40,0,5
4,00:15:00,0,True,17,20,-3,35,0,5
4,00:09:20,0,True,17,27,-10,35,0,5
1,00:15:00,0,True,0,0,0,35,0,5
1,00:04:33,0,True,12,0,12,25,0,5
2,00:13:39,0,False,0,19,-19,35,0,5
2,00:09:41,0,True,21,0,21,25,0,5
3,00:08:16,0,False,1,31,-30,35,0,5
4,00:07:01,0,True,31,10,21,45,0,5
1,00:15:00,0,True,0,0,0,35,0,5
1,00:10:48,0,True,0,7,-7,40,0,5
1,00:08:01,0,True,0,14,-14,35,0,5
2,00:15:00,0,True,7,21,-14,35,0,5
3,00:15:00,0,False,21,17,4,35,0,5
4,00:10:52,0,True,20,28,-8,35,0,5
1,00:15:00,0,True,0,0,0,35,0,5
1,00:07:17,0,False,0,7,-7,35,0,5
1,00:01:14,0,False,0,14,-14,35,0,5
2,00:00:14,0,False,0,20,-20,35,0,5
3,00:15:00,0,False,0,20,-20,35,0,5
3,00:09:19,0,True,20,3,17,35,0,5
4,00:01:20,0,True,24,9,15,35,0,5
1,00:15:00,0,False,0,0,0,35,0,5
1,00:07:38,0,False,0,7,-7,35,0,5
1,00:01:59,0,True,7,7,0,35,0,5
3,00:15:00,0,True,10,10,0,35,0,5
3,00:11:25,0,True,10,17,-7,35,0,5
4,00:11:35,0,True,13,24,-11,35,0,5
4,00:08:38,0,False,24,21,3,20,0,5
1,00:15:00,0,True,0,0,0,35,0,5
1,00:09:31,0,False,0,7,-7,35,0,5
2,00:11:20,0,False,0,17,-17,35,0,5
3,00:15:00,0,False,1,17,-16,23,0,5
3,00:09:23,0,False,1,24,-23,35,0,5
3,00:04:29,0,True,25,8,17,35,0,5
4,00:08:05,0,False,15,34,-19,35,0,5
4,00:02:22,0,False,15,48,-33,35,0,5
1,00:15:00,0,False,0,0,0,35,0,5
1,00:11:47,0,True,0,3,-3,35,0,5
1,00:09:31,0,False,3,7,-4,35,0,5
1,00:05:48,0,True,7,10,-3,35,0,5
2,00:14:47,0,False,10,10,0,35,0,5
2,00:04:06,0,True,10,16,-6,35,0,5
3,00:15:00,0,True,13,19,-6,35,0,5
3,00:05:49,0,True,20,22,-2,40,0,5
4,00:10:48,0,False,22,30,-8,35,0,5
4,00:08:14,0,True,30,28,2,35,0,5
4,00:00:28,0,True,33,34,-1,35,0,5
1,00:15:00,0,False,0,0,0,35,0,5
3,00:15:00,0,True,2,7,-5,35,0,5
4,00:09:00,0,False,8,25,-17,35,0,5
1,00:15:00,0,True,0,0,0,35,0,5
2,00:15:00,0,True,6,10,-4,35,0,5
2,00:09:38,0,True,6,17,-11,35,0,5
3,00:15:00,0,False,17,9,8,35,0,5
3,00:10:56,0,True,9,24,-15,35,0,5
3,00:04:49,0,True,12,31,-19,35,0,5
1,00:15:00,0,False,0,0,0,35,0,5
1,00:00:10,0,True,0,11,-11,35,0,5
2,00:06:51,0,False,11,6,5,35,0,5
2,00:02:31,0,False,11,13,-2,35,0,5
3,00:15:00,0,False,14,13,1,35,0,5
3,00:02:56,0,False,16,13,3,25,0,5
4,00:05:31,0,True,13,26,-13,35,0,5
1,00:15:00,0,True,0,0,0,35,0,5
1,00:08:19,0,True,0,7,-7,25,0,5
3,00:15:00,0,False,13,3,10,35,0,5
1,00:15:00,0,False,0,0,0,35,0,5
1,00:09:47,0,True,0,3,-3,35,0,5
1,00:04:20,0,False,3,3,0,35,0,5
2,00:06:41,0,True,6,7,-1,35,0,5
4,00:14:00,0,True,12,14,-2,35,0,5
2,00:07:56,0,False,4,7,-3,35,0,5
3,00:15:00,0,False,4,7,-3,35,0,5
1,00:15:00,0,True,0,0,0,35,0,5
1,00:11:45,0,False,0,3,-3,35,0,5
1,00:07:51,0,False,0,10,-10,35,0,5
1,00:04:13,0,True,10,3,7,35,0,5
2,00:01:29,0,False,3,20,-17,35,0,5
3,00:15:00,0,False,3,20,-17,35,0,5
3,00:06:40,0,False,3,27,-24,35,0,5
4,00:13:40,0,False,3,34,-31,35,0,5
4,00:11:30,0,False,3,41,-38,35,0,5
4,00:04:22,0,False,5,41,-36,25,0,5
1,00:15:00,0,False,0,0,0,35,0,5
1,00:10:10,0,False,3,3,0,35,0,5
1,00:05:51,0,True,3,10,-7,35,0,5
2,00:14:29,0,False,10,10,0,35,0,5
2,00:02:50,0,True,10,13,-3,35,0,5
2,00:00:10,0,True,13,20,-7,35,0,5
3,00:08:26,0,False,20,20,0,35,0,5
1,00:15:00,0,False,0,0,0,35,0,5
1,00:02:16,0,True,0,6,-6,35,0,5
2,00:10:12,0,True,0,9,-9,35,0,5
2,00:03:23,0,False,9,3,6,35,0,5
3,00:15:00,0,True,6,9,-3,35,0,5
1,00:15:00,0,True,0,0,0,35,0,5
1,00:07:06,0,True,7,7,0,35,0,5
1,00:05:09,0,False,7,14,-7,35,0,5
3,00:15:00,0,False,17,20,-3,35,0,5
4,00:05:04,0,False,23,30,-7,35,0,5
1,00:15:00,0,False,0,0,0,35,0,5
1,00:12:24,0,False,0,7,-7,35,0,5
2,00:03:29,0,False,6,21,-15,35,0,5
2,00:01:39,0,False,6,28,-22,35,0,5
3,00:15:00,0,True,28,6,22,35,0,5
4,00:12:08,0,False,9,34,-25,35,0,5
1,00:15:00,0,False,0,0,0,35,0,5
2,00:13:55,0,False,6,6,0,35,0,5
2,00:01:47,0,True,6,13,-7,35,0,5
3,00:12:02,0,True,6,20,-14,35,0,5
3,00:08:07,0,False,20,13,7,35,0,5
4,00:14:34,0,False,20,20,0,35,0,5
4,00:12:28,0,False,20,27,-7,35,0,5
4,00:11:07,0,True,29,20,9,25,0,5
1,00:15:00,0,True,0,0,0,35,0,5
1,00:06:59,0,False,0,4,-4,35,0,5
2,00:14:53,0,True,4,3,1,30,0,5
2,00:00:44,0,True,5,10,-5,35,0,5
3,00:15:00,0,False,10,5,5,35,0,5
3,00:11:43,0,True,5,17,-12,35,0,5
4,00:12:40,0,False,19,5,14,25,0,5
4,00:10:06,0,False,21,5,16,25,0,5
4,00:01:33,0,True,5,31,-26,35,0,5
1,00:15:00,0,True,0,0,0,35,0,5
1,00:06:02,0,True,0,7,-7,20,0,5
1,00:02:43,0,False,7,7,0,35,0,5
2,00:05:46,0,False,10,14,-4,35,0,5
2,00:02:02,0,False,10,21,-11,35,0,5
3,00:15:00,0,False,10,21,-11,35,0,5
3,00:03:14,0,True,21,13,8,35,0,5
4,00:09:41,0,True,21,19,2,35,0,5
4,00:01:32,0,True,24,25,-1,35,0,5
1,00:15:00,0,True,0,0,0,35,0,5
1,00:04:37,0,True,0,17,-17,35,0,5
1,00:01:42,0,True,0,24,-24,35,0,5
2,00:04:56,0,False,32,7,25,35,0,5
3,00:15:00,0,True,7,32,-25,35,0,5
1,00:15:00,0,True,0,0,0,35,0,5
3,00:15:00,0,False,3,10,-7,35,0,5
4,00:14:45,0,True,10,13,-3,35,0,5
1,00:15:00,0,True,0,0,0,35,0,5
1,00:12:02,0,True,0,7,-7,35,0,5
1,00:06:14,0,True,1,10,-9,35,0,5
1,00:00:42,0,False,10,5,5,35,0,5
2,00:10:00,0,True,8,17,-9,35,0,5
2,00:02:37,0,True,8,27,-19,35,0,5
4,00:00:30,0,False,33,23,10,35,0,5
1,00:15:00,0,True,0,0,0,35,0,5
1,00:07:00,0,False,0,10,-10,35,0,5
1,00:05:13,0,True,10,3,7,35,0,5
2,00:15:00,0,False,3,17,-14,35,0,5
2,00:12:04,0,True,17,6,11,35,0,5
3,00:15:00,0,False,19,17,2,35,0,5
3,00:04:49,0,False,19,27,-8,35,0,5
3,00:01:34,0,True,27,26,1,35,0,5
1,00:15:00,0,False,0,0,0,35,0,5
1,00:06:55,0,False,0,7,-7,35,0,5
2,00:02:30,0,False,0,21,-21,35,0,5
2,00:01:36,0,True,21,7,14,35,0,5
3,00:15:00,0,True,28,7,21,35,0,5
1,00:15:00,0,True,0,0,0,35,0,5
2,00:11:40,0,False,7,7,0,35,0,5
2,00:03:53,0,True,7,14,-7,35,0,5
2,00:01:21,0,False,14,14,0,35,0,5
2,00:00:03,0,False,14,21,-7,35,0,5
4,00:13:43,0,False,21,28,-7,35,0,5
4,00:03:04,0,False,21,38,-17,35,0,5
1,00:15:00,0,True,0,0,0,35,0,5
3,00:15:00,0,False,4,8,-4,35,0,5
1,00:15:00,0,True,0,0,0,35,0,5
1,00:06:44,0,True,0,7,-7,35,0,5
1,00:04:50,0,False,7,7,0,35,0,5
1,00:01:29,0,True,7,10,-3,35,0,5
2,00:02:49,0,True,7,17,-10,35,0,5
3,00:15:00,0,False,17,7,10,35,0,5
3,00:06:15,0,True,7,20,-13,35,0,5
4,00:14:32,0,False,20,17,3,35,0,5
4,00:05:49,0,False,23,20,3,35,0,5
4,00:00:33,0,True,20,30,-10,35,0,5
1,00:15:00,0,True,0,0,0,35,0,5
2,00:09:31,0,False,1,4,-3,35,0,5
3,00:15:00,0,False,4,4,0,35,0,5
4,00:14:24,0,False,4,12,-8,35,0,5
4,00:03:14,0,True,12,11,1,35,0,5
1,00:15:00,0,False,0,0,0,35,0,5
1,00:08:07,0,True,0,7,-7,35,0,5
2,00:07:14,0,False,10,6,4,35,0,5
3,00:15:00,0,True,9,13,-4,35,0,5
4,00:14:29,0,False,13,17,-4,35,0,5
4,00:09:30,0,True,17,19,-2,35,0,5
4,00:06:08,0,True,17,26,-9,35,0,5
4,00:01:56,0,True,17,33,-16,50,0,5
1,00:15:00,0,True,0,0,0,35,0,5
2,00:05:53,0,True,1,3,-2,35,0,5
3,00:15:00,0,False,6,1,5,35,0,5
3,00:13:42,0,False,6,8,-2,35,0,5
3,00:01:22,0,True,8,13,-5,35,0,5
4,00:04:18,0,True,14,16,-2,35,0,5
4,00:02:08,0,False,16,21,-5,35,0,5
1,00:15:00,0,False,0,0,0,35,0,5
1,00:02:59,0,True,0,7,-7,35,0,5
1,00:01:19,0,False,7,7,0,35,0,5
2,00:11:30,0,False,7,14,-7,35,0,5
2,00:06:06,0,False,7,24,-17,35,0,5
2,00:01:02,0,False,7,31,-24,45,0,5
3,00:15:00,0,True,31,10,21,35,0,5
3,00:03:10,0,True,31,23,8,35,0,5
4,00:00:12,0,False,27,41,-14,35,0,5
1,00:15:00,0,False,0,0,0,35,0,5
1,00:13:09,0,False,0,7,-7,35,0,5
3,00:15:00,0,True,7,8,-1,45,0,5
4,00:06:02,0,True,7,18,-11,35,0,5
4,00:04:12,0,True,7,25,-18,35,0,5
4,00:02:10,0,True,7,32,-25,35,0,5
1,00:15:00,0,True,0,0,0,35,0,5
1,00:12:33,0,False,0,3,-3,35,0,5
1,00:10:32,0,False,0,10,-10,35,0,5
2,00:14:39,0,True,10,3,7,40,0,5
2,00:02:31,0,True,13,6,7,35,0,5
4,00:15:00,0,True,16,19,-3,35,0,5
1,00:15:00,0,False,0,0,0,35,0,5
1,00:11:44,0,True,0,3,-3,35,0,5
1,00:01:40,0,False,3,7,-4,35,0,5
4,00:06:06,0,True,13,10,3,35,0,5
4,00:04:50,0,False,10,20,-10,25,0,5
1,00:15:00,0,False,0,0,0,35,0,5
1,00:07:30,0,True,0,7,-7,35,0,5
2,00:11:59,0,True,2,7,-5,25,0,5
2,00:07:48,0,True,4,7,-3,25,0,5
3,00:15:00,0,False,7,14,-7,35,0,5
3,00:08:25,0,False,7,21,-14,35,0,5
3,00:04:19,0,True,21,14,7,35,0,5
3,00:02:38,0,True,21,21,0,35,0,5
4,00:07:48,0,True,21,27,-6,35,0,5
4,00:05:19,0,False,27,28,-1,35,0,5
4,00:00:28,0,False,30,35,-5,35,0,5
1,00:15:00,0,False,0,0,0,35,0,5
1,00:13:35,0,False,0,3,-3,35,0,5
1,00:07:37,0,False,1,10,-9,35,0,5
1,00:02:07,0,False,3,10,-7,25,0,5
3,00:15:00,0,False,10,13,-3,35,0,5
1,00:06:48,0,True,8,7,1,35,0,5
2,00:08:23,0,False,7,15,-8,35,0,5
3,00:15:00,0,True,15,10,5,35,0,5
4,00:08:49,0,False,10,25,-15,35,0,5
2,00:03:39,0,True,5,3,2,25,0,5
3,00:15:00,0,False,6,5,1,35,0,5
1,00:15:00,0,True,0,0,0,35,0,5
1,00:06:20,0,True,0,3,-3,35,0,5
2,00:05:23,0,True,7,10,-3,35,0,5
2,00:02:30,0,True,7,17,-10,35,0,5
3,00:15:00,0,False,17,10,7,35,0,5
3,00:10:25,0,True,10,24,-14,35,0,5
3,00:04:35,0,True,10,31,-21,35,0,5
4,00:04:35,0,False,34,20,14,35,0,5
4,00:02:34,0,False,34,27,7,35,0,5
4,00:01:33,0,True,27,41,-14,35,0,5
4,00:00:21,0,False,41,34,7,35,0,5
1,00:12:50,0,False,0,7,-7,35,0,5
1,00:07:20,0,True,7,3,4,35,0,5
1,00:06:29,0,True,7,10,-3,35,0,5
2,00:15:00,0,True,7,17,-10,35,0,5
3,00:15:00,0,True,7,21,-14,35,0,5
3,00:08:12,0,True,10,24,-14,35,0,5
3,00:04:15,0,False,24,17,7,35,0,5
4,00:15:00,0,False,24,24,0,35,0,5
4,00:13:23,0,False,24,31,-7,35,0,5
4,00:02:55,0,False,24,38,-14,35,0,5
1,00:15:00,0,True,0,0,0,35,0,5
1,00:01:48,0,False,1,7,-6,35,0,5
2,00:08:11,0,False,10,8,2,25,0,5
2,00:01:33,0,True,8,20,-12,35,0,5
3,00:15:00,0,True,8,27,-19,35,0,5
3,00:11:53,0,False,27,15,12,35,0,5
3,00:06:02,0,True,15,30,-15,35,0,5
4,00:02:27,0,False,30,24,6,35,0,5
1,00:15:00,0,False,0,0,0,35,0,5
1,00:07:15,0,True,2,0,2,25,0,5
2,00:11:05,0,True,5,3,2,35,0,5
3,00:15:00,0,True,6,6,0,35,0,5
3,00:05:11,0,True,9,9,0,35,0,5
4,00:12:15,0,False,16,19,-3,35,0,5
4,00:01:37,0,False,16,33,-17,35,0,5
1,00:10:40,0,True,3,7,-4,35,0,5
2,00:08:56,0,True,3,22,-19,35,0,5
2,00:00:38,0,False,29,10,19,35,0,5
3,00:08:04,0,False,32,18,14,40,0,5
4,00:04:42,0,False,33,33,0,40,0,5
4,00:01:48,0,False,33,40,-7,35,0,5
1,00:15:00,0,False,0,0,0,35,0,5
1,00:02:08,0,True,0,3,-3,35,0,5
1,00:00:11,0,False,3,3,0,35,0,5
2,00:11:14,0,False,3,6,-3,35,0,5
2,00:02:42,0,True,8,3,5,25,0,5
2,00:00:45,0,False,3,15,-12,35,0,5
4,00:03:01,0,False,9,26,-17,35,0,5
1,00:15:00,0,True,0,0,0,35,0,5
2,00:13:32,0,False,0,13,-13,35,0,5
3,00:15:00,0,False,3,13,-10,35,0,5
3,00:07:24,0,False,3,20,-17,35,0,5
1,00:15:00,0,True,0,0,0,35,0,5
2,00:14:00,0,True,0,11,-11,35,0,5
2,00:06:16,0,False,18,8,10,30,0,5
3,00:15:00,0,False,21,9,12,35,0,5
4,00:11:51,0,False,30,9,21,25,0,5
4,00:07:42,0,False,30,16,14,35,0,5
4,00:01:49,0,False,33,23,10,35,0,5
4,00:00:53,0,True,23,40,-17,35,0,5
2,00:14:02,0,False,0,3,-3,35,0,5
2,00:02:40,0,True,3,8,-5,35,0,5
2,00:02:18,0,True,3,15,-12,35,0,5
4,00:11:29,0,False,15,17,-2,35,0,5
4,00:02:40,0,False,16,24,-8,35,0,5
4,00:00:06,0,True,25,23,2,35,0,5
1,00:15:00,0,False,0,0,0,35,0,5
2,00:13:45,0,False,0,7,-7,35,0,5
2,00:04:25,0,False,1,15,-14,35,0,5
2,00:00:22,0,True,15,8,7,35,0,5
3,00:15:00,0,True,15,8,7,35,0,5
3,00:11:27,0,True,15,15,0,35,0,5
3,00:00:35,0,False,15,18,-3,35,0,5
4,00:11:21,0,False,15,25,-10,35,0,5
4,00:02:42,0,False,15,31,-16,35,0,5
1,00:15:00,0,False,0,0,0,35,0,5
1,00:07:59,0,True,0,7,-7,35,0,5
1,00:02:53,0,False,7,3,4,35,0,5
2,00:05:47,0,True,3,15,-12,35,0,5
2,00:02:47,0,False,15,10,5,35,0,5
2,00:00:15,0,True,10,22,-12,35,0,5
3,00:15:00,0,True,10,22,-12,35,0,5
3,00:11:37,0,False,22,17,5,35,0,5
3,00:07:28,0,True,17,29,-12,35,0,5
4,00:13:47,0,False,29,24,5,35,0,5
4,00:00:49,0,False,32,32,0,35,0,5
2,00:10:53,0,True,0,7,-7,35,0,5
2,00:05:03,0,True,0,10,-10,35,0,5
2,00:00:39,0,False,10,7,3,35,0,5
3,00:15:00,0,False,10,7,3,35,0,5
1,00:15:00,0,True,0,0,0,35,0,5
1,00:11:39,0,False,0,7,-7,35,0,5
1,00:02:43,0,False,0,10,-10,35,0,5
2,00:13:06,0,True,12,0,12,25,0,5
3,00:15:00,0,False,0,14,-14,35,0,5
4,00:00:52,0,False,0,24,-24,35,0,5
1,00:15:00,0,False,0,0,0,35,0,5
2,00:13:56,0,True,2,3,-1,25,0,5
2,00:09:33,0,True,2,10,-8,35,0,5
3,00:15:00,0,False,10,5,5,35,0,5
4,00:10:25,0,True,5,16,-11,35,0,5
1,00:15:00,0,False,0,0,0,35,0,5
1,00:09:57,0,True,0,7,-7,35,0,5
3,00:15:00,0,True,3,7,-4,35,0,5
3,00:10:01,0,True,5,7,-2,25,0,5
4,00:11:17,0,False,7,14,-7,35,0,5
1,00:15:00,0,False,0,0,0,35,0,5
1,00:13:46,0,False,0,7,-7,35,0,5
1,00:09:06,0,True,7,7,0,35,0,5
2,00:09:06,0,False,10,14,-4,35,0,5
2,00:06:01,0,True,14,17,-3,35,0,5
2,00:01:43,0,False,17,21,-4,35,0,5
3,00:15:00,0,True,28,17,11,35,0,5
1,00:15:00,0,False,0,0,0,35,0,5
1,00:05:35,0,False,2,0,2,25,0,5
2,00:05:54,0,True,0,9,-9,35,0,5
3,00:15:00,0,True,0,9,-9,35,0,5
3,00:03:38,0,True,0,24,-24,35,0,5
3,00:02:12,0,False,24,8,16,35,0,5
4,00:15:00,0,False,24,16,8,25,0,5
4,00:08:27,0,False,24,24,0,35,0,5
4,00:00:32,0,True,24,31,-7,35,0,5
1,00:15:00,0,True,0,0,0,35,0,5
1,00:10:08,0,False,0,7,-7,35,0,5
1,00:06:15,0,False,0,14,-14,35,0,5
1,00:06:06,0,True,14,7,7,35,0,5
2,00:05:28,0,True,20,14,6,35,0,5
2,00:03:26,0,True,20,21,-1,35,0,5
3,00:15:00,0,False,21,20,1,35,0,5
4,00:00:25,0,True,33,32,1,35,0,5
1,00:15:00,0,False,0,0,0,35,0,5
1,00:00:03,0,True,0,10,-10,35,0,5
3,00:08:28,0,False,10,12,-2,35,0,5
4,00:07:17,0,True,14,17,-3,25,0,5
4,00:04:09,0,True,16,17,-1,25,0,5
2,00:03:43,0,False,13,7,6,35,0,5
2,00:01:49,0,True,7,20,-13,35,0,5
3,00:15:00,0,False,20,10,10,35,0,5
3,00:03:07,0,True,13,30,-17,35,0,5
4,00:13:53,0,False,30,20,10,40,0,5
4,00:02:07,0,False,33,27,6,35,0,5
4,00:01:14,0,False,33,34,-1,40,0,5
1,00:08:46,0,False,0,3,-3,35,0,5
2,00:06:42,0,False,0,10,-10,35,0,5
2,00:02:30,0,False,3,17,-14,35,0,5
3,00:15:00,0,True,17,3,14,35,0,5
3,00:09:37,0,False,3,24,-21,35,0,5
3,00:05:10,0,False,3,27,-24,35,0,5
4,00:12:06,0,False,3,34,-31,35,0,5
4,00:02:54,0,False,3,41,-38,35,0,5
1,00:15:00,0,False,0,0,0,35,0,5
1,00:03:30,0,True,0,7,-7,35,0,5
2,00:09:43,0,False,7,7,0,35,0,5
2,00:04:14,0,False,7,14,-7,35,0,5
3,00:15:00,0,True,14,7,7,35,0,5
3,00:11:54,0,False,7,21,-14,35,0,5
3,00:04:04,0,False,7,31,-24,35,0,5
4,00:10:53,0,False,9,34,-25,25,0,5
1,00:15:00,0,False,0,0,0,35,0,5
1,00:05:43,0,False,0,7,-7,35,0,5
2,00:05:31,0,False,0,21,-21,35,0,5
2,00:02:37,0,False,0,28,-28,35,0,5
2,00:02:27,0,True,30,0,30,25,0,5
2,00:00:04,0,False,0,37,-37,35,0,5
3,00:15:00,0,True,37,0,37,35,0,5
1,00:15:00,0,True,0,0,0,35,0,5
3,00:15:00,0,False,1,7,-6,35,0,5
3,00:09:53,0,False,3,7,-4,25,0,5
1,00:15:00,0,True,0,0,0,35,0,5
1,00:07:57,0,False,0,3,-3,35,0,5
1,00:05:35,0,True,3,3,0,35,0,5
2,00:15:00,0,True,3,10,-7,35,0,5
2,00:11:17,0,False,10,6,4,35,0,5
3,00:15:00,0,False,10,6,4,35,0,5
4,00:14:22,0,True,6,20,-14,35,0,5
4,00:08:09,0,False,20,9,11,35,0,5
1,00:15:00,0,False,0,0,0,35,0,5
1,00:08:58,0,True,0,7,-7,35,0,5
1,00:06:16,0,True,0,14,-14,35,0,5
1,00:02:01,0,False,14,3,11,35,0,5
3,00:15:00,0,True,6,16,-10,35,0,5
3,00:09:39,0,True,7,23,-16,35,0,5
3,00:02:08,0,True,9,23,-14,25,0,5
4,00:07:09,0,False,26,23,3,35,0,5
4,00:01:25,0,True,23,33,-10,35,0,5
1,00:15:00,0,True,0,0,0,35,0,5
2,00:00:58,0,False,4,10,-6,35,0,5
2,00:00:25,0,False,4,13,-9,35,0,5
3,00:14:47,0,False,4,13,-9,35,0,5
3,00:14:39,0,True,13,11,2,35,0,5
4,00:07:28,0,True,13,24,-11,35,0,5
4,00:00:42,0,False,24,19,5,35,0,5
1,00:15:00,0,True,0,0,0,35,0,5
1,00:05:24,0,True,7,7,0,35,0,5
3,00:15:00,0,False,13,7,6,35,0,5
3,00:11:24,0,True,7,20,-13,35,0,5
3,00:01:54,0,False,23,10,13,35,0,5
4,00:12:12,0,False,23,17,6,35,0,5
1,00:15:00,0,True,0,0,0,35,0,5
1,00:03:18,0,True,1,3,-2,35,0,5
2,00:15:00,0,False,3,8,-5,35,0,5
2,00:07:56,0,True,8,10,-2,35,0,5
2,00:00:54,0,True,8,20,-12,35,0,5
2,00:00:06,0,False,20,15,5,20,0,5
3,00:15:00,0,False,20,15,5,35,0,5
3,00:08:10,0,True,15,27,-12,35,0,5
4,00:09:45,0,True,23,27,-4,25,0,5
4,00:06:23,0,False,27,30,-3,35,0,5
4,00:05:01,0,False,27,37,-10,35,0,5
1,00:15:00,0,False,0,0,0,35,0,5
1,00:13:44,0,True,2,0,2,25,0,5
2,00:15:00,0,False,0,15,-15,35,0,5
2,00:06:50,0,True,15,7,8,35,0,5
3,00:09:55,0,True,15,14,1,35,0,5
3,00:01:34,0,True,15,21,-6,35,0,5
4,00:04:56,0,False,21,25,-4,20,0,5
1,00:05:48,0,True,4,7,-3,35,0,5
2,00:07:20,0,False,7,7,0,35,0,5
2,00:03:03,0,False,7,14,-7,35,0,5
4,00:09:26,0,True,17,20,-3,35,0,5
4,00:03:52,0,True,17,28,-11,35,0,5
4,00:02:27,0,False,28,23,5,35,0,5
1,00:15:00,0,True,0,0,0,35,0,5
1,00:01:23,0,False,0,8,-8,35,0,5
2,00:11:03,0,True,8,7,1,35,0,5
2,00:07:51,0,False,7,15,-8,35,0,5
2,00:07:32,0,True,15,14,1,35,0,5
3,00:15:00,0,False,14,15,-1,35,0,5
3,00:06:45,0,False,17,22,-5,35,0,5
3,00:03:28,0,True,22,24,-2,35,0,5
4,00:04:09,0,True,25,34,-9,35,0,5
1,00:15:00,0,True,0,0,0,35,0,5
1,00:01:26,0,True,7,3,4,35,0,5
2,00:12:49,0,False,3,10,-7,35,0,5
3,00:15:00,0,False,3,10,-7,35,0,5
3,00:10:24,0,True,10,9,1,35,0,5
4,00:06:59,0,True,11,12,-1,35,0,5
4,00:05:34,0,True,11,15,-4,35,0,5
4,00:03:16,0,True,11,18,-7,35,0,5
4,00:00:11,0,True,13,18,-5,25,0,5
1,00:15:00,0,False,0,0,0,35,0,5
1,00:11:19,0,False,0,3,-3,35,0,5
1,00:05:30,0,False,0,10,-10,35,0,5
1,00:01:27,0,True,10,3,7,35,0,5
2,00:09:58,0,False,3,17,-14,35,0,5
3,00:15:00,0,True,20,3,17,35,0,5
3,00:08:55,0,False,3,27,-24,35,0,5
4,00:08:53,0,False,3,37,-34,35,0,5
1,00:15:00,0,False,0,0,0,35,0,5
2,00:10:43,0,False,3,7,-4,35,0,5
2,00:00:09,0,True,7,11,-4,35,0,5
3,00:15:00,0,False,11,7,4,35,0,5
4,00:09:01,0,False,14,17,-3,35,0,5
1,00:15:00,0,False,0,0,0,35,0,5
1,00:09:56,0,False,0,7,-7,35,0,5
1,00:08:30,0,False,0,14,-14,35,0,5
1,00:15:00,0,False,0,0,0,35,0,5
1,00:11:11,0,True,0,3,-3,35,0,5
1,00:07:06,0,False,3,3,0,35,0,5
2,00:14:00,0,True,3,10,-7,35,0,5
2,00:08:53,0,False,10,6,4,35,0,5
2,00:02:18,0,True,6,17,-11,50,0,5
2,00:01:01,0,False,17,13,4,35,0,5
3,00:15:00,0,True,13,24,-11,35,0,5
3,00:06:02,0,False,24,16,8,35,0,5
1,00:15:00,0,True,0,0,0,35,0,5
2,00:09:10,0,False,0,11,-11,35,0,5
3,00:15:00,0,False,6,11,-5,35,0,5
4,00:12:08,0,False,6,21,-15,35,0,5
4,00:07:01,0,True,21,9,12,35,0,5
4,00:00:19,0,True,29,15,14,35,0,5
1,00:15:00,0,False,0,0,0,35,0,5
2,00:06:43,0,True,7,4,3,35,0,5
3,00:15:00,0,True,16,4,12,18,0,5
3,00:11:08,0,False,4,23,-19,35,0,5
4,00:02:53,0,True,24,17,7,35,0,5
1,00:15:00,0,False,0,0,0,35,0,5
2,00:05:30,0,False,0,8,-8,35,0,5
2,00:02:35,0,True,8,3,5,35,0,5
3,00:15:00,0,True,15,3,12,35,0,5
3,00:09:15,0,False,3,22,-19,35,0,5
3,00:01:39,0,False,3,36,-33,35,0,5
4,00:12:36,0,False,3,43,-40,35,0,5
4,00:10:36,0,False,3,50,-47,35,0,5
4,00:02:14,0,True,50,11,39,35,0,5
4,00:00:40,0,True,50,17,33,35,0,5
1,00:15:00,0,True,0,0,0,35,0,5
1,00:11:13,0,False,0,7,-7,35,0,5
2,00:13:09,0,False,1,14,-13,35,0,5
2,00:08:42,0,False,1,22,-21,35,0,5
2,00:01:46,0,True,22,4,18,35,0,5
2,00:00:40,0,False,4,29,-25,35,0,5
3,00:15:00,0,False,4,29,-25,35,0,5
3,00:10:06,0,False,4,36,-32,35,0,5
4,00:02:18,0,False,18,43,-25,35,0,5
1,00:15:00,0,False,0,0,0,35,0,5
1,00:05:04,0,False,0,7,-7,35,0,5
2,00:14:01,0,False,0,14,-14,50,0,5
2,00:01:21,0,True,17,7,10,35,0,5
3,00:15:00,0,True,17,7,10,35,0,5
1,00:15:00,0,True,0,0,0,35,0,5
2,00:08:03,0,False,0,10,-10,35,0,5
2,00:06:20,0,False,0,17,-17,35,0,5
2,00:00:44,0,True,17,7,10,35,0,5
3,00:15:00,0,True,17,7,10,35,0,5
1,00:15:00,0,False,0,0,0,35,0,5
1,00:07:07,0,True,0,7,-7,35,0,5
1,00:01:51,0,False,7,3,4,35,0,5
2,00:10:52,0,False,7,10,-3,35,0,5
2,00:04:29,0,True,10,14,-4,35,0,5
2,00:00:26,0,False,14,20,-6,35,0,5
3,00:15:00,0,False,14,20,-6,35,0,5
3,00:05:49,0,False,14,27,-13,35,0,5
3,00:00:41,0,True,27,17,10,35,0,5
4,00:09:56,0,True,27,24,3,35,0,5
4,00:03:44,0,False,24,37,-13,35,0,5
1,00:15:00,0,False,0,0,0,35,0,5
1,00:05:54,0,False,0,7,-7,35,0,5
2,00:04:46,0,False,0,13,-13,35,0,5
3,00:14:46,0,True,20,0,20,35,0,5
3,00:14:31,0,False,0,27,-27,35,0,5
3,00:08:44,0,False,0,34,-34,35,0,5
4,00:09:57,0,False,7,37,-30,35,0,5
1,00:15:00,0,True,0,0,0,35,0,5
1,00:05:25,0,False,0,6,-6,35,0,5
2,00:00:30,0,True,6,12,-6,35,0,5
3,00:15:00,0,False,13,6,7,35,0,5
3,00:07:09,0,True,7,20,-13,35,0,5
3,00:05:00,0,False,20,14,6,35,0,5
3,00:00:39,0,True,14,27,-13,35,0,5
4,00:08:40,0,True,14,34,-20,35,0,5
4,00:05:15,0,False,34,20,14,35,0,5
1,00:15:00,0,True,0,0,0,35,0,5
1,00:08:31,0,False,0,3,-3,35,0,5
1,00:04:33,0,True,3,3,0,35,0,5
2,00:14:21,0,False,3,6,-3,35,0,5
2,00:01:52,0,True,6,6,0,35,0,5
3,00:15:00,0,False,6,6,0,35,0,5
3,00:12:14,0,False,6,9,-3,35,0,5
4,00:11:03,0,False,6,20,-14,35,0,5
1,00:15:00,0,True,0,0,0,35,0,5
1,00:15:00,0,True,0,0,0,35,0,5
2,00:02:29,0,False,4,3,1,35,0,5
3,00:15:00,0,False,12,3,9,35,0,5
1,00:15:00,0,True,0,0,0,35,0,5
1,00:10:48,0,False,0,7,-7,35,0,5
1,00:07:01,0,True,7,3,4,35,0,5
2,00:10:40,0,True,7,10,-3,35,0,5
2,00:05:35,0,True,7,20,-13,35,0,5
2,00:01:13,0,False,22,7,15,25,0,5
3,00:10:57,0,True,7,30,-23,35,0,5
1,00:15:00,0,False,0,0,0,35,0,5
1,00:13:25,0,True,0,7,-7,35,0,5
1,00:08:32,0,False,7,7,0,50,0,5
1,00:04:49,0,True,7,10,-3,35,0,5
2,00:12:32,0,True,7,13,-6,35,0,5
2,00:05:45,0,True,7,20,-13,35,0,5
3,00:15:00,0,True,7,20,-13,35,0,5
4,00:13:35,0,False,23,13,10,35,0,5
4,00:11:28,0,True,13,26,-13,35,0,5
1,00:15:00,0,True,0,0,0,35,0,5
1,00:11:50,0,False,0,6,-6,35,0,5
2,00:13:52,0,False,3,13,-10,35,0,5
2,00:10:59,0,True,13,10,3,20,0,5
3,00:15:00,0,False,13,19,-6,35,0,5
3,00:02:07,0,False,16,27,-11,35,0,5
4,00:13:46,0,True,27,23,4,35,0,5
4,00:08:52,0,False,23,30,-7,35,0,5
4,00:00:36,0,True,30,37,-7,35,0,5
1,00:15:00,0,True,0,0,0,35,0,5
1,00:11:06,0,False,0,6,-6,35,0,5
2,00:09:25,0,False,5,6,-1,25,0,5
2,00:05:26,0,False,5,13,-8,35,0,5
3,00:15:00,0,False,5,13,-8,35,0,5
3,00:07:57,0,True,13,13,0,30,0,5
4,00:10:06,0,True,16,20,-4,35,0,5
1,00:09:56,0,True,0,7,-7,35,0,5
1,00:05:13,0,False,7,7,0,35,0,5
2,00:10:19,0,True,9,15,-6,25,0,5
3,00:15:00,0,False,18,10,8,35,0,5
3,00:06:28,0,False,18,18,0,35,0,5
1,00:15:00,0,True,0,0,0,35,0,5
1,00:12:44,0,True,2,0,2,35,0,5
1,00:00:12,0,True,3,7,-4,20,0,5
2,00:15:00,0,False,7,10,-3,35,0,5
3,00:15:00,0,False,10,10,0,35,0,5
3,00:06:17,0,False,10,16,-6,35,0,5
1,00:15:00,0,True,0,0,0,35,0,5
1,00:00:47,0,True,0,7,-7,35,0,5
2,00:13:22,0,False,7,7,0,35,0,5
2,00:01:28,0,False,15,14,1,35,0,5
3,00:13:51,0,False,15,22,-7,40,0,5
1,00:11:31,0,True,1,3,-2,35,0,5
1,00:06:21,0,False,3,7,-4,35,0,5
1,00:01:22,0,True,7,10,-3,35,0,5
2,00:15:00,0,True,7,17,-10,35,0,5
2,00:10:41,0,True,7,24,-17,35,0,5
2,00:04:02,0,True,7,38,-31,50,0,5
3,00:15:00,0,True,13,38,-25,35,0,5
3,00:08:07,0,True,15,41,-26,25,0,5
3,00:01:08,0,True,18,49,-31,20,0,5
4,00:11:50,0,False,49,26,23,35,0,5
1,00:04:21,0,False,0,7,-7,35,0,5
2,00:02:02,0,False,0,16,-16,35,0,5
3,00:15:00,0,True,16,0,16,35,0,5
3,00:07:03,0,False,0,22,-22,35,0,5
4,00:09:55,0,True,25,11,14,35,0,5
1,00:15:00,0,True,0,0,0,35,0,5
2,00:07:27,0,True,0,6,-6,35,0,5
2,00:03:53,0,False,6,7,-1,35,0,5
3,00:15:00,0,False,7,10,-3,35,0,5
3,00:03:16,0,True,13,16,-3,30,0,5
4,00:14:37,0,False,16,20,-4,35,0,5
1,00:15:00,0,False,0,0,0,35,0,5
1,00:04:14,0,False,3,3,0,35,0,5
2,00:13:48,0,True,3,10,-7,35,0,5
2,00:00:08,0,False,10,17,-7,40,0,5
3,00:15:00,0,True,17,10,7,35,0,5
4,00:09:26,0,True,21,18,3,35,0,5
4,00:00:06,0,True,28,28,0,35,0,5
1,00:15:00,0,False,0,0,0,35,0,5
1,00:07:16,0,False,0,7,-7,35,0,5
1,00:03:52,0,False,0,14,-14,35,0,5
2,00:14:38,0,False,0,20,-20,35,0,5
2,00:10:07,0,False,0,26,-26,35,0,5
2,00:03:06,0,True,29,8,21,35,0,5
2,00:01:53,0,False,8,36,-28,35,0,5
3,00:15:00,0,True,36,11,25,35,0,5
3,00:06:35,0,False,14,43,-29,35,0,5
1,00:15:00,0,True,0,0,0,35,0,5
2,00:04:23,0,True,12,10,2,35,0,5
2,00:00:17,0,False,10,19,-9,35,0,5
3,00:15:00,0,False,10,19,-9,35,0,5
4,00:13:50,0,True,22,20,2,35,0,5
1,00:05:31,0,True,0,7,-7,35,0,5
3,00:15:00,0,True,6,7,-1,35,0,5
3,00:04:58,0,True,9,15,-6,35,0,5
4,00:13:01,0,True,12,22,-10,35,0,5
4,00:06:18,0,False,22,18,4,35,0,5
4,00:02:21,0,True,18,29,-11,35,0,5
4,00:01:38,0,False,29,26,3,35,0,5
1,00:15:00,0,False,0,0,0,35,0,5
2,00:07:53,0,False,7,6,1,35,0,5
2,00:02:39,0,False,7,21,-14,35,0,5
2,00:01:33,0,True,21,14,7,25,0,5
3,00:15:00,0,True,22,14,8,35,0,5
2,00:10:50,0,True,4,7,-3,35,0,5
3,00:07:16,0,False,10,14,-4,35,0,5
4,00:05:12,0,False,13,17,-4,35,0,5
1,00:15:00,0,False,0,0,0,35,0,5
1,00:12:07,0,False,2,0,2,25,0,5
3,00:15:00,0,True,3,8,-5,35,0,5
4,00:11:18,0,False,11,12,-1,35,0,5
4,00:09:24,0,True,12,17,-5,35,0,5
1,00:15:00,0,True,0,0,0,35,0,5
1,00:08:08,0,True,0,7,-7,35,0,5
3,00:09:23,0,False,17,11,6,35,0,5
4,00:14:28,0,True,11,27,-16,50,0,5
4,00:00:36,0,False,27,24,3,35,0,5
1,00:10:20,0,True,0,8,-8,35,0,5
1,00:00:49,0,False,16,8,8,35,0,5
3,00:15:00,0,False,16,16,0,35,0,5
3,00:02:14,0,False,16,23,-7,35,0,5
4,00:15:00,0,True,23,22,1,35,0,5
1,00:15:00,0,True,0,0,0,35,0,5
1,00:08:13,0,True,0,8,-8,35,0,5
1,00:00:06,0,False,11,8,3,35,0,5
2,00:11:24,0,True,8,19,-11,35,0,5
3,00:15:00,0,False,19,17,2,35,0,5
4,00:07:55,0,False,23,26,-3,35,0,5
1,00:15:00,0,True,0,0,0,35,0,5
1,00:06:11,0,False,0,7,-7,35,0,5
1,00:03:04,0,False,0,14,-14,35,0,5
2,00:14:04,0,False,0,21,-21,35,0,5
2,00:10:27,0,True,21,7,14,35,0,5
3,00:15:00,0,False,7,21,-14,35,0,5
4,00:03:21,0,True,24,27,-3,35,0,5
1,00:15:00,0,True,0,0,0,35,0,5
1,00:01:23,0,True,1,3,-2,35,0,5
2,00:10:04,0,False,3,4,-1,35,0,5
3,00:15:00,0,False,3,4,-1,35,0,5
3,00:06:33,0,False,3,11,-8,35,0,5
3,00:02:00,0,False,3,18,-15,35,0,5
4,00:08:31,0,False,3,25,-22,35,0,5
4,00:04:38,0,False,3,32,-29,35,0,5
1,00:15:00,0,False,0,0,0,35,0,5
1,00:07:43,0,False,0,3,-3,35,0,5
2,00:00:13,0,False,14,14,0,35,0,5
3,00:15:00,0,True,14,14,0,35,0,5
3,00:11:01,0,False,14,21,-7,35,0,5
4,00:06:45,0,True,21,28,-7,35,0,5
1,00:15:00,0,True,0,0,0,35,0,5
1,00:07:43,0,True,7,3,4,35,0,5
2,00:02:00,0,True,7,13,-6,35,0,5
3,00:15:00,0,False,14,10,4,35,0,5
4,00:08:11,0,True,31,25,6,33,0,23
4,00:05:28,2,False,0,44,-44,49,10,23
1,00:10:57,2,False,0,3,-3,48,8,23
1,00:07:44,0,True,0,0,0,30,0,23
4,00:00:01,3,True,17,23,-6,23,22,23
2,00:06:12,0,True,17,7,10,55,0,23
4,00:09:53,1,False,12,13,-1,1,10,23
2,00:11:02,1,False,0,0,0,11,10,23
4,00:00:06,0,False,34,27,7,6,0,23
1,00:11:08,3,False,0,0,0,31,4,17
1,00:06:09,3,True,0,0,0,32,8,17
1,00:01:46,3,False,0,0,0,26,10,17
3,00:10:33,3,True,3,14,-11,5,5,17
3,00:06:12,3,True,3,17,-14,35,12,17
3,00:03:33,3,False,17,3,14,30,16,17
1,00:06:32,2,True,7,0,7,26,8,17
1,00:00:15,3,True,7,3,4,24,10,17
2,00:08:55,3,True,7,13,-6,24,2,17
2,00:03:56,3,False,16,7,9,43,10,17
2,00:01:10,3,False,16,7,9,25,5,17
3,00:04:29,3,True,12,23,-11,7,7,17
4,00:09:39,3,True,22,16,6,27,19,17
1,00:08:35,3,True,0,0,0,32,1,17
2,00:12:16,3,True,7,10,-3,45,6,17
3,00:04:59,3,True,14,11,3,20,5,17
4,00:09:50,3,True,21,14,7,26,12,17
4,00:03:02,3,False,17,21,-4,30,7,17
3,00:05:40,3,False,18,21,-3,40,10,17
4,00:02:38,3,False,25,38,-13,16,3,17
1,00:05:51,3,False,0,0,0,31,4,17
2,00:00:00,1,True,17,14,3,40,10,17
3,00:04:47,3,True,17,17,0,29,26,17
3,00:01:20,3,True,17,20,-3,12,5,17
4,00:12:55,3,True,17,23,-6,3,3,17
4,00:09:59,3,False,26,17,9,24,14,17
4,00:01:13,3,True,27,26,1,39,4,17
1,00:08:18,3,False,0,7,-7,33,9,17
3,00:13:43,3,False,7,17,-10,7,2,17
3,00:09:08,3,False,7,20,-13,16,16,17
2,00:11:23,3,True,8,0,8,5,5,17
4,00:13:10,3,True,8,17,-9,7,1,17
2,00:05:24,3,True,9,7,2,19,19,17
4,00:04:50,3,True,17,17,0,29,2,17
2,00:04:55,3,True,8,7,1,35,3,17
3,00:07:44,3,True,9,10,-1,26,7,17
4,00:14:43,3,True,9,13,-4,40,2,17
4,00:08:56,3,False,16,9,7,7,7,17
4,00:06:05,3,True,12,16,-4,43,15,17
4,00:01:44,3,True,12,19,-7,35,11,17
1,00:08:48,3,False,0,0,0,22,12,17
2,00:14:21,3,True,3,2,1,3,3,17
2,00:03:28,3,True,17,5,12,36,7,17
2,00:00:00,3,True,17,5,12,11,11,17
3,00:07:53,3,False,8,31,-23,32,7,17
4,00:04:03,3,False,22,34,-12,32,4,17
1,00:03:05,3,False,1,7,-6,16,8,17
2,00:12:32,3,False,2,10,-8,34,17,17
2,00:01:58,3,True,13,2,11,12,4,17
2,00:00:01,3,False,5,13,-8,25,12,17
3,00:10:42,3,True,16,5,11,29,10,17
3,00:10:10,3,False,0,35,-35,34,13,17
3,00:05:26,3,False,0,38,-38,37,4,17
3,00:02:59,3,False,0,41,-41,39,4,17
1,00:08:40,3,True,0,0,0,6,6,17
2,00:14:50,3,True,7,3,4,7,7,17
2,00:10:44,3,True,7,6,1,22,10,17
2,00:02:33,3,False,9,7,2,31,16,17
2,00:00:21,3,True,10,9,1,43,18,17
1,00:05:46,3,True,7,0,7,30,10,17
2,00:02:09,3,True,7,11,-4,28,2,17
4,00:11:02,3,False,21,23,-2,40,9,17
4,00:02:20,3,True,23,21,2,22,3,17
1,00:10:21,3,True,0,7,-7,40,10,17
1,00:08:28,3,False,7,0,7,8,1,17
1,00:01:08,3,False,8,3,5,22,4,17
3,00:04:33,3,False,22,13,9,36,3,17
4,00:13:27,3,False,22,16,6,17,10,17
4,00:03:45,3,True,19,22,-3,30,16,17
2,00:00:00,1,True,8,14,-6,5,5,17
3,00:04:59,3,True,15,17,-2,3,3,17
1,00:04:21,3,False,0,7,-7,18,18,17
2,00:01:54,3,True,17,0,17,10,5,17
4,00:09:37,3,True,25,4,21,15,10,17
1,00:07:43,3,False,14,0,14,28,6,17
2,00:09:55,3,True,11,14,-3,29,21,17
2,00:08:07,3,True,11,17,-6,27,3,17
2,00:00:00,2,True,13,20,-7,2,2,17
3,00:07:38,3,False,23,27,-4,16,6,17
3,00:01:45,3,False,24,30,-6,41,15,17
4,00:04:28,3,True,33,31,2,27,5,17
4,00:01:41,3,True,33,34,-1,29,9,17
1,00:06:33,3,True,0,8,-8,41,17,17
1,00:00:00,3,False,11,0,11,26,10,17
2,00:13:10,3,False,11,3,8,14,11,17
2,00:03:10,3,False,11,10,1,12,10,17
3,00:07:47,3,False,12,20,-8,2,2,17
4,00:14:42,3,True,23,12,11,27,9,17
2,00:08:47,3,True,15,21,-6,14,10,17
2,00:03:12,3,False,24,22,2,37,5,17
3,00:12:13,3,True,25,31,-6,33,8,17
3,00:05:09,3,True,32,34,-2,27,7,17
1,00:08:51,3,False,0,2,-2,16,10,17
2,00:09:31,3,False,0,5,-5,36,7,17
4,00:10:26,3,True,38,21,17,32,15,17
4,00:06:14,3,False,24,38,-14,32,1,17
4,00:02:16,3,False,24,41,-17,20,2,17
2,00:14:43,3,False,0,14,-14,20,19,17
2,00:10:36,3,False,0,17,-17,25,2,17
2,00:06:53,3,True,20,0,20,15,15,17
3,00:02:16,3,True,27,11,16,28,4,17
4,00:13:20,3,True,27,14,13,39,6,17
4,00:02:33,3,False,24,27,-3,27,9,17
4,00:00:23,3,True,27,24,3,10,10,17
3,00:07:49,3,False,36,1,35,33,10,17
4,00:13:28,3,True,6,36,-30,17,9,17
4,00:01:31,3,False,39,12,27,30,10,17
4,00:00:05,1,False,39,15,24,21,15,17
1,00:08:22,3,False,0,0,0,8,8,17
1,00:05:19,3,True,3,0,3,21,6,17
2,00:02:08,3,False,8,3,5,35,4,17
4,00:00:17,3,True,11,16,-5,20,7,17
2,00:14:26,3,False,0,7,-7,16,15,17
2,00:09:02,3,False,0,10,-10,26,8,17
2,00:04:54,3,True,13,0,13,35,7,17
3,00:05:17,3,False,3,14,-11,17,12,17
3,00:00:07,3,True,17,3,14,5,5,17
4,00:12:13,3,True,17,6,11,30,2,17
1,00:06:13,3,False,7,0,7,9,7,17
2,00:01:45,3,False,14,11,3,29,15,17
3,00:11:40,3,False,21,14,7,31,2,17
3,00:05:25,3,False,21,17,4,21,10,17
1,00:13:13,3,False,0,0,0,35,5,17
2,00:06:07,3,False,16,7,9,32,10,17
2,00:01:15,3,False,16,10,6,19,3,17
1,00:05:46,3,False,0,0,0,18,10,17
2,00:02:25,3,True,10,7,3,25,10,17
2,00:00:00,1,False,10,10,0,33,10,17
3,00:03:21,3,True,13,16,-3,36,4,17
4,00:05:57,3,False,19,22,-3,27,5,17
4,00:01:35,3,False,19,25,-6,18,11,17
1,00:11:13,3,False,0,0,0,37,3,17
2,00:00:00,1,False,21,11,10,37,10,17
4,00:12:46,3,True,14,29,-15,14,14,17
1,00:07:51,3,False,7,0,7,45,7,17
3,00:03:42,3,True,25,22,3,33,3,17
1,00:00:33,3,True,7,0,7,13,6,17
2,00:10:01,3,True,7,3,4,15,3,17
3,00:08:54,3,True,7,13,-6,11,11,17
3,00:01:28,3,True,7,16,-9,32,6,17
4,00:00:47,3,True,14,19,-5,31,2,17
1,00:03:22,3,False,15,7,8,32,10,17
2,00:05:36,3,True,7,15,-8,27,9,17
4,00:10:09,3,True,14,47,-33,5,3,17
4,00:05:49,3,False,50,14,36,23,10,17
4,00:01:27,3,True,17,50,-33,30,10,17
2,00:07:20,3,True,9,6,3,33,1,17
2,00:00:44,3,False,13,9,4,17,9,17
3,00:05:35,3,False,13,14,-1,17,3,17
1,00:03:58,3,False,0,0,0,24,4,17
1,00:12:40,3,False,0,0,0,41,10,17
2,00:01:41,3,True,1,14,-13,34,5,17
2,00:00:32,3,False,17,1,16,20,4,17
3,00:09:11,3,True,4,17,-13,37,4,17
1,00:12:09,3,False,0,0,0,27,3,17
2,00:14:50,3,False,7,3,4,24,13,17
3,00:05:19,3,True,6,28,-22,23,5,17
4,00:14:49,3,False,31,6,25,15,10,17
4,00:10:47,3,True,9,32,-23,33,6,17
4,00:05:26,3,True,9,32,-23,17,10,17
1,00:08:42,3,False,0,0,0,24,4,17
2,00:00:02,3,False,3,1,2,25,2,17
4,00:08:42,3,False,11,11,0,33,3,17
4,00:02:28,3,False,12,14,-2,12,7,17
1,00:06:03,3,True,0,7,-7,35,11,17
2,00:09:47,3,False,24,0,24,20,10,17
2,00:01:32,3,False,24,10,14,33,3,17
3,00:10:17,3,False,24,19,5,21,11,17
4,00:09:50,3,True,35,24,11,19,5,17
4,00:04:06,3,False,27,35,-8,12,2,17
1,00:05:17,3,True,0,0,0,40,3,17
2,00:12:56,3,False,3,0,3,29,10,17
4,00:14:45,3,True,24,10,14,8,3,17
1,00:10:27,3,True,0,0,0,5,5,17
2,00:03:04,3,True,2,3,-1,25,15,17
2,00:01:07,3,False,6,2,4,28,5,17
3,00:08:37,3,False,6,9,-3,8,8,17
4,00:13:51,3,False,21,12,9,30,2,17
4,00:09:56,3,False,21,12,9,40,10,17
4,00:00:00,2,True,22,21,1,35,10,17
2,00:14:30,3,False,0,0,0,6,6,17
2,00:07:10,3,False,0,3,-3,40,2,17
2,00:00:00,3,False,0,13,-13,8,3,17
1,00:10:02,3,False,0,0,0,25,5,17
1,00:07:46,3,True,3,0,3,19,10,17
2,00:09:24,3,False,3,10,-7,24,12,17
2,00:06:09,3,True,13,3,10,11,2,17
3,00:03:39,3,False,13,20,-7,16,6,17
4,00:13:42,3,False,13,23,-10,16,10,17
4,00:04:12,3,False,27,26,1,7,6,17
4,00:01:00,3,False,27,29,-2,1,1,17
2,00:07:20,3,True,14,8,6,30,10,17
2,00:01:22,3,True,14,11,3,12,8,17
2,00:00:00,2,True,14,14,0,19,4,17
3,00:02:45,3,True,14,24,-10,26,2,17
4,00:14:46,3,False,27,14,13,34,10,17
4,00:04:16,3,True,17,34,-17,16,3,17
1,00:11:37,3,False,0,0,0,8,3,17
1,00:01:48,3,True,10,0,10,10,8,17
3,00:11:23,3,True,17,26,-9,10,8,17
3,00:02:20,3,True,17,29,-12,5,5,17
4,00:14:45,3,False,32,17,15,29,2,17
1,00:07:48,3,True,0,0,0,3,3,17
2,00:08:33,3,True,7,3,4,10,3,17
3,00:08:06,3,True,14,6,8,9,8,17
3,00:00:00,3,True,21,9,12,3,3,17
4,00:10:29,3,False,12,21,-9,13,5,17
2,00:13:39,3,True,8,1,7,21,14,17
2,00:01:33,3,False,1,15,-14,38,9,17
3,00:05:13,3,True,22,1,21,43,13,17
1,00:08:55,3,False,0,0,0,18,15,17
1,00:03:47,3,True,3,0,3,9,5,17
2,00:11:12,3,False,3,3,0,31,5,17
3,00:05:16,3,True,8,17,-9,31,17,17
4,00:01:55,3,True,22,27,-5,20,9,17
2,00:14:45,3,False,8,0,8,27,1,17
2,00:00:32,3,False,22,3,19,32,7,17
3,00:10:05,3,False,22,6,16,2,2,17
4,00:10:55,3,False,23,16,7,35,2,17
4,00:01:16,3,True,19,30,-11,22,4,17
1,00:11:16,3,False,0,0,0,19,19,17
3,00:02:11,3,False,17,17,0,39,11,17
4,00:04:41,3,True,26,17,9,32,2,17
1,00:05:35,3,False,0,0,0,27,10,17
4,00:06:27,3,True,10,25,-15,38,3,17
4,00:00:30,3,True,17,28,-11,26,8,17
1,00:04:03,3,False,14,0,14,41,6,17
2,00:00:32,3,True,0,28,-28,36,7,17
2,00:00:00,1,False,31,0,31,41,10,17
4,00:08:31,3,False,32,10,22,8,8,17
4,00:03:35,3,True,13,32,-19,28,5,17
4,00:00:31,3,True,13,35,-22,29,6,17
2,00:13:51,3,False,0,13,-13,20,3,17
2,00:00:00,1,False,7,23,-16,23,10,17
3,00:12:05,3,True,26,7,19,21,6,17
3,00:00:42,3,True,26,17,9,6,5,17
1,00:12:34,3,False,0,0,0,41,8,17
1,00:00:00,3,False,14,0,14,17,10,17
2,00:03:44,3,True,3,21,-18,29,6,17
1,00:11:25,3,True,0,0,0,34,13,17
3,00:06:02,3,True,7,17,-10,30,10,17
4,00:11:44,3,False,24,8,16,11,10,17
4,00:07:49,3,True,11,24,-13,39,10,17
4,00:00:00,3,True,18,34,-16,20,1,17
1,00:09:41,3,False,0,0,0,28,10,17
1,00:04:38,3,True,10,0,10,8,8,17
3,00:09:04,3,False,4,25,-21,7,6,17
4,00:12:34,3,False,11,35,-24,39,6,17
1,00:09:02,3,True,0,0,0,8,8,17
2,00:05:46,3,True,8,4,4,3,3,17
3,00:12:49,3,True,8,7,1,17,10,17
4,00:14:28,3,False,11,11,0,18,18,17
4,00:10:37,3,True,14,11,3,31,6,17
1,00:11:46,3,False,0,0,0,5,5,17
1,00:00:39,3,False,0,10,-10,38,9,17
2,00:13:27,3,True,13,0,13,6,6,17
2,00:11:08,3,False,3,13,-10,36,9,17
2,00:03:01,3,False,4,16,-12,13,9,17
2,00:01:07,3,False,11,19,-8,36,2,17
3,00:03:40,3,True,21,16,5,24,4,17
4,00:12:26,3,False,19,21,-2,16,8,17
4,00:03:55,3,True,24,19,5,23,10,17
1,00:06:55,3,True,0,0,0,40,12,17
3,00:02:50,3,True,14,4,10,42,7,17
1,00:08:15,3,True,7,0,7,9,9,17
1,00:01:50,3,True,7,3,4,32,4,17
2,00:13:36,3,True,7,6,1,33,2,17
2,00:00:12,3,False,16,14,2,13,13,17
4,00:13:44,3,False,16,33,-17,38,10,17
4,00:02:10,3,True,33,23,10,23,3,17
4,00:01:05,3,False,26,33,-7,19,5,17
1,00:10:36,3,True,0,0,0,9,9,17
2,00:01:29,3,False,10,14,-4,12,10,17
3,00:10:20,3,False,17,17,0,4,4,17
3,00:01:54,3,False,24,20,4,41,8,17
4,00:11:05,3,False,24,23,1,15,10,17
4,00:00:23,3,True,27,31,-4,26,5,17
1,00:08:14,3,True,0,0,0,38,2,17
2,00:06:42,3,True,0,12,-12,32,9,17
2,00:00:37,3,True,7,15,-8,37,7,17
2,00:00:00,3,True,7,18,-11,17,5,17
3,00:11:39,3,False,21,14,7,38,11,17
3,00:02:42,3,False,28,21,7,35,9,17
4,00:13:08,3,False,28,24,4,23,7,17
4,00:09:02,3,True,27,28,-1,26,15,17
4,00:03:41,3,False,38,33,5,27,10,17
4,00:00:00,1,False,38,36,2,7,7,17
2,00:13:07,3,True,7,4,3,3,3,17
4,00:01:40,3,True,14,29,-15,14,11,17
4,00:00:15,3,True,14,32,-18,35,10,17
3,00:00:14,3,True,24,8,16,11,11,17
1,00:05:27,3,False,0,7,-7,33,3,17
2,00:02:06,3,True,24,0,24,25,12,17
2,00:00:03,3,True,24,3,21,6,3,17
4,00:14:23,3,False,7,24,-17,3,3,17
4,00:07:23,3,False,14,27,-13,37,10,17
4,00:00:39,3,False,14,34,-20,35,10,17
1,00:12:13,3,False,0,0,0,39,6,17
1,00:09:32,3,True,3,0,3,20,1,17
2,00:14:11,3,True,3,3,0,29,10,17
2,00:02:48,3,True,10,6,4,36,16,17
2,00:00:40,3,True,10,9,1,16,3,17
3,00:10:47,3,True,10,12,-2,29,1,17
4,00:10:43,3,False,22,24,-2,35,10,17
1,00:03:08,3,True,0,0,0,20,5,17
2,00:11:56,3,False,3,0,3,40,6,17
2,00:04:07,3,True,3,10,-7,25,3,17
4,00:12:38,3,True,10,20,-10,4,4,17
4,00:08:52,3,False,23,10,13,26,12,17
4,00:02:03,3,False,24,13,11,25,16,17
4,00:00:42,3,True,13,24,-11,27,1,17
1,00:11:39,3,False,0,0,0,6,6,17
1,00:09:08,3,True,3,0,3,30,10,17
2,00:03:29,3,True,3,17,-14,16,10,17
2,00:00:00,1,True,3,20,-17,30,10,17
4,00:02:05,3,False,23,17,6,13,10,17
4,00:01:06,3,True,20,23,-3,26,6,17
1,00:02:47,3,False,7,0,7,22,4,17
2,00:13:50,3,False,7,10,-3,7,7,17
2,00:00:15,3,False,7,28,-21,8,8,17
4,00:01:30,3,False,14,32,-18,31,4,17
2,00:12:39,3,True,14,0,14,19,10,17
2,00:02:39,3,False,3,21,-18,25,8,17
3,00:09:09,3,False,3,31,-28,18,14,17
1,00:05:02,3,False,0,7,-7,29,1,17
2,00:13:16,3,False,7,10,-3,33,3,17
2,00:08:47,3,True,13,7,6,40,5,17
3,00:05:32,3,False,17,21,-4,36,5,17
3,00:02:15,3,False,17,24,-7,13,10,17
3,00:00:01,3,True,27,17,10,10,10,17
1,00:07:42,3,True,0,7,-7,16,16,17
2,00:01:44,3,True,8,12,-4,7,4,17
2,00:01:05,3,False,16,0,16,15,1,17
4,00:08:08,3,False,23,17,6,19,4,17
4,00:04:04,3,True,20,23,-3,35,9,17
1,00:11:28,3,True,0,0,0,16,7,17
1,00:03:12,3,False,3,0,3,9,3,17
2,00:07:29,3,True,10,3,7,13,13,17
2,00:01:17,3,True,10,6,4,25,12,17
3,00:13:36,3,False,15,10,5,27,6,17
3,00:01:57,3,True,19,15,4,29,16,17
4,00:10:25,3,False,18,19,-1,35,3,17
1,00:06:01,3,False,0,7,-7,21,8,17
1,00:01:42,3,False,0,7,-7,35,10,17
1,00:09:10,3,True,0,0,0,39,15,17
2,00:08:37,3,False,4,7,-3,38,9,17
3,00:03:21,3,True,17,4,13,14,10,17
4,00:11:22,3,False,7,17,-10,37,2,17
4,00:06:19,3,False,7,20,-13,9,9,17
4,00:00:35,3,False,7,23,-16,15,3,17
1,00:07:58,3,False,0,0,0,26,2,17
1,00:01:16,3,True,3,0,3,21,1,17
2,00:12:05,3,False,3,3,0,16,12,17
3,00:12:35,3,True,6,17,-11,11,6,17
4,00:13:31,3,True,6,27,-21,15,7,17
1,00:07:25,3,True,0,0,0,18,10,17
1,00:01:13,3,False,10,0,10,16,10,17
2,00:02:30,3,True,10,10,0,33,8,17
3,00:08:00,3,False,13,10,3,4,4,17
3,00:04:12,3,True,13,13,0,18,1,17
4,00:10:25,3,False,23,20,3,15,5,17
4,00:03:24,3,False,23,23,0,1,1,17
2,00:12:32,3,True,0,2,-2,20,7,17
3,00:13:31,3,False,2,0,2,41,10,17
3,00:11:45,3,False,2,0,2,22,10,17
3,00:06:57,3,False,2,3,-1,28,7,17
4,00:00:00,2,True,13,10,3,25,10,17
5,00:15:00,3,True,13,13,0,27,2,17
1,00:09:14,3,False,0,0,0,31,3,17
1,00:02:50,3,False,0,0,0,33,23,17
2,00:13:06,3,False,7,3,4,22,6,17
2,00:01:13,3,True,13,14,-1,21,3,17
2,00:00:00,1,False,17,13,4,3,5,17
4,00:04:57,3,False,25,23,2,38,8,17
4,00:00:28,3,False,25,26,-1,21,5,17
1,00:06:43,3,False,0,0,0,6,6,17
1,00:00:15,3,False,7,3,4,24,6,17
4,00:07:23,3,True,13,22,-9,5,2,17
4,00:02:59,3,True,13,25,-12,32,10,17
1,00:11:36,3,True,0,0,0,9,9,17
2,00:02:40,3,False,10,21,-11,21,5,17
3,00:00:00,3,True,24,24,0,16,5,17
4,00:01:24,3,True,24,27,-3,14,8,17
1,00:09:44,3,True,0,0,0,38,4,17
2,00:12:46,3,False,3,7,-4,12,8,17
2,00:02:47,3,True,24,3,21,17,10,17
4,00:14:48,3,True,31,13,18,26,10,17
1,00:08:48,3,False,0,0,0,36,5,17
2,00:02:54,3,False,14,10,4,41,2,17
3,00:05:50,3,True,13,14,-1,34,9,17
3,00:00:22,3,True,13,14,-1,7,7,17
4,00:09:17,3,False,17,13,4,33,13,17
1,00:02:26,3,True,7,0,7,29,4,17
2,00:00:00,3,False,4,7,-3,4,1,17
3,00:00:58,3,False,4,11,-7,29,14,17
4,00:00:08,3,True,11,11,0,31,16,17
2,00:04:40,3,True,7,7,0,36,3,17
2,00:00:35,3,False,17,7,10,29,2,17
3,00:12:08,3,True,7,17,-10,34,10,17
4,00:12:43,3,True,21,20,1,19,14,17
1,00:03:51,3,False,0,7,-7,37,4,17
2,00:14:13,3,False,7,10,-3,27,10,17
2,00:02:54,3,True,10,14,-4,41,6,17
2,00:11:38,3,True,14,0,14,26,17,17
2,00:06:38,3,False,3,14,-11,34,18,17
2,00:00:27,3,True,17,4,13,35,5,17
3,00:09:59,3,True,17,7,10,7,7,17
4,00:14:03,3,False,17,17,0,33,5,17
4,00:07:25,3,True,17,17,0,18,10,17
4,00:01:34,3,False,20,17,3,34,10,17
4,00:00:00,2,False,20,20,0,35,15,17
1,00:08:31,3,True,0,0,0,32,3,17
2,00:14:38,3,True,14,3,11,17,17,17
4,00:10:28,3,True,35,13,22,41,21,17
4,00:02:19,3,False,23,35,-12,7,2,17
4,00:00:55,3,False,23,38,-15,33,7,17
1,00:00:32,3,False,7,1,6,26,9,17
2,00:01:22,3,False,15,4,11,20,9,17
3,00:06:03,3,False,23,7,16,12,9,17
4,00:12:45,3,True,10,23,-13,14,10,17
4,00:13:35,3,False,16,14,2,21,1,17
4,00:00:13,3,True,14,16,-2,25,10,17
1,00:01:22,3,False,0,14,-14,10,10,17
2,00:09:54,3,True,18,0,18,17,4,17
2,00:02:49,3,False,10,18,-8,34,2,17
2,00:01:04,3,False,10,21,-11,33,9,17
2,00:00:00,2,True,21,10,11,40,3,17
3,00:10:09,3,False,13,21,-8,35,5,17
4,00:14:35,3,False,13,31,-18,39,4,17
4,00:10:37,3,False,13,34,-21,19,7,17
4,00:02:48,3,False,13,37,-24,30,2,17
1,00:00:00,3,False,0,14,-14,1,1,17
1,00:02:49,3,False,0,1,-1,31,2,17
3,00:10:28,3,False,0,11,-11,19,11,17
2,00:12:13,3,True,14,7,7,7,7,17
2,00:07:29,3,True,14,10,4,35,17,17
2,00:00:43,3,False,13,14,-1,9,9,17
4,00:03:21,3,False,27,17,10,39,3,17
1,00:11:12,3,False,0,0,0,28,6,17
2,00:01:04,3,False,1,21,-20,14,5,17
2,00:00:00,2,False,21,14,7,40,10,17
3,00:10:37,3,False,21,17,4,9,9,17
3,00:00:45,3,True,20,22,-2,37,8,17
4,00:11:08,3,True,20,25,-5,12,6,17
4,00:00:30,3,False,28,33,-5,30,10,17
2,00:14:20,3,False,0,14,-14,38,1,17
2,00:03:07,3,False,0,14,-14,27,10,17
2,00:00:14,3,False,0,17,-17,20,1,17
3,00:09:19,3,True,20,0,20,16,10,17
4,00:02:34,3,False,3,21,-18,41,7,17
2,00:02:30,3,True,10,7,3,15,8,17
3,00:06:55,3,False,17,10,7,25,6,17
4,00:01:30,3,False,24,22,2,36,8,17
4,00:00:48,3,False,24,25,-1,8,1,17
2,00:14:34,3,False,0,7,-7,12,10,17
4,00:14:40,3,False,15,25,-10,33,3,17
1,00:11:46,3,True,0,0,0,9,6,17
2,00:14:47,3,False,10,7,3,18,10,17
2,00:01:53,3,False,16,10,6,32,2,17
2,00:00:00,1,True,13,16,-3,16,15,17
3,00:05:54,3,True,20,19,1,20,5,17
3,00:02:16,3,False,22,20,2,30,17,17
4,00:02:18,3,False,28,30,-2,15,10,17
4,00:05:36,3,True,25,8,17,26,13,17
1,00:12:34,3,False,0,0,0,37,2,17
1,00:09:58,3,True,3,0,3,29,2,17
1,00:04:50,3,False,3,3,0,14,9,17
2,00:10:43,3,False,10,6,4,27,7,17
2,00:00:47,3,False,17,6,11,4,3,17
2,00:00:06,2,True,9,17,-8,38,9,17
3,00:08:02,3,False,24,9,15,15,7,17
3,00:02:51,3,False,31,12,19,44,8,17
4,00:09:53,3,True,15,31,-16,5,5,17
1,00:02:19,3,True,0,1,-1,8,8,17
2,00:10:50,3,False,11,0,11,11,3,17
2,00:06:51,3,False,11,3,8,3,3,17
2,00:00:00,1,True,13,11,2,34,10,17
3,00:04:09,3,True,13,14,-1,33,1,17
4,00:11:14,3,True,13,16,-3,23,7,17
2,00:07:25,3,True,0,7,-7,2,2,17
2,00:02:46,3,True,0,10,-10,6,6,17
2,00:01:07,3,False,13,0,13,15,15,17
4,00:06:56,3,True,3,20,-17,31,14,17
4,00:02:38,3,True,3,23,-20,28,11,17
1,00:09:47,3,True,0,0,0,29,10,17
1,00:04:20,3,False,3,0,3,19,8,17
2,00:08:36,3,False,4,3,1,22,10,17
2,00:06:41,3,True,6,4,2,33,13,17
2,00:00:04,3,False,7,6,1,15,10,17
3,00:02:31,3,False,7,9,-2,24,5,17
4,00:05:07,3,False,14,12,2,40,3,17
4,00:01:33,3,True,15,14,1,39,10,17
4,00:00:28,3,False,17,15,2,15,4,17
1,00:02:05,3,True,0,1,-1,35,11,17
2,00:00:58,3,False,4,7,-3,41,7,17
3,00:02:48,3,True,7,4,3,22,15,17
4,00:15:00,3,True,7,7,0,37,3,17
4,00:06:44,3,False,7,7,0,32,2,17
1,00:11:45,3,False,0,0,0,23,10,17
1,00:04:13,3,True,10,0,10,35,10,17
2,00:03:48,3,False,3,10,-7,8,8,17
1,00:12:43,3,True,0,0,0,29,12,17
1,00:10:10,3,False,3,0,3,24,2,17
2,00:02:50,3,True,10,10,0,29,5,17
2,00:01:10,3,False,13,10,3,33,7,17
3,00:01:16,3,True,20,20,0,22,15,17
4,00:08:55,3,True,20,23,-3,23,10,17
1,00:08:35,2,False,0,0,0,12,14,17
1,00:02:16,3,True,0,3,-3,20,2,17
2,00:10:12,3,True,0,6,-6,26,9,17
2,00:03:23,3,False,9,0,9,3,3,17
2,00:00:00,1,False,9,3,6,11,10,17
3,00:09:21,3,True,6,9,-3,44,12,17
3,00:00:37,3,True,6,20,-14,42,8,17
2,00:06:36,3,True,14,14,0,3,3,17
2,00:01:56,3,False,17,14,3,4,4,17
2,00:00:00,3,False,17,17,0,29,2,17
3,00:09:10,3,True,20,17,3,30,3,17
3,00:06:09,3,False,20,20,0,10,10,17
4,00:10:19,3,True,23,20,3,17,17,17
4,00:00:55,3,False,23,30,-7,25,7,17
1,00:04:40,3,True,14,0,14,10,9,17
1,00:01:40,3,True,14,3,11,9,3,17
3,00:08:22,3,False,6,28,-22,32,2,17
3,00:01:53,3,True,31,6,25,33,20,17
4,00:12:08,3,False,9,31,-22,31,6,17
4,00:08:04,3,False,9,34,-25,36,6,17
1,00:10:09,3,True,0,0,0,12,6,17
1,00:03:32,3,True,0,3,-3,18,4,17
2,00:13:55,3,False,6,0,6,25,5,17
1,00:06:59,3,False,0,1,-1,42,15,17
1,00:04:36,3,True,4,0,4,31,13,17
1,00:00:00,3,True,4,0,4,23,6,17
2,00:02:32,3,True,5,3,2,41,10,17
4,00:01:45,3,True,5,21,-16,35,2,17
2,00:08:24,3,True,7,7,0,37,2,17
3,00:03:14,3,True,21,10,11,14,10,17
4,00:05:58,3,False,19,21,-2,28,3,17
1,00:08:07,3,True,0,7,-7,8,3,17
2,00:14:42,3,False,24,0,24,24,10,17
2,00:01:40,3,False,32,7,25,39,6,17
3,00:06:36,3,True,7,32,-25,27,21,17
4,00:07:49,3,True,7,35,-28,35,17,17
1,00:07:46,3,True,0,0,0,35,13,17
1,00:01:12,3,False,3,0,3,34,17,17
2,00:03:01,3,True,10,3,7,41,8,17
4,00:14:45,3,True,10,10,0,3,3,17
4,00:07:19,3,True,11,13,-2,33,4,17
1,00:06:14,3,True,1,7,-6,22,12,17
1,00:00:42,3,False,10,2,8,23,10,17
2,00:11:16,3,False,10,5,5,25,22,17
2,00:07:48,3,True,8,17,-9,27,3,17
2,00:00:21,3,True,8,27,-19,35,3,17
3,00:05:15,3,False,30,8,22,20,10,17
4,00:11:33,3,False,30,11,19,22,10,17
4,00:03:46,3,False,30,14,16,25,10,17
4,00:01:15,3,True,17,30,-13,35,5,17
1,00:11:14,3,False,0,0,0,19,9,17
1,00:05:13,3,True,10,0,10,6,4,17
2,00:12:04,3,True,17,3,14,24,24,17
2,00:02:30,3,True,17,13,4,24,4,17
2,00:00:27,3,True,17,16,1,30,13,17
3,00:10:06,3,False,19,17,2,39,4,17
4,00:08:37,3,False,26,27,-1,25,10,17
4,00:06:36,3,True,30,26,4,32,10,17
4,00:02:32,3,False,29,30,-1,13,13,17
4,00:00:04,3,False,29,33,-4,34,6,17
3,00:08:49,3,False,7,28,-21,5,5,17
4,00:14:03,3,True,32,14,18,24,3,17
4,00:09:35,3,False,17,32,-15,33,1,17
4,00:06:06,3,False,17,35,-18,21,2,17
4,00:08:19,3,False,21,28,-7,11,7,17
1,00:01:49,3,False,0,1,-1,10,10,17
2,00:12:29,3,False,1,4,-3,12,2,17
2,00:09:00,3,True,7,1,6,32,14,17
2,00:00:12,3,True,8,4,4,43,5,17
3,00:03:35,3,True,8,4,4,20,4,17
4,00:00:20,3,True,8,7,1,19,3,17
1,00:01:29,3,True,7,7,0,12,4,17
2,00:04:44,3,False,10,7,3,40,4,17
3,00:06:15,3,True,7,17,-10,32,18,17
3,00:03:17,3,False,20,7,13,45,5,17
4,00:09:49,3,True,17,20,-3,31,6,17
4,00:05:49,3,False,23,17,6,25,6,17
1,00:09:47,3,True,0,0,0,36,11,17
2,00:09:31,3,False,1,1,0,23,10,17
2,00:05:43,3,True,4,1,3,38,6,17
4,00:03:34,3,False,4,12,-8,32,19,17
4,00:00:12,3,False,11,13,-2,24,1,17
1,00:03:52,3,True,0,7,-7,23,10,17
2,00:11:00,3,False,10,0,10,25,11,17
2,00:07:14,3,False,10,3,7,26,10,17
2,00:02:05,3,True,6,10,-4,21,10,17
2,00:00:00,1,False,13,6,7,40,10,17
4,00:12:09,3,True,17,13,4,25,10,17
4,00:09:30,3,True,17,16,1,20,8,17
2,00:05:53,3,True,1,0,1,30,21,17
2,00:03:00,3,True,1,3,-2,16,14,17
2,00:00:00,3,True,1,3,-2,6,4,17
3,00:11:23,3,False,6,8,-2,14,10,17
4,00:13:00,3,False,13,8,5,15,10,17
4,00:09:12,3,False,13,11,2,17,11,17
4,00:04:18,3,True,14,13,1,14,5,17
4,00:00:53,3,False,16,21,-5,9,9,17
2,00:07:44,3,False,7,14,-7,42,15,17
2,00:00:00,2,True,31,7,24,29,8,17
3,00:11:14,3,True,31,10,21,15,8,17
3,00:07:17,3,True,31,13,18,35,10,17
4,00:09:11,3,False,24,31,-7,18,8,17
4,00:01:44,3,True,34,24,10,38,4,17
3,00:03:33,3,True,7,8,-1,25,9,17
4,00:11:00,3,True,7,11,-4,34,10,17
1,00:12:33,3,False,0,0,0,30,1,17
2,00:14:46,3,True,10,0,10,34,4,17
2,00:05:35,3,False,3,10,-7,8,7,17
2,00:02:31,3,True,13,3,10,5,5,17
2,00:00:00,2,True,13,6,7,38,20,17
3,00:12:16,3,False,9,13,-4,13,6,17
3,00:09:16,3,True,16,9,7,41,12,17
1,00:11:44,3,True,0,0,0,22,17,17
3,00:03:14,3,False,3,9,-6,14,10,17
2,00:14:18,3,False,7,0,7,41,6,17
2,00:01:02,3,False,7,11,-4,10,10,17
4,00:11:26,3,True,21,21,0,26,14,17
4,00:07:48,3,True,21,24,-3,39,5,17
4,00:02:58,3,True,28,27,1,34,1,17
1,00:13:35,3,False,0,0,0,21,5,17
2,00:02:43,3,False,3,10,-7,16,10,17
4,00:03:24,3,False,12,13,-1,46,2,17
2,00:02:59,3,True,15,7,8,7,7,17
3,00:10:28,3,False,10,15,-5,40,9,17
4,00:04:37,3,True,25,10,15,37,17,17
4,00:02:21,3,False,13,25,-12,26,5,17
1,00:12:43,3,False,0,0,0,27,3,17
2,00:09:22,3,True,3,0,3,42,13,17
2,00:00:00,1,True,5,3,2,26,10,17
1,00:06:20,3,True,0,0,0,34,10,17
2,00:00:00,3,False,17,7,10,18,9,17
4,00:13:27,3,False,31,10,21,13,5,17
4,00:07:00,3,True,13,31,-18,28,5,17
1,00:07:20,3,True,7,0,7,40,2,17
2,00:02:03,3,True,7,17,-10,5,5,17
3,00:12:57,3,False,21,7,14,28,4,17
3,00:08:12,3,True,10,21,-11,16,10,17
2,00:04:37,3,True,8,10,-2,28,5,17
3,00:06:02,3,True,15,27,-12,28,2,17
1,00:00:00,3,False,0,2,-2,32,1,17
2,00:11:06,3,True,5,0,5,32,2,17
2,00:00:15,3,True,6,3,3,39,15,17
3,00:12:02,3,False,6,6,0,9,8,17
3,00:05:11,3,True,9,6,3,34,9,17
3,00:00:16,3,False,9,9,0,24,11,17
1,00:13:44,3,False,0,0,0,21,2,17
3,00:10:22,3,True,10,29,-19,29,3,17
1,00:02:08,3,True,0,0,0,10,10,17
1,00:00:11,3,False,3,0,3,33,6,17
2,00:11:14,3,False,3,3,0,21,11,17
3,00:08:44,3,True,15,3,12,35,10,17
4,00:12:07,3,True,16,6,10,41,6,17
4,00:08:09,3,False,9,16,-7,29,1,17
1,00:11:22,3,False,0,0,0,42,3,17
1,00:07:49,3,False,0,3,-3,44,4,17
2,00:02:59,3,True,13,0,13,3,3,17
3,00:10:24,3,False,3,13,-10,35,3,17
1,00:06:01,3,True,0,1,-1,46,2,17
2,00:00:06,3,True,9,18,-9,38,6,17
4,00:04:21,3,True,16,30,-14,42,7,17
2,00:14:02,3,False,0,0,0,5,5,17
3,00:11:10,3,False,15,3,12,12,3,17
3,00:00:33,3,False,15,7,8,34,3,17
3,00:00:35,3,False,15,15,0,11,2,17
4,00:07:53,2,False,15,25,-10,27,8,17
4,00:02:42,3,False,15,28,-13,20,5,17
1,00:02:53,3,False,7,0,7,33,9,17
4,00:01:53,3,True,24,29,-5,16,5,17
5,00:00:00,3,False,32,32,0,30,5,17
5,00:15:00,3,False,32,32,0,15,6,17
2,00:05:03,3,True,0,7,-7,7,7,17
4,00:06:07,3,True,7,12,-5,9,5,17
1,00:02:43,3,False,0,7,-7,20,10,17
3,00:10:14,3,False,0,14,-14,38,3,17
1,00:11:29,3,True,0,0,0,36,9,17
2,00:04:35,3,False,10,2,8,13,5,17
3,00:12:41,3,True,5,10,-5,29,7,17
3,00:03:30,3,True,5,13,-8,40,3,17
4,00:10:25,3,True,5,13,-8,32,10,17
2,00:06:20,3,False,7,0,7,17,10,17
3,00:11:30,3,False,7,3,4,38,13,17
3,00:07:42,3,False,7,5,2,28,11,17
3,00:02:56,3,False,7,8,-1,36,13,17
4,00:11:17,3,False,7,11,-4,23,10,17
1,00:09:24,3,False,0,7,-7,44,8,17
1,00:00:01,3,True,7,7,0,2,23,17
3,00:10:41,3,False,17,28,-11,18,2,17
3,00:06:26,3,True,31,17,14,15,5,17
4,00:13:18,3,False,20,39,-19,24,2,17
2,00:08:48,3,True,0,2,-2,43,7,17
1,00:02:54,3,False,7,14,-7,38,4,17
2,00:10:21,3,False,7,17,-10,40,6,17
3,00:06:52,3,False,21,20,1,6,6,17
4,00:14:26,3,False,21,23,-2,21,10,17
4,00:11:09,3,False,21,26,-5,20,16,17
4,00:08:47,3,True,29,21,8,37,4,17
4,00:01:21,3,False,24,30,-6,31,11,17
1,00:00:38,3,True,0,0,0,20,2,17
2,00:12:44,3,False,10,0,10,32,13,17
2,00:05:14,3,False,10,3,7,8,6,17
2,00:01:15,3,False,10,6,4,35,21,17
3,00:08:28,3,False,10,9,1,30,10,17
4,00:01:43,3,False,17,16,1,1,1,17
1,00:00:15,3,True,0,7,-7,35,3,17
2,00:09:22,3,True,0,10,-10,13,8,17
2,00:00:00,3,False,20,7,13,26,16,17
3,00:10:14,3,True,10,20,-10,31,17,17
3,00:05:20,3,False,23,10,13,32,5,17
4,00:04:59,3,True,20,30,-10,25,2,17
1,00:08:46,3,False,0,0,0,22,10,17
2,00:03:47,3,True,10,0,10,27,4,17
3,00:05:10,3,False,3,24,-21,23,12,17
3,00:09:23,3,True,21,7,14,40,4,17
3,00:05:13,3,False,7,21,-14,18,3,17
3,00:00:37,3,False,7,31,-24,34,7,17
4,00:03:40,3,False,9,34,-25,18,5,17
4,00:01:15,3,False,9,37,-28,21,6,17
1,00:02:26,3,False,0,7,-7,14,6,17
2,00:08:48,3,False,0,11,-11,26,6,17
3,00:10:37,3,False,0,37,-37,9,6,17
3,00:07:36,3,True,40,0,40,36,9,17
3,00:01:17,3,True,40,3,37,24,6,17
4,00:10:03,3,True,41,6,35,19,10,17
1,00:09:01,3,False,0,0,0,14,3,17
2,00:00:00,1,False,1,4,-3,19,10,17
3,00:05:09,3,True,7,3,4,31,3,17
3,00:00:50,3,True,7,3,4,20,9,17
4,00:04:34,3,False,6,16,-10,29,10,17
1,00:07:57,3,False,0,0,0,23,10,17
1,00:05:35,3,True,3,0,3,28,3,17
2,00:11:17,3,False,10,3,7,42,2,17
3,00:09:07,3,True,6,10,-4,30,10,17
4,00:08:15,3,False,20,6,14,30,5,17
4,00:03:10,3,False,20,9,11,41,7,17
1,00:02:01,3,False,14,0,14,19,1,17
2,00:12:19,3,False,15,3,12,22,10,17
3,00:06:10,3,False,23,7,16,30,10,17
4,00:10:42,3,True,16,23,-7,34,11,17
1,00:12:40,3,True,0,0,0,35,10,17
1,00:08:05,3,False,0,0,0,36,7,17
2,00:11:38,3,True,3,0,3,30,5,17
2,00:00:25,3,False,4,10,-6,10,10,17
3,00:05:04,3,True,13,11,2,39,6,17
4,00:13:10,3,True,13,14,-1,22,21,17
2,00:03:34,3,True,7,7,0,34,10,17
2,00:00:21,3,True,7,10,-3,7,3,17
3,00:08:31,3,True,7,20,-13,39,10,17
3,00:01:54,3,False,23,7,16,14,14,17
1,00:03:18,3,True,1,0,1,25,7,17
2,00:02:58,3,True,8,10,-2,25,5,17
4,00:02:22,3,False,27,37,-10,11,3,17
1,00:10:01,3,False,0,2,-2,29,26,17
1,00:04:39,3,False,0,5,-5,15,5,17
4,00:11:46,3,False,21,15,6,22,8,17
4,00:02:31,3,True,25,21,4,38,10,17
1,00:11:06,3,False,0,0,0,38,14,17
2,00:07:20,3,False,7,4,3,10,10,17
2,00:00:48,3,True,14,7,7,15,10,17
2,00:00:00,2,True,14,10,4,7,7,17
3,00:07:29,3,False,13,14,-1,39,15,17
3,00:10:08,3,True,15,14,1,15,10,17
4,00:11:29,3,True,22,24,-2,21,5,17
4,00:07:21,3,False,27,22,5,35,20,17
1,00:01:26,3,True,7,0,7,14,8,17
2,00:12:49,3,False,3,7,-4,20,6,17
2,00:03:11,3,False,3,10,-7,25,6,17
4,00:06:59,3,True,11,9,2,3,3,17
4,00:05:34,3,True,11,12,-1,23,8,17
4,00:03:16,3,True,11,15,-4,11,1,17
1,00:11:19,3,False,0,0,0,40,11,17
1,00:01:27,3,True,10,0,10,14,4,17
2,00:03:12,3,False,3,17,-14,37,7,17
3,00:01:35,3,False,3,27,-24,8,6,17
1,00:10:00,3,False,0,0,0,38,10,17
1,00:03:09,3,True,0,0,0,14,9,17
3,00:02:51,3,True,7,11,-4,18,3,17
4,00:14:01,3,False,14,7,7,38,10,17
2,00:14:37,3,False,0,14,-14,32,7,17
2,00:03:13,3,False,0,17,-17,15,15,17
4,00:11:42,3,True,20,2,18,14,10,17
4,00:07:16,3,False,5,20,-15,38,1,17
1,00:11:11,3,True,0,0,0,5,5,17
1,00:07:06,3,False,3,0,3,11,6,17
2,00:08:53,3,False,10,3,7,39,20,17
3,00:06:02,3,False,24,13,11,19,3,17
3,00:02:21,3,True,16,24,-8,18,4,17
4,00:11:18,2,True,16,27,-11,33,10,17
4,00:02:18,3,True,16,30,-14,7,6,17
1,00:11:57,3,False,0,0,0,11,10,17
2,00:06:03,3,True,11,0,11,16,7,17
2,00:02:41,3,True,11,3,8,23,6,17
3,00:09:35,3,False,6,11,-5,16,2,17
4,00:07:01,3,True,21,6,15,5,5,17
1,00:08:07,3,False,1,0,1,16,10,17
2,00:06:43,3,True,7,1,6,13,5,17
2,00:03:11,3,False,4,7,-3,31,10,17
3,00:05:18,3,True,23,4,19,15,3,17
2,00:02:35,3,True,8,0,8,22,10,17
2,00:01:46,3,True,22,1,21,35,10,17
2,00:02:17,3,False,0,14,-14,4,4,17
3,00:04:20,3,False,7,17,-10,12,5,17
4,00:11:55,3,True,20,7,13,18,5,17
4,00:05:35,3,True,20,10,10,5,5,17
4,00:02:05,3,True,20,13,7,30,16,17
1,00:11:43,3,False,0,0,0,30,12,17
1,00:03:50,3,False,0,3,-3,34,5,17
2,00:08:03,3,False,0,7,-7,14,6,17
3,00:01:23,3,True,18,7,11,23,5,17
1,00:01:51,3,False,7,0,7,25,8,17
2,00:01:20,3,False,14,10,4,13,4,17
3,00:00:41,3,True,27,14,13,26,10,17
4,00:05:28,3,False,24,27,-3,35,10,17
4,00:01:46,3,False,24,37,-13,20,5,17
2,00:09:49,3,False,0,7,-7,24,6,17
2,00:04:46,3,False,0,10,-10,29,8,17
4,00:09:57,3,False,7,34,-27,25,4,17
4,00:01:58,3,True,37,7,30,26,21,17
1,00:00:00,3,True,6,0,6,13,2,17
2,00:11:01,3,True,6,3,3,37,3,17
2,00:06:39,3,True,6,6,0,35,7,17
1,00:08:31,3,False,0,0,0,21,10,17
1,00:04:33,3,True,3,0,3,10,5,17
2,00:14:21,2,False,3,3,0,25,15,17
2,00:01:52,3,True,6,3,3,32,20,17
3,00:12:14,3,False,6,6,0,34,4,17
3,00:06:25,3,False,6,9,-3,21,10,17
4,00:01:24,3,False,6,20,-14,43,28,17
1,00:07:48,3,False,0,0,0,33,4,17
1,00:07:29,3,False,0,0,0,30,15,17
2,00:09:17,3,True,0,1,-1,21,6,17
2,00:02:29,3,False,4,0,4,33,10,17
1,00:07:01,3,True,7,0,7,35,4,17
2,00:07:38,3,True,7,10,-3,18,2,17
4,00:14:44,3,False,30,7,23,24,10,17
4,00:09:53,3,False,30,10,20,42,10,17
1,00:04:49,3,True,7,7,0,42,13,17
2,00:12:32,3,True,7,10,-3,12,3,17
2,00:00:01,3,False,20,7,13,29,17,17
3,00:06:24,3,True,7,20,-13,13,6,17
4,00:11:28,3,True,13,23,-10,14,9,17
1,00:07:01,3,True,6,0,6,7,3,17
2,00:08:25,3,False,10,13,-3,40,9,17
2,00:05:51,3,False,10,16,-6,35,19,17
2,00:02:37,3,True,19,10,9,40,10,17
2,00:00:01,1,True,19,10,9,44,10,17
3,00:12:47,3,True,19,13,6,24,4,17
3,00:06:48,3,False,16,19,-3,37,14,17
4,00:08:52,3,False,23,27,-4,36,2,17
2,00:10:49,3,True,6,0,6,33,5,17
3,00:01:36,3,False,13,13,0,30,1,17
2,00:01:09,3,True,10,15,-5,13,10,17
3,00:00:00,3,True,18,18,0,23,6,17
4,00:02:35,3,False,22,18,4,36,10,17
4,00:00:00,1,False,23,21,2,43,10,17
2,00:02:38,3,True,10,7,3,32,12,17
4,00:09:59,3,False,23,23,0,12,2,17
1,00:11:31,3,True,1,0,1,12,3,17
3,00:10:12,3,True,13,38,-25,25,12,17
3,00:04:35,3,False,41,15,26,24,20,17
4,00:05:56,3,True,26,49,-23,31,9,17
2,00:09:51,3,False,0,7,-7,16,9,17
2,00:01:05,3,True,16,0,16,29,10,17
3,00:03:19,3,True,22,0,22,21,11,17
4,00:14:45,3,False,3,22,-19,42,2,17
4,00:02:54,3,False,11,25,-14,10,8,17
1,00:06:54,3,True,0,0,0,4,4,17
2,00:07:27,3,True,0,3,-3,5,5,17
2,00:00:00,1,False,7,7,0,39,10,17
3,00:05:56,3,False,9,10,-1,21,2,17
1,00:10:20,3,True,0,0,0,43,17,17
1,00:04:14,3,True,0,3,-3,2,2,17
2,00:06:23,3,False,10,3,7,23,18,17
2,00:04:24,3,False,10,6,4,42,4,17
3,00:08:50,3,False,10,17,-7,14,14,17
4,00:14:35,3,True,21,11,10,35,2,17
4,00:02:46,3,True,21,18,3,32,6,17
1,00:10:14,3,True,0,0,0,36,7,17
2,00:06:41,3,False,0,26,-26,37,18,17
2,00:00:03,3,True,36,8,28,35,7,17
3,00:07:56,3,True,36,11,25,9,6,17
4,00:11:57,3,True,43,14,29,24,13,17
4,00:07:09,3,False,17,43,-26,23,6,17
1,00:05:59,3,False,0,0,0,44,3,17
1,00:02:33,3,False,0,3,-3,14,8,17
2,00:13:45,3,True,6,0,6,15,3,17
3,00:11:53,3,True,19,10,9,15,3,17
3,00:01:31,3,False,13,19,-6,17,10,17
4,00:10:07,3,False,20,22,-2,26,1,17
4,00:02:49,3,True,25,20,5,31,3,17
1,00:00:23,3,False,7,0,7,17,5,17
2,00:09:49,3,False,7,3,4,6,5,17
3,00:10:13,3,False,7,6,1,4,4,17
3,00:02:06,3,False,15,9,6,35,6,17
4,00:00:15,3,False,29,26,3,48,10,17
5,00:00:00,3,True,29,29,0,26,1,17
3,00:05:44,3,True,22,14,8,41,2,17
4,00:13:14,3,True,22,17,5,38,9,17
4,00:01:27,3,False,20,22,-2,23,13,17
1,00:00:42,3,False,0,1,-1,14,5,17
2,00:01:34,3,False,7,4,3,35,10,17
2,00:00:07,3,True,7,7,0,46,12,17
4,00:12:48,3,True,14,10,4,29,10,17
4,00:05:12,3,False,13,14,-1,20,10,17
1,00:04:23,3,True,0,2,-2,16,10,17
2,00:04:11,3,True,0,5,-5,14,8,17
2,00:00:00,3,False,8,0,8,11,3,17
3,00:11:15,3,False,8,3,5,23,2,17
3,00:08:01,3,True,6,8,-2,23,6,17
4,00:04:10,3,True,12,17,-5,32,4,17
4,00:02:20,3,True,12,20,-8,30,1,17
2,00:07:38,3,False,8,0,8,42,7,17
3,00:04:38,3,True,11,17,-6,7,13,17
4,00:07:55,3,False,27,11,16,16,8,17
4,00:03:05,3,False,27,14,13,43,24,17
2,00:04:40,3,True,16,16,0,38,9,17
4,00:06:53,3,True,23,22,1,42,4,17
4,00:02:14,3,False,25,23,2,33,3,17
4,00:01:27,3,True,26,25,1,45,4,17
1,00:04:47,3,True,0,8,-8,35,5,17
2,00:05:45,3,False,19,8,11,18,8,17
3,00:08:28,3,True,17,19,-2,16,6,17
3,00:06:12,3,False,22,17,5,37,7,17
4,00:03:52,3,True,26,23,3,41,4,17
4,00:01:34,3,False,26,26,0,25,10,17
5,00:00:00,3,False,26,26,0,27,2,17
3,00:11:14,3,True,21,7,14,26,11,17
4,00:12:31,3,True,21,18,3,37,18,17
4,00:06:20,3,False,21,21,0,31,8,17
4,00:02:22,3,False,27,24,3,35,10,17
4,00:00:46,3,True,27,27,0,17,2,17
1,00:12:28,3,True,0,0,0,35,12,17
1,00:01:23,3,True,1,0,1,3,3,17
2,00:10:04,3,False,3,1,2,28,11,17
1,00:12:54,3,True,0,0,0,50,3,17
1,00:07:43,3,False,0,0,0,22,10,17
2,00:14:16,3,True,3,7,-4,36,11,17
2,00:09:20,3,False,10,3,7,33,20,17
2,00:01:20,3,True,6,11,-5,14,2,17
3,00:07:36,3,True,21,14,7,42,6,17
4,00:14:01,3,True,21,17,4,18,18,17
4,00:01:41,3,True,21,28,-7,32,15,17
1,00:07:43,3,True,7,0,7,41,5,17
1,00:01:30,3,False,3,7,-4,30,18,17
2,00:14:06,3,True,7,3,4,34,9,17
2,00:09:11,3,False,6,7,-1,37,8,17
2,00:00:03,1,False,13,7,6,17,10,17
3,00:01:48,3,True,10,15,-5,15,7,17
4,00:14:29,3,True,10,15,-5,34,10,17
4,00:08:23,3,False,18,10,8,42,7,17
2,00:13:04,0,False,6,3,3,5,0,22
2,00:01:37,0,False,13,3,10,5,0,22
3,00:00:00,0,False,23,6,17,5,0,22
1,00:12:25,0,True,6,0,6,5,0,22
2,00:12:23,0,False,12,7,5,5,0,22
2,00:00:15,0,False,22,10,12,5,0,22
4,00:13:27,0,False,32,12,20,5,0,22
4,00:11:56,0,True,18,33,-15,5,0,22
4,00:04:15,0,True,25,33,-8,5,0,22
1,00:08:18,0,True,6,0,6,5,0,22
2,00:07:58,0,False,6,7,-1,5,0,22
2,00:07:11,0,True,13,7,6,5,0,22
3,00:09:14,0,True,20,9,11,5,0,22
3,00:04:01,0,False,15,21,-6,5,0,22
4,00:05:37,0,True,28,19,9,5,0,22
4,00:00:25,0,False,25,29,-4,5,0,22
1,00:02:45,0,True,6,3,3,5,0,22
1,00:00:53,0,False,9,7,2,5,0,22
2,00:02:48,0,True,13,11,2,5,0,22
3,00:01:03,0,True,20,14,6,5,0,22
4,00:00:54,0,False,23,24,-1,5,0,22
4,00:00:24,0,False,30,24,6,5,0,22
1,00:00:28,0,True,6,2,4,5,0,22
2,00:09:46,0,False,9,7,2,5,0,22
2,00:02:01,0,False,16,7,9,5,0,22
2,00:01:30,0,False,17,13,4,5,0,22
3,00:10:47,0,True,20,18,2,5,0,22
4,00:13:05,0,True,30,18,12,5,0,22
4,00:11:02,0,False,24,31,-7,5,0,22
4,00:05:24,0,True,37,25,12,5,0,22
4,00:02:07,0,True,47,25,22,5,0,22
1,00:00:00,0,False,6,3,3,5,0,22
2,00:11:20,0,True,9,7,2,5,0,22
2,00:01:31,0,True,16,7,9,5,0,22
2,00:01:13,0,True,17,13,4,5,0,22
4,00:03:09,0,True,26,26,0,5,0,22
1,00:11:22,0,True,6,0,6,5,0,22
1,00:02:39,0,True,16,0,16,5,0,22
2,00:04:44,0,False,6,17,-11,5,0,22
3,00:04:51,0,True,29,7,22,5,0,22
4,00:10:42,0,True,36,7,29,5,0,22
4,00:04:11,0,False,19,37,-18,5,0,22
4,00:02:58,0,False,26,37,-11,5,0,22
4,00:02:17,0,False,33,37,-4,5,0,22
1,00:04:46,0,True,7,0,7,5,0,22
2,00:05:58,0,False,9,8,1,5,0,22
2,00:01:29,0,False,16,8,8,5,0,22
1,00:00:10,0,False,6,2,4,5,0,22
2,00:10:53,0,True,8,7,1,5,0,22
3,00:08:49,0,True,10,16,-6,5,0,22
3,00:03:11,0,True,16,17,-1,5,0,22
4,00:02:31,0,True,23,20,3,5,0,22
1,00:11:03,0,False,6,0,6,5,0,22
2,00:07:40,0,True,7,7,0,5,0,22
2,00:11:44,0,True,9,5,4,5,0,22
2,00:06:15,0,True,16,5,11,5,0,22
3,00:12:22,0,True,23,8,15,5,0,22
3,00:11:13,0,True,30,8,22,5,0,22
4,00:14:05,0,False,14,34,-20,5,0,22
4,00:08:56,0,False,21,34,-13,5,0,22
4,00:01:57,0,False,28,37,-9,5,0,22
1,00:13:24,0,True,6,0,6,5,0,22
3,00:06:51,0,True,22,8,14,5,0,22
3,00:05:12,0,False,14,23,-9,5,0,22
3,00:01:21,0,False,27,23,4,5,0,22
4,00:14:38,0,True,29,28,1,5,0,22
4,00:01:17,0,False,36,30,6,5,0,22
1,00:06:58,0,True,6,0,6,5,0,22
1,00:00:00,0,True,13,0,13,5,0,22
2,00:02:45,0,True,20,0,20,5,0,22
2,00:01:12,0,True,27,0,27,10,0,22
2,00:00:00,0,True,34,0,34,5,0,22
4,00:05:11,0,True,50,0,50,5,0,22
1,00:08:13,0,True,6,3,3,5,0,22
3,00:09:54,0,True,16,12,4,5,0,22
4,00:12:56,0,True,23,13,10,5,0,22
1,00:11:45,0,True,6,0,6,5,0,22
1,00:01:57,0,False,9,7,2,5,0,22
3,00:08:12,0,True,15,14,1,5,0,22
3,00:04:21,0,True,22,14,8,5,0,22
4,00:14:02,0,False,20,23,-3,5,0,22
1,00:12:50,0,False,6,0,6,5,0,22
2,00:00:17,0,False,14,13,1,5,0,22
3,00:07:50,0,False,21,13,8,5,0,22
4,00:01:18,0,True,25,22,3,5,0,22
1,00:09:49,0,True,6,0,6,5,0,22
1,00:01:29,0,False,6,8,-2,5,0,22
2,00:09:53,0,False,13,8,5,5,0,22
3,00:08:17,0,True,14,17,-3,5,0,22
4,00:11:41,0,False,26,15,11,10,0,22
4,00:09:43,0,True,21,27,-6,5,0,22
1,00:09:13,0,True,6,0,6,5,0,22
1,00:01:23,0,True,16,0,16,5,0,22
2,00:00:58,0,True,23,3,20,5,0,22
1,00:11:39,0,False,6,0,6,5,0,22
1,00:09:58,0,False,13,0,13,5,0,22
1,00:01:43,0,True,9,14,-5,5,0,22
3,00:13:28,0,True,19,23,-4,5,0,22
3,00:11:32,0,True,26,23,3,5,0,22
4,00:10:17,0,False,30,33,-3,5,0,22
1,00:10:13,0,False,7,0,7,5,0,22
2,00:05:44,0,True,9,11,-2,5,0,22
2,00:02:24,0,True,19,11,8,5,0,22
4,00:07:47,0,False,29,23,6,5,0,22
1,00:12:07,0,True,6,0,6,5,0,22
1,00:04:14,0,False,13,8,5,5,0,22
1,00:00:50,0,False,20,8,12,5,0,22
2,00:13:50,0,True,14,21,-7,5,0,22
2,00:07:58,0,True,21,24,-3,5,0,22
2,00:01:17,0,False,30,25,5,5,0,22
3,00:09:53,0,True,31,34,-3,5,0,22
4,00:05:01,0,True,38,34,4,5,0,22
2,00:02:47,0,True,14,0,14,5,0,22
3,00:02:48,0,False,6,15,-9,10,0,22
3,00:00:00,0,True,21,7,14,5,0,22
4,00:08:29,0,True,28,7,21,5,0,22
4,00:06:47,0,False,13,29,-16,5,0,22
4,00:02:34,0,True,35,14,21,5,0,22
1,00:09:30,0,True,6,0,6,5,0,22
1,00:03:18,0,True,13,0,13,5,0,22
2,00:10:08,0,False,6,16,-10,5,0,22
2,00:05:56,0,True,22,6,16,5,0,22
2,00:01:40,0,True,30,6,24,5,0,22
3,00:10:25,0,False,12,31,-19,5,0,22
3,00:09:37,0,False,19,31,-12,5,0,22
3,00:01:57,0,True,37,21,16,5,0,22
1,00:09:32,0,True,6,0,6,5,0,22
1,00:02:42,0,True,13,0,13,5,0,22
2,00:00:23,0,False,10,20,-10,5,0,22
3,00:14:16,0,True,26,11,15,5,0,22
4,00:05:35,0,False,23,27,-4,5,0,22
1,00:10:09,0,False,6,0,6,5,0,22
1,00:00:49,0,False,13,0,13,5,0,22
2,00:00:00,0,False,21,1,20,5,0,22
3,00:10:56,0,False,28,1,27,5,0,22
3,00:09:48,0,False,35,1,34,5,0,22
2,00:12:34,0,False,6,3,3,5,0,22
4,00:05:49,0,False,15,4,11,5,0,22
4,00:02:10,0,True,10,16,-6,5,0,22
1,00:06:00,0,True,6,0,6,5,0,22
4,00:04:14,0,True,23,9,14,5,0,22
1,00:11:41,0,False,6,0,6,5,0,22
2,00:14:23,0,True,3,13,-10,5,0,22
2,00:00:14,0,False,20,14,6,5,0,22
4,00:05:08,0,True,34,21,13,5,0,22
1,00:11:24,0,False,6,0,6,5,0,22
1,00:06:31,0,False,15,0,15,5,0,22
1,00:03:56,0,True,6,16,-10,5,0,22
4,00:09:27,0,False,29,13,16,5,0,22
4,00:06:22,0,True,19,30,-11,5,0,22
1,00:01:12,0,False,6,3,3,5,0,22
2,00:14:23,0,True,9,7,2,5,0,22
4,00:10:34,0,True,21,19,2,5,0,22
4,00:00:28,0,False,25,28,-3,5,0,22
1,00:02:23,0,False,6,4,2,5,0,22
1,00:00:00,0,True,10,7,3,5,0,22
2,00:07:21,0,False,13,11,2,5,0,22
2,00:00:50,0,False,20,11,9,5,0,22
3,00:07:53,0,False,28,14,14,5,0,22
4,00:09:59,0,True,20,32,-12,5,0,22
4,00:02:15,0,False,38,21,17,5,0,22
4,00:00:23,0,True,27,39,-12,5,0,22
1,00:11:00,0,False,6,0,6,5,0,22
1,00:04:57,0,True,9,7,2,5,0,22
2,00:08:50,0,True,17,8,9,5,0,22
2,00:05:30,0,False,14,18,-4,3,0,22
3,00:12:41,0,True,24,15,9,5,0,22
3,00:10:19,0,False,21,25,-4,5,0,22
4,00:07:42,0,False,31,25,6,5,0,22
1,00:07:00,0,True,6,0,6,5,0,22
2,00:03:42,0,False,12,7,5,5,0,22
4,00:03:33,0,True,13,19,-6,5,0,22
1,00:14:13,0,False,6,0,6,5,0,22
1,00:11:52,0,True,6,7,-1,5,0,22
1,00:07:21,0,False,13,7,6,5,0,22
2,00:03:42,0,False,24,7,17,5,0,22
2,00:01:49,0,False,32,7,25,5,0,22
2,00:01:02,0,True,13,33,-20,5,0,22
3,00:10:18,0,False,39,14,25,5,0,22
3,00:00:26,0,False,46,14,32,5,0,22
1,00:12:37,0,True,6,0,6,5,0,22
2,00:02:25,0,False,12,9,3,5,0,22
4,00:05:50,0,True,24,13,11,5,0,22
4,00:02:40,0,False,19,25,-6,5,0,22
3,00:10:12,0,False,7,3,4,5,0,22
3,00:03:52,0,False,14,3,11,5,0,22
2,00:13:49,0,False,6,1,5,5,0,22
2,00:11:57,0,False,13,1,12,5,0,22
3,00:03:06,0,False,26,4,22,5,0,22
3,00:00:00,0,True,10,27,-17,15,0,22
4,00:13:00,0,False,33,11,22,5,0,22
1,00:06:39,0,False,6,3,3,5,0,22
2,00:07:07,0,False,13,6,7,5,0,22
2,00:01:23,0,False,20,6,14,5,0,22
3,00:10:31,0,False,27,6,21,5,0,22
3,00:01:31,0,True,10,4,6,5,0,22
4,00:11:44,0,False,10,11,-1,5,0,22
1,00:08:34,0,False,6,0,6,5,0,22
1,00:03:01,0,False,16,0,16,5,0,22
1,00:00:00,0,False,23,0,23,5,0,22
2,00:03:53,0,True,9,24,-15,5,0,22
3,00:00:56,0,True,34,24,10,5,0,22
2,00:08:22,0,True,9,3,6,5,0,22
2,00:03:12,0,False,9,10,-1,5,0,22
3,00:11:10,0,True,16,10,6,5,0,22
3,00:04:59,0,True,23,10,13,5,0,22
4,00:02:00,0,True,30,14,16,5,0,22
4,00:01:09,0,False,20,31,-11,5,0,22
2,00:00:02,0,True,8,6,2,5,0,22
3,00:05:29,0,False,12,12,0,5,0,22
4,00:00:38,0,True,21,21,0,5,0,22
2,00:03:38,0,True,12,0,12,5,0,22
3,00:00:00,0,True,22,0,22,5,0,22
4,00:12:32,0,True,29,0,29,5,0,22
4,00:05:38,0,True,36,0,36,3,0,22
1,00:01:01,0,True,9,3,6,5,0,22
2,00:00:46,0,True,19,6,13,5,0,22
3,00:10:08,0,False,12,20,-8,5,0,22
4,00:12:22,0,False,19,26,-7,5,0,22
4,00:11:08,0,False,26,26,0,5,0,22
1,00:02:22,0,False,7,0,7,0,0,22
1,00:00:00,0,True,6,8,-2,5,0,22
2,00:11:13,0,True,13,8,5,5,0,22
3,00:09:26,0,False,23,14,9,5,0,22
4,00:12:36,0,False,33,17,16,5,0,22
4,00:01:19,0,True,23,37,-14,5,0,22
1,00:07:52,0,True,9,0,9,5,0,22
2,00:11:15,0,False,11,10,1,5,0,22
2,00:07:15,0,True,16,12,4,5,0,22
2,00:04:21,0,False,18,17,1,5,0,22
2,00:02:08,0,False,25,17,8,5,0,22
2,00:12:56,0,True,6,3,3,5,0,22
2,00:04:00,0,True,13,6,7,5,0,22
3,00:05:07,0,True,20,9,11,5,0,22
4,00:02:24,0,True,30,12,18,5,0,22
4,00:00:56,0,True,37,12,25,5,0,22
1,00:00:08,0,True,7,1,6,5,0,22
2,00:07:35,0,True,14,1,13,5,0,22
3,00:08:41,0,True,21,1,20,5,0,22
3,00:00:34,0,False,10,22,-12,5,0,22
4,00:03:00,0,False,26,22,4,5,0,22
4,00:00:40,0,False,33,22,11,5,0,22
2,00:06:43,0,False,9,6,3,5,0,22
2,00:01:33,0,False,16,6,10,5,0,22
3,00:01:06,0,True,14,20,-6,5,0,22
4,00:12:17,0,False,26,15,11,5,0,22
4,00:05:12,0,True,21,27,-6,5,0,22
1,00:10:36,0,False,6,0,6,5,0,22
2,00:07:46,0,False,14,3,11,5,0,22
2,00:01:58,0,False,21,3,18,5,0,22
3,00:08:09,0,True,15,22,-7,5,0,22
4,00:06:31,0,False,29,19,10,5,0,22
1,00:01:10,0,False,7,3,4,5,0,22
2,00:07:06,0,True,9,9,0,5,0,22
2,00:04:06,0,True,16,9,7,5,0,22
2,00:01:50,0,False,15,17,-2,5,0,22
4,00:06:10,0,True,25,17,8,5,0,22
2,00:11:08,0,False,6,3,3,5,0,22
3,00:12:46,0,True,9,16,-7,5,0,22
3,00:10:21,0,False,22,10,12,5,0,22
4,00:02:13,0,True,16,28,-12,5,0,22
1,00:13:32,0,False,6,0,6,5,0,22
1,00:06:31,0,False,13,0,13,5,0,22
1,00:03:49,0,False,20,0,20,5,0,22
2,00:03:27,0,False,27,0,27,5,0,22
4,00:14:08,0,True,9,32,-23,5,0,22
1,00:12:02,0,True,6,0,6,5,0,22
2,00:09:45,0,False,6,16,-10,5,0,22
3,00:08:07,0,False,16,26,-10,5,0,22
4,00:08:10,0,True,34,20,14,5,0,22
4,00:05:01,0,False,26,35,-9,5,0,22
4,00:02:34,0,True,41,27,14,5,0,22
1,00:09:17,0,False,6,0,6,5,0,22
1,00:03:01,0,False,13,0,13,5,0,22
2,00:10:06,0,False,20,3,17,5,0,22
2,00:01:22,0,False,30,3,27,5,0,22
4,00:14:04,0,False,38,3,35,5,0,22
4,00:08:47,0,True,9,40,-31,5,0,22
4,00:04:24,0,True,16,40,-24,5,0,22
4,00:03:00,0,True,23,40,-17,5,0,22
4,00:01:24,0,False,46,24,22,5,0,22
1,00:04:17,0,False,9,0,9,5,0,22
2,00:08:19,0,True,6,10,-4,5,0,22
2,00:02:38,0,False,16,7,9,5,0,22
3,00:00:48,0,False,23,7,16,5,0,22
4,00:05:24,0,False,33,11,22,5,0,22
4,00:02:39,0,True,17,34,-17,5,0,22
1,00:06:37,0,True,9,0,9,5,0,22
1,00:01:23,0,True,16,3,13,5,0,22
2,00:01:19,0,True,24,4,20,5,0,22
3,00:02:43,0,True,34,4,30,5,0,22
3,00:02:12,0,False,10,35,-25,5,0,22
1,00:06:13,0,True,6,3,3,5,0,22
4,00:01:45,0,False,20,14,6,5,0,22
4,00:01:02,0,True,20,21,-1,5,0,22
1,00:03:41,0,True,9,0,9,5,0,22
2,00:01:45,0,False,10,19,-9,5,0,22
3,00:09:33,0,True,25,11,14,5,0,22
3,00:04:56,0,False,17,26,-9,5,0,22
4,00:05:14,0,True,32,26,6,5,0,22
4,00:01:07,0,True,39,26,13,5,0,22
1,00:12:22,0,True,6,0,6,5,0,22
1,00:01:45,0,False,6,7,-1,5,0,22
1,00:01:13,0,True,13,7,6,5,0,22
2,00:06:43,0,False,15,14,1,5,0,22
2,00:02:43,0,True,20,16,4,5,0,22
2,00:14:14,0,True,6,3,3,5,0,22
2,00:09:16,0,True,13,3,10,5,0,22
1,00:11:37,0,True,6,0,6,5,0,22
2,00:10:17,0,True,13,9,4,5,0,22
2,00:01:42,0,False,15,14,1,5,0,22
3,00:10:28,0,True,23,16,7,5,0,22
3,00:02:31,0,True,32,16,16,5,0,22
4,00:00:01,0,False,32,36,-4,5,0,22
1,00:00:12,0,False,9,0,9,5,0,22
2,00:07:00,0,True,6,10,-4,5,0,22
2,00:02:09,0,True,13,10,3,5,0,22
2,00:00:09,0,False,16,17,-1,5,0,22
3,00:05:26,0,False,23,20,3,5,0,22
4,00:08:02,0,False,30,26,4,5,0,22
1,00:04:04,0,False,11,0,11,5,0,22
2,00:03:22,0,True,6,15,-9,5,0,22
3,00:13:43,0,True,13,21,-8,5,0,22
3,00:11:18,0,False,27,14,13,5,0,22
3,00:08:58,0,True,20,28,-8,5,0,22
4,00:07:24,0,False,37,27,10,5,0,22
1,00:09:39,0,True,6,0,6,5,0,22
2,00:07:10,0,False,13,7,6,5,0,22
2,00:01:52,0,True,13,14,-1,5,0,22
2,00:01:16,0,False,20,14,6,5,0,22
4,00:10:42,0,False,28,14,14,5,0,22
1,00:00:36,0,True,8,1,7,5,0,22
2,00:07:15,0,True,15,1,14,5,0,22
2,00:01:19,0,False,7,16,-9,5,0,22
3,00:10:40,0,True,22,8,14,5,0,22
4,00:08:00,0,False,17,24,-7,5,0,22
1,00:11:26,0,True,6,0,6,5,0,22
1,00:00:00,0,True,16,0,16,5,0,22
2,00:07:20,0,True,23,0,23,5,0,22
4,00:11:11,0,False,13,27,-14,5,0,22
4,00:02:08,0,True,33,14,19,5,0,22
2,00:11:21,0,True,9,6,3,5,0,22
3,00:06:50,0,True,16,15,1,5,0,22
3,00:03:04,0,False,21,17,4,5,0,22
3,00:00:40,0,True,23,22,1,5,0,22
4,00:08:00,0,False,28,27,1,5,0,22
2,00:09:36,0,False,9,3,6,5,0,22
2,00:01:34,0,False,19,3,16,5,0,22
2,00:00:03,0,True,9,20,-11,5,0,22
1,00:00:52,0,False,9,3,6,5,0,22
2,00:11:46,0,False,16,3,13,5,0,22
3,00:09:10,0,True,9,23,-14,5,0,22
4,00:09:42,0,True,16,23,-7,5,0,22
1,00:08:24,0,False,6,0,6,5,0,22
1,00:01:27,0,True,9,7,2,5,0,22
2,00:11:48,0,True,19,7,12,5,0,22
2,00:07:51,0,True,26,7,19,5,0,22
3,00:08:12,0,False,13,31,-18,5,0,22
1,00:06:46,0,True,6,0,6,5,0,22
1,00:03:03,0,True,13,0,13,5,0,22
2,00:09:00,0,True,20,3,17,5,0,22
2,00:00:32,0,True,30,3,27,5,0,22
1,00:09:09,0,True,6,0,6,5,0,22
1,00:00:46,0,False,6,10,-4,5,0,22
2,00:04:29,0,True,19,10,9,5,0,22
2,00:00:27,0,False,16,21,-5,5,0,22
4,00:02:44,0,True,35,21,14,5,0,22
1,00:14:12,0,False,6,0,6,5,0,22
2,00:03:31,0,True,7,12,-5,5,0,22
2,00:00:27,0,True,14,15,-1,5,0,22
3,00:13:07,0,True,21,15,6,5,0,22
3,00:06:05,0,True,28,15,13,5,0,22
4,00:09:18,0,True,35,15,20,5,0,22
4,00:05:16,0,False,21,36,-15,5,0,22
4,00:02:01,0,True,42,22,20,5,0,22
4,00:00:48,0,False,28,43,-15,5,0,22
1,00:08:24,0,False,6,0,6,5,0,22
1,00:04:10,0,False,13,0,13,5,0,22
3,00:08:51,0,True,9,16,-7,5,0,22
3,00:06:04,0,False,22,10,12,5,0,22
4,00:11:29,0,True,16,23,-7,5,0,22
4,00:03:43,0,True,26,23,3,5,0,22
2,00:11:11,0,True,9,3,6,5,0,22
4,00:04:52,0,False,24,22,2,5,0,22
4,00:01:48,0,True,28,25,3,5,0,22
1,00:11:14,0,True,6,0,6,5,0,22
2,00:12:36,0,False,6,10,-4,5,0,22
2,00:09:22,0,False,13,10,3,5,0,22
1,00:01:32,0,True,6,3,3,5,0,22
2,00:02:45,0,True,16,4,12,5,0,22
2,00:05:58,0,False,9,6,3,5,0,22
2,00:00:43,0,False,16,6,10,5,0,22
3,00:05:27,0,False,26,6,20,5,0,22
4,00:03:56,0,False,36,7,29,5,0,22
1,00:06:22,0,False,9,0,9,5,0,22
2,00:03:57,0,True,9,10,-1,5,0,22
3,00:01:38,0,True,19,16,3,5,0,22
3,00:00:00,0,False,22,20,2,5,0,22
4,00:01:06,0,False,29,26,3,5,0,22
3,00:04:12,0,False,8,6,2,5,0,22
4,00:01:04,0,True,12,10,2,5,0,22
2,00:14:32,0,False,6,3,3,5,0,22
2,00:04:26,0,False,13,6,7,5,0,22
2,00:02:41,0,True,12,14,-2,5,0,22
3,00:10:16,0,False,23,16,7,5,0,22
4,00:13:02,0,True,22,25,-3,5,0,22
1,00:02:40,0,False,6,3,3,5,0,22
2,00:08:40,0,False,13,6,7,5,0,22
2,00:02:43,0,False,21,6,15,5,0,22
3,00:09:23,0,True,12,22,-10,5,0,22
4,00:01:12,0,False,34,13,21,5,0,22
1,00:07:47,0,True,6,3,3,5,0,22
1,00:00:29,0,False,9,7,2,5,0,22
2,00:13:10,0,True,13,10,3,5,0,22
2,00:06:43,0,True,20,10,10,5,0,22
2,00:00:24,0,False,16,24,-8,5,0,22
3,00:09:34,0,False,23,24,-1,5,0,22
1,00:06:38,0,True,6,3,3,5,0,22
2,00:08:49,0,True,16,3,13,5,0,22
2,00:05:22,0,True,23,3,20,5,0,22
2,00:01:56,0,True,30,6,24,5,0,22
3,00:02:39,0,False,12,31,-19,5,0,22
4,00:05:02,0,True,37,16,21,5,0,22
4,00:03:48,0,True,44,16,28,5,0,22
4,00:01:56,0,False,22,45,-23,5,0,22
1,00:03:14,0,False,6,3,3,5,0,22
2,00:11:42,0,False,13,3,10,5,0,22
2,00:06:23,0,True,9,14,-5,5,0,22
4,00:06:46,0,False,23,16,7,5,0,22
1,00:05:38,0,True,6,0,6,5,0,22
4,00:02:43,0,False,10,11,-1,5,0,22
1,00:05:09,0,False,6,0,6,5,0,22
1,00:00:00,0,True,6,7,-1,5,0,22
2,00:01:22,0,False,16,7,9,5,0,22
3,00:02:10,0,True,20,20,0,5,0,22
4,00:05:16,0,True,27,23,4,5,0,22
1,00:13:05,0,True,6,0,6,5,0,22
1,00:00:58,0,False,6,10,-4,5,0,22
2,00:09:04,0,False,13,10,3,5,0,22
3,00:10:22,0,False,20,10,10,5,0,22
3,00:01:55,0,True,16,21,-5,5,0,22
1,00:12:22,0,True,6,0,6,5,0,22
1,00:00:17,0,True,13,0,13,5,0,22
3,00:03:10,0,False,16,17,-1,5,0,22
1,00:06:05,0,True,6,3,3,5,0,22
1,00:03:09,0,True,13,3,10,5,0,22
2,00:09:53,0,True,20,6,14,5,0,22
2,00:00:54,0,False,12,21,-9,5,0,22
3,00:08:58,0,True,27,13,14,5,0,22
3,00:01:58,0,True,34,13,21,5,0,22
4,00:05:41,0,False,22,35,-13,5,0,22
1,00:02:27,0,False,6,1,5,5,0,22
2,00:14:05,0,False,13,4,9,5,0,22
2,00:00:07,0,False,21,7,14,5,0,22
2,00:14:34,0,True,6,0,6,5,0,22
2,00:07:40,0,True,13,0,13,5,0,22
3,00:12:28,0,False,8,14,-6,5,0,22
3,00:08:34,0,False,15,14,1,5,0,22
1,00:10:07,0,True,6,0,6,5,0,22
1,00:08:09,0,False,0,13,-13,5,0,22
2,00:05:56,0,False,9,18,-9,5,0,22
3,00:02:49,0,True,30,13,17,5,0,22
1,00:11:17,0,True,6,0,6,5,0,22
1,00:03:47,0,True,13,0,13,10,0,22
2,00:02:54,0,True,23,0,23,5,0,22
2,00:02:06,0,False,6,24,-18,5,0,22
3,00:10:42,0,True,30,7,23,5,0,22
3,00:05:46,0,False,13,31,-18,5,0,22
3,00:04:21,0,True,37,14,23,5,0,22
4,00:07:54,0,True,44,14,30,5,0,22
4,00:03:22,0,False,20,45,-25,5,0,22
1,00:00:00,0,True,10,0,10,5,0,22
4,00:13:15,0,True,21,1,20,5,0,22
4,00:07:26,0,True,28,1,27,5,0,22
4,00:00:00,0,False,7,29,-22,5,0,22
1,00:13:02,0,True,6,0,6,5,0,22
1,00:06:10,0,False,6,7,-1,5,0,22
1,00:00:46,0,True,13,7,6,5,0,22
3,00:00:00,0,False,19,17,2,5,0,22
4,00:09:20,0,False,26,17,9,5,0,22
1,00:06:04,0,True,9,0,9,5,0,22
2,00:13:39,0,True,18,0,18,5,0,22
3,00:08:16,0,True,30,1,29,5,0,22
4,00:07:01,0,False,9,31,-22,5,0,22
1,00:10:48,0,False,6,0,6,5,0,22
1,00:08:01,0,False,13,0,13,5,0,22
1,00:03:51,0,True,6,14,-8,5,0,22
1,00:00:00,0,False,20,7,13,5,0,22
2,00:06:07,0,True,13,21,-8,5,0,22
4,00:02:33,0,True,32,28,4,5,0,22
1,00:07:17,0,True,6,0,6,5,0,22
1,00:01:14,0,True,13,0,13,5,0,22
1,00:07:38,0,True,6,0,6,5,0,22
1,00:01:59,0,False,6,7,-1,5,0,22
3,00:11:25,0,False,16,10,6,5,0,22
4,00:11:35,0,False,23,13,10,5,0,22
1,00:09:31,0,True,6,0,6,5,0,22
2,00:11:20,0,True,16,0,16,5,0,22
3,00:09:23,0,True,23,1,22,5,0,22
3,00:04:29,0,False,7,25,-18,5,0,22
3,00:01:36,0,False,14,25,-11,5,0,22
4,00:04:05,0,True,40,15,25,5,0,22
4,00:02:47,0,True,47,15,32,5,0,22
1,00:09:31,0,True,6,3,3,5,0,22
1,00:05:48,0,False,9,7,2,5,0,22
3,00:10:54,0,True,19,19,0,5,0,22
4,00:10:48,0,True,29,22,7,5,0,22
2,00:07:05,0,False,6,1,5,5,0,22
3,00:13:02,0,True,8,7,1,5,0,22
4,00:14:01,0,True,17,8,9,5,0,22
4,00:09:00,0,True,24,8,16,5,0,22
1,00:00:00,0,False,9,6,3,5,0,22
2,00:09:38,0,False,16,6,10,5,0,22
3,00:10:56,0,False,23,9,14,5,0,22
3,00:04:49,0,False,30,12,18,5,0,22
1,00:00:10,0,False,10,0,10,5,0,22
2,00:02:31,0,True,12,11,1,5,0,22
4,00:05:31,0,False,25,13,12,5,0,22
1,00:08:19,0,False,6,0,6,5,0,22
4,00:09:49,0,False,19,3,16,5,0,22
4,00:14:00,0,False,13,12,1,5,0,22
2,00:07:56,0,True,6,4,2,5,0,22
1,00:07:51,0,True,9,0,9,5,0,22
2,00:01:29,0,True,19,3,16,5,0,22
3,00:06:40,0,True,26,3,23,5,0,22
4,00:13:40,0,True,33,3,30,5,0,22
4,00:11:30,0,True,40,3,37,5,0,22
1,00:05:51,0,False,9,3,6,5,0,22
2,00:14:29,0,True,9,10,-1,5,0,22
2,00:00:10,0,False,19,13,6,5,0,22
3,00:08:26,0,True,19,20,-1,5,0,22
3,00:06:07,0,False,18,6,12,5,0,22
1,00:13:45,0,False,0,6,-6,5,0,22
1,00:07:06,0,False,6,7,-1,5,0,22
1,00:05:09,0,True,13,7,6,5,0,22
2,00:12:58,0,False,13,14,-1,5,0,22
4,00:05:04,0,True,29,23,6,5,0,22
1,00:12:24,0,True,6,0,6,5,0,22
1,00:10:22,0,True,13,0,13,5,0,22
2,00:03:29,0,True,20,6,14,5,0,22
2,00:01:39,0,True,27,6,21,5,0,22
2,00:01:47,0,False,12,6,6,5,0,22
3,00:12:02,0,False,19,6,13,5,0,22
3,00:08:07,0,True,12,20,-8,5,0,22
4,00:14:34,0,True,19,20,-1,5,0,22
4,00:12:28,0,True,26,20,6,5,0,22
4,00:00:00,0,False,26,29,-3,5,0,22
2,00:00:44,0,False,9,5,4,5,0,22
3,00:11:43,0,False,16,5,11,5,0,22
4,00:01:33,0,False,30,5,25,5,0,22
1,00:02:43,0,True,6,7,-1,5,0,22
2,00:05:46,0,True,13,10,3,5,0,22
2,00:02:02,0,True,20,10,10,5,0,22
1,00:10:27,0,False,6,0,6,5,0,22
1,00:04:37,0,False,16,0,16,5,0,22
1,00:01:42,0,False,23,0,23,5,0,22
2,00:07:51,0,False,30,0,30,5,0,22
2,00:04:56,0,True,6,32,-26,5,0,22
4,00:05:44,0,True,13,38,-25,5,0,22
2,00:05:07,0,True,9,3,6,5,0,22
3,00:01:59,0,False,9,10,-1,5,0,22
1,00:12:02,0,False,6,0,6,5,0,22
2,00:10:00,0,False,16,8,8,5,0,22
2,00:02:37,0,False,26,8,18,5,0,22
1,00:07:00,0,True,9,0,9,5,0,22
1,00:00:00,0,True,16,3,13,5,0,22
2,00:06:50,0,False,12,17,-5,5,0,22
3,00:04:49,0,True,26,19,7,5,0,22
3,00:01:34,0,False,25,27,-2,5,0,22
1,00:06:55,0,True,6,0,6,5,0,22
2,00:12:00,0,True,13,0,13,5,0,22
2,00:02:30,0,True,20,0,20,5,0,22
2,00:01:36,0,False,6,21,-15,5,0,22
2,00:00:48,0,True,27,7,20,5,0,22
3,00:04:29,0,False,13,31,-18,5,0,22
1,00:08:37,0,False,6,0,6,5,0,22
2,00:11:40,0,True,6,7,-1,5,0,22
2,00:03:53,0,False,13,7,6,5,0,22
2,00:01:21,0,True,13,14,-1,5,0,22
2,00:00:03,0,True,20,14,6,5,0,22
3,00:08:06,0,False,20,21,-1,5,0,22
4,00:13:43,0,True,27,21,6,5,0,22
4,00:03:04,0,True,37,21,16,5,0,22
1,00:06:44,0,False,6,0,6,5,0,22
1,00:04:50,0,True,6,7,-1,5,0,22
2,00:02:49,0,False,16,7,9,5,0,22
4,00:14:32,0,True,16,20,-4,5,0,22
4,00:00:33,0,False,29,20,9,5,0,22
4,00:14:24,0,True,11,4,7,5,0,22
4,00:03:14,0,False,10,12,-2,5,0,22
1,00:08:07,0,False,6,0,6,10,0,22
4,00:14:29,0,True,16,13,3,5,0,22
4,00:06:08,0,False,25,17,8,5,0,22
3,00:13:42,0,True,7,6,1,5,0,22
3,00:01:22,0,False,12,8,4,5,0,22
4,00:02:08,0,True,20,16,4,5,0,22
1,00:02:59,0,False,6,0,6,5,0,22
1,00:01:21,0,True,6,7,-1,5,0,22
2,00:11:30,0,True,13,7,6,5,0,22
2,00:06:06,0,True,23,7,16,5,0,22
3,00:03:10,0,False,22,31,-9,5,0,22
4,00:00:12,0,True,40,27,13,5,0,22
1,00:13:09,0,True,6,0,6,5,0,22
1,00:02:48,0,False,6,7,-1,5,0,22
4,00:06:02,0,False,17,7,10,5,0,22
4,00:04:12,0,True,7,24,-17,5,0,22
4,00:02:10,0,False,31,7,24,5,0,22
1,00:10:32,0,True,9,0,9,5,0,22
3,00:00:00,0,False,18,16,2,5,0,22
1,00:01:40,0,True,6,3,3,5,0,22
4,00:06:06,0,False,9,13,-4,5,0,22
4,00:04:50,0,True,19,10,9,5,0,22
1,00:07:30,0,False,6,0,6,5,0,22
2,00:06:19,0,True,10,7,3,5,0,22
3,00:08:25,0,True,20,7,13,5,0,22
3,00:04:19,0,False,13,21,-8,5,0,22
3,00:02:38,0,False,20,21,-1,5,0,22
4,00:05:19,0,True,27,27,0,5,0,22
4,00:00:28,0,True,34,30,4,5,0,22
1,00:07:37,0,True,9,1,8,5,0,22
2,00:00:22,0,False,9,13,-4,5,0,22
1,00:10:13,0,True,6,0,6,5,0,22
1,00:06:48,0,False,6,8,-2,5,0,22
2,00:08:23,0,True,14,7,7,5,0,22
4,00:08:49,0,True,24,10,14,5,0,22
2,00:08:02,0,True,6,3,3,5,0,22
2,00:05:23,0,False,9,7,2,5,0,22
2,00:02:30,0,False,16,7,9,5,0,22
3,00:10:25,0,False,23,10,13,5,0,22
3,00:04:35,0,False,30,10,20,5,0,22
4,00:04:35,0,True,19,34,-15,5,0,22
4,00:02:34,0,True,26,34,-8,5,0,22
4,00:01:23,0,False,40,27,13,5,0,22
4,00:00:21,0,True,33,41,-8,5,0,22
1,00:12:50,0,True,6,0,6,5,0,22
1,00:06:29,0,False,9,7,2,5,0,22
1,00:00:00,0,False,16,7,9,5,0,22
3,00:04:15,0,True,16,24,-8,5,0,22
3,00:00:00,0,True,23,24,-1,5,0,22
4,00:13:23,0,True,30,24,6,5,0,22
4,00:02:55,0,True,37,24,13,5,0,22
4,00:00:12,0,False,30,38,-8,5,0,22
1,00:01:48,0,True,6,1,5,5,0,22
2,00:14:35,0,False,7,7,0,5,0,22
2,00:01:33,0,False,19,8,11,5,0,22
2,00:00:38,0,False,26,8,18,5,0,22
3,00:11:53,0,True,14,27,-13,5,0,22
4,00:02:27,0,True,23,30,-7,5,0,22
4,00:14:27,0,False,15,12,3,5,0,22
4,00:12:15,0,True,18,16,2,5,0,22
4,00:06:57,0,True,25,16,9,5,0,22
4,00:01:37,0,True,32,16,16,5,0,22
1,00:10:40,0,False,6,3,3,5,0,22
1,00:05:41,0,False,13,3,10,5,0,22
2,00:08:56,0,False,21,3,18,5,0,22
2,00:04:22,0,False,28,3,25,5,0,22
2,00:00:38,0,True,9,29,-20,5,0,22
3,00:05:02,0,True,24,32,-8,5,0,22
4,00:01:48,0,True,39,33,6,5,0,22
2,00:00:45,0,True,14,3,11,5,0,22
4,00:03:01,0,True,25,9,16,5,0,22
2,00:13:32,0,True,12,0,12,5,0,22
3,00:07:24,0,True,19,3,16,5,0,22
4,00:03:28,0,True,26,3,23,5,0,22
2,00:14:00,0,False,10,0,10,5,0,22
2,00:09:05,0,False,17,1,16,5,0,22
2,00:06:24,0,True,7,18,-11,5,0,22
3,00:09:12,0,False,27,9,18,5,0,22
4,00:07:42,0,True,15,30,-15,5,0,22
4,00:01:49,0,True,22,33,-11,5,0,22
4,00:00:53,0,False,39,23,16,5,0,22
2,00:02:40,0,False,7,3,4,5,0,22
2,00:01:18,0,False,14,3,11,5,0,22
4,00:11:29,0,True,16,15,1,5,0,22
4,00:02:40,0,True,23,16,7,5,0,22
4,00:00:06,0,False,22,25,-3,5,0,22
2,00:13:45,0,True,6,0,6,5,0,22
2,00:04:25,0,True,14,1,13,5,0,22
2,00:00:22,0,False,7,15,-8,5,0,22
3,00:11:27,0,False,14,15,-1,5,0,22
4,00:11:21,0,True,24,15,9,5,0,22
1,00:07:59,0,False,6,0,6,5,0,22
2,00:05:47,0,False,14,3,11,5,0,22
2,00:02:47,0,False,15,9,6,5,0,22
2,00:00:20,0,False,21,10,11,5,0,22
3,00:11:37,0,True,16,22,-6,5,0,22
3,00:07:28,0,False,28,17,11,5,0,22
4,00:13:47,0,True,23,29,-6,5,0,22
2,00:10:53,0,False,6,0,6,5,0,22
2,00:00:39,0,True,6,10,-4,5,0,22
1,00:11:39,0,True,6,0,6,5,0,22
4,00:00:52,0,True,23,0,23,5,0,22
2,00:09:33,0,False,9,2,7,10,0,22
1,00:09:57,0,False,6,0,6,5,0,22
1,00:13:46,0,True,6,0,6,5,0,22
1,00:09:06,0,False,6,7,-1,5,0,22
2,00:09:06,0,True,13,10,3,5,0,22
2,00:06:01,0,False,16,14,2,5,0,22
2,00:01:43,0,True,20,17,3,5,0,22
2,00:00:03,0,True,27,17,10,5,0,22
3,00:02:26,0,True,37,20,17,5,0,22
2,00:05:54,0,False,8,0,8,5,0,22
3,00:07:28,0,False,16,0,16,5,0,22
3,00:03:38,0,False,23,0,23,5,0,22
4,00:00:32,0,False,30,24,6,5,0,22
1,00:10:08,0,True,6,0,6,5,0,22
1,00:06:30,0,True,13,0,13,5,0,22
1,00:06:06,0,False,6,14,-8,5,0,22
2,00:05:28,0,False,13,20,-7,5,0,22
2,00:03:26,0,False,20,20,0,5,0,22
1,00:00:03,0,False,9,0,9,5,0,22
3,00:03:07,0,False,16,12,4,5,0,22
1,00:08:59,0,False,6,0,6,5,0,22
2,00:03:43,0,True,6,13,-7,5,0,22
2,00:01:49,0,False,19,7,12,5,0,22
3,00:03:07,0,False,29,13,16,5,0,22
4,00:02:07,0,True,26,33,-7,5,0,22
2,00:06:42,0,True,9,0,9,5,0,22
2,00:02:30,0,True,16,3,13,5,0,22
3,00:09:37,0,True,23,3,20,5,0,22
4,00:12:06,0,True,33,3,30,5,0,22
4,00:02:54,0,True,40,3,37,5,0,22
1,00:03:30,0,False,6,0,6,5,0,22
2,00:09:43,0,True,6,7,-1,5,0,22
2,00:04:14,0,True,13,7,6,5,0,22
3,00:11:54,0,True,20,7,13,5,0,22
3,00:04:04,0,True,30,7,23,5,0,22
1,00:05:43,0,True,6,0,6,5,0,22
2,00:05:31,0,True,20,0,20,5,0,22
2,00:02:37,0,True,27,0,27,5,0,22
2,00:00:04,0,True,36,0,36,5,0,22
4,00:13:43,0,True,13,6,7,5,0,22
1,00:00:00,0,False,9,3,6,5,0,22
4,00:14:22,0,False,19,6,13,5,0,22
1,00:08:58,0,False,6,0,6,5,0,22
1,00:06:16,0,False,13,0,13,10,0,22
3,00:09:39,0,False,22,7,15,5,0,22
3,00:00:00,0,True,15,23,-8,5,0,22
4,00:07:09,0,True,22,26,-4,5,0,22
4,00:01:25,0,False,32,23,9,5,0,22
2,00:00:58,0,True,9,4,5,5,0,22
3,00:14:39,0,False,10,13,-3,5,0,22
4,00:07:28,0,False,23,13,10,5,0,22
1,00:10:25,0,True,6,0,6,5,0,22
1,00:05:24,0,False,6,7,-1,5,0,22
3,00:11:24,0,False,19,7,12,5,0,22
4,00:12:12,0,False,23,16,7,5,0,22
1,00:00:00,0,True,7,3,4,5,0,22
2,00:07:56,0,False,9,8,1,5,0,22
2,00:00:54,0,False,19,8,11,5,0,22
2,00:01:06,0,True,14,20,-6,5,0,22
3,00:08:10,0,False,26,15,11,5,0,22
4,00:06:23,0,True,29,27,2,5,0,22
4,00:05:01,0,True,36,27,9,5,0,22
1,00:00:00,0,True,14,0,14,5,0,22
2,00:06:50,0,False,6,15,-9,5,0,22
3,00:09:55,0,False,13,15,-2,5,0,22
3,00:01:34,0,False,20,15,5,5,0,22
4,00:04:56,0,True,24,21,3,5,0,22
1,00:05:48,0,False,6,4,2,5,0,22
2,00:03:03,0,True,13,7,6,5,0,22
4,00:09:26,0,False,19,17,2,5,0,22
4,00:03:52,0,False,27,17,10,5,0,22
1,00:01:23,0,True,7,0,7,5,0,22
2,00:11:03,0,False,6,8,-2,5,0,22
2,00:08:08,0,True,14,7,7,5,0,22
2,00:07:32,0,False,13,15,-2,5,0,22
3,00:06:45,0,True,21,17,4,5,0,22
3,00:03:28,0,False,23,22,1,5,0,22
4,00:04:09,0,False,33,25,8,5,0,22
1,00:10:59,0,True,6,0,6,5,0,22
3,00:10:37,0,False,9,10,-1,5,0,22
1,00:05:30,0,True,9,0,9,5,0,22
2,00:09:58,0,True,16,3,13,5,0,22
3,00:08:55,0,True,26,3,23,5,0,22
4,00:08:53,0,True,36,3,33,5,0,22
2,00:10:43,0,True,6,3,3,5,0,22
2,00:00:10,0,False,10,7,3,5,0,22
4,00:09:01,0,True,16,14,2,5,0,22
1,00:09:56,0,True,6,0,6,5,0,22
1,00:08:30,0,True,13,0,13,5,0,22
2,00:14:00,0,False,9,3,6,5,0,22
2,00:02:18,0,False,16,6,10,5,0,22
2,00:01:01,0,True,12,17,-5,5,0,22
2,00:00:23,0,False,23,13,10,5,0,22
2,00:09:10,0,True,10,0,10,5,0,22
4,00:12:08,0,True,20,6,14,5,0,22
4,00:03:15,0,True,27,9,18,5,0,22
2,00:12:38,0,True,6,1,5,5,0,22
3,00:11:08,0,True,22,4,18,5,0,22
4,00:02:53,0,False,16,24,-8,15,0,22
2,00:05:30,0,True,7,0,7,5,0,22
2,00:01:09,0,True,14,3,11,5,0,22
3,00:09:15,0,True,21,3,18,5,0,22
3,00:03:59,0,True,28,3,25,5,0,22
3,00:01:39,0,True,35,3,32,5,0,22
4,00:12:36,0,True,42,3,39,5,0,22
4,00:10:36,0,True,49,3,46,5,0,22
1,00:11:13,0,True,6,0,6,5,0,22
2,00:13:09,0,True,13,1,12,5,0,22
2,00:08:42,0,False,1,21,-20,5,0,22
2,00:00:40,0,True,28,4,24,5,0,22
3,00:10:06,0,True,35,4,31,5,0,22
3,00:05:55,0,False,10,36,-26,5,0,22
3,00:03:00,0,False,17,36,-19,5,0,22
4,00:02:18,0,True,42,18,24,5,0,22
1,00:05:04,0,True,6,0,6,5,0,22
2,00:14:01,0,True,13,0,13,5,0,22
2,00:01:21,0,False,6,17,-11,5,0,22
2,00:06:20,0,True,16,0,16,5,0,22
2,00:00:44,0,False,6,17,-11,5,0,22
1,00:07:07,0,False,6,0,6,5,0,22
2,00:10:52,0,True,9,7,2,5,0,22
2,00:04:29,0,False,13,10,3,5,0,22
2,00:00:26,0,True,19,14,5,5,0,22
3,00:05:49,0,True,26,14,12,5,0,22
4,00:09:56,0,False,23,27,-4,5,0,22
4,00:03:44,0,True,36,24,12,5,0,22
1,00:06:54,0,True,6,0,6,25,0,22
2,00:02:25,0,True,19,0,19,25,0,22
3,00:14:31,0,True,26,0,26,25,0,22
3,00:08:44,0,True,33,0,33,25,0,22
4,00:12:59,0,False,6,34,-28,20,0,22
1,00:05:45,0,True,6,0,6,5,0,22
3,00:07:09,0,False,19,7,12,25,0,22
3,00:05:03,0,True,13,20,-7,25,0,22
3,00:00:39,0,False,26,14,12,25,0,22
4,00:08:36,0,False,33,14,19,25,0,22
4,00:02:17,0,True,26,34,-8,25,0,22
3,00:03:05,0,False,18,3,15,32,0,22
1,00:10:48,0,True,6,0,6,25,0,22
2,00:10:40,0,False,9,7,2,25,0,22
2,00:05:35,0,False,19,7,12,25,0,22
1,00:13:25,0,False,6,0,6,25,0,22
2,00:05:45,0,False,19,7,12,25,0,22
4,00:13:56,0,True,13,23,-10,32,0,22
2,00:13:52,0,True,12,3,9,25,0,22
2,00:10:59,0,True,13,9,4,25,0,22
3,00:02:07,0,True,25,16,9,25,0,22
4,00:13:46,0,False,22,27,-5,25,0,22
4,00:05:39,0,False,29,30,-1,25,0,22
4,00:00:36,0,False,36,30,6,25,0,22
1,00:11:24,0,True,6,0,6,25,0,22
2,00:05:26,0,True,12,5,7,25,0,22
4,00:10:04,0,False,19,16,3,25,0,22
1,00:09:56,0,False,6,0,6,25,0,22
1,00:05:13,0,True,6,7,-1,25,0,22
1,00:00:00,0,True,9,7,2,25,0,22
1,00:00:47,0,False,6,0,6,25,0,22
2,00:13:22,0,True,6,7,-1,25,0,22
2,00:02:09,0,False,13,7,6,25,0,22
2,00:01:28,0,True,13,15,-2,25,0,22
4,00:06:58,0,False,29,26,3,25,0,22
1,00:06:48,0,True,7,3,4,25,0,22
1,00:01:22,0,False,9,7,2,25,0,22
1,00:00:00,0,False,16,7,9,25,0,22
2,00:10:41,0,False,23,7,16,25,0,22
2,00:09:27,0,False,30,7,23,25,0,22
2,00:04:02,0,False,37,7,30,25,0,22
2,00:00:35,0,True,13,38,-25,25,0,22
1,00:04:21,0,True,6,0,6,25,0,22
3,00:07:15,0,True,22,0,22,25,0,22
2,00:03:53,0,True,6,6,0,25,0,22
3,00:03:21,0,False,15,13,2,25,0,22
4,00:14:37,0,True,19,16,3,25,0,22
4,00:07:49,0,True,26,16,10,25,0,22
2,00:13:48,0,False,9,3,6,25,0,22
4,00:09:26,0,False,17,21,-4,25,0,22
4,00:01:17,0,True,27,21,6,25,0,22
4,00:00:06,0,False,27,28,-1,25,0,22
1,00:07:16,0,True,6,0,6,25,0,22
1,00:03:52,0,True,13,0,13,25,0,22
2,00:14:54,0,True,20,0,20,25,0,22
2,00:10:21,0,True,26,0,26,25,0,22
2,00:01:53,0,True,35,8,27,25,0,22
3,00:06:35,0,True,42,14,28,25,0,22
2,00:10:07,0,True,12,3,9,25,0,22
2,00:04:23,0,False,9,12,-3,25,0,22
2,00:00:17,0,True,18,10,8,25,0,22
4,00:13:50,0,False,19,22,-3,25,0,22
1,00:05:31,0,False,6,0,6,25,0,22
4,00:13:01,0,False,21,12,9,25,0,22
4,00:06:38,0,True,18,22,-4,25,0,22
4,00:02:21,0,False,28,18,10,25,0,22
1,00:00:08,0,False,6,0,6,25,0,22
2,00:08:07,0,True,6,7,-1,25,0,22
2,00:02:39,0,True,20,7,13,25,0,22
2,00:01:33,0,False,13,21,-8,25,0,22
2,00:10:50,0,False,6,4,2,25,0,22
3,00:07:16,0,True,13,10,3,25,0,22
1,00:08:08,0,False,6,0,6,25,0,22
3,00:14:17,0,False,15,4,11,25,0,22
3,00:09:23,0,True,10,17,-7,25,0,22
4,00:14:28,0,False,26,11,15,25,0,22
4,00:00:36,0,True,23,27,-4,25,0,22
1,00:10:20,0,False,7,0,7,25,0,22
2,00:10:49,0,True,15,16,-1,25,0,22
3,00:02:14,0,True,22,16,6,25,0,22
3,00:00:16,0,False,22,23,-1,25,0,22
4,00:08:10,0,True,26,23,3,25,0,22
1,00:06:11,0,True,6,0,6,25,0,22
1,00:03:04,0,True,13,0,13,25,0,22
2,00:14:04,0,True,20,0,20,25,0,22
2,00:10:27,0,False,6,21,-15,25,0,22
4,00:03:31,0,False,27,24,3,25,0,22
3,00:06:33,0,True,10,3,7,25,0,22
3,00:02:00,0,True,17,3,14,25,0,22
4,00:08:31,0,True,24,3,21,25,0,22
4,00:04:38,0,True,31,3,28,25,0,22
1,00:06:02,0,False,6,3,3,25,0,22
3,00:11:01,0,True,20,14,6,25,0,22
1,00:10:23,0,True,6,0,6,25,0,22
2,00:02:00,0,False,12,7,5,25,0,22
1,00:08:28,1,False,0,0,0,14,10,1
1,00:07:51,1,False,0,0,0,51,10,1
1,00:06:56,1,True,0,0,0,34,10,1
1,00:04:34,2,True,0,0,0,34,10,1
1,00:03:47,1,False,0,0,0,44,10,1
1,00:03:15,2,False,0,0,0,39,5,1
1,00:01:21,1,False,0,3,-3,33,10,1
1,00:01:03,2,False,0,3,-3,37,6,1
1,00:00:01,2,False,0,3,-3,55,5,1
2,00:15:00,1,True,3,0,3,47,10,1
2,00:14:29,1,True,3,0,3,30,10,1
2,00:12:58,1,True,3,7,-4,30,10,1
2,00:11:58,1,False,7,3,4,42,10,1
2,00:10:10,2,True,3,7,-4,7,11,1
2,00:09:00,2,True,3,7,-4,53,4,1
2,00:06:00,1,False,7,3,4,42,10,1
2,00:05:19,1,True,3,7,-4,53,10,1
2,00:02:34,2,False,7,3,4,55,10,1
2,00:01:37,1,True,3,7,-4,10,10,1
2,00:01:31,1,True,3,14,-11,43,10,1
2,00:00:42,2,False,14,3,11,27,6,1
2,00:00:24,1,False,14,3,11,43,10,1
2,00:00:09,2,False,14,3,11,54,10,1
2,00:00:01,3,True,3,14,-11,47,1,1
3,00:12:48,1,True,3,14,-11,44,10,1
3,00:07:48,1,True,3,17,-14,33,10,1
3,00:05:40,1,False,17,3,14,38,10,1
3,00:05:00,1,False,17,3,14,24,10,1
3,00:02:28,1,True,6,17,-11,50,10,1
3,00:01:08,1,True,6,17,-11,7,10,1
3,00:00:17,2,True,6,17,-11,5,5,1
4,00:12:56,1,False,24,6,18,30,10,1
4,00:07:01,1,True,6,24,-18,40,10,1
4,00:05:12,1,False,24,6,18,51,10,1
4,00:03:15,1,False,24,6,18,9,10,1
4,00:02:56,2,False,24,6,18,15,4,1
4,00:02:10,1,False,24,6,18,19,10,1
4,00:01:57,2,False,24,6,18,51,9,1
4,00:00:57,2,True,6,24,-18,44,10,1
4,00:00:01,3,True,6,24,-18,49,10,1
1,00:14:47,1,True,0,0,0,32,10,1
1,00:09:21,1,False,0,7,-7,30,10,1
1,00:08:45,1,False,0,7,-7,45,10,1
1,00:08:00,1,True,7,0,7,28,10,1
1,00:05:10,2,True,7,3,4,23,12,1
1,00:04:41,1,True,7,3,4,38,10,1
1,00:02:32,1,True,7,3,4,43,10,1
1,00:01:51,1,True,7,3,4,35,10,1
2,00:08:49,1,True,7,16,-9,33,10,1
2,00:07:23,1,False,16,7,9,43,10,1
2,00:05:29,2,True,7,16,-9,34,6,1
2,00:05:07,1,False,16,7,9,53,10,1
2,00:03:32,1,False,16,7,9,9,10,1
2,00:03:00,2,False,16,7,9,17,2,1
2,00:01:53,1,True,7,16,-9,41,10,1
2,00:01:46,1,False,16,7,9,53,10,1
2,00:01:22,2,False,16,7,9,30,10,1
2,00:01:10,1,False,16,10,6,35,10,1
2,00:00:15,2,True,10,16,-6,25,10,1
3,00:14:45,1,False,23,10,13,44,10,1
3,00:13:30,1,True,10,23,-13,43,10,1
3,00:13:20,2,True,10,23,-13,47,6,1
3,00:12:00,2,False,23,10,13,51,12,1
3,00:10:17,2,False,23,10,13,7,7,1
3,00:08:21,1,False,23,12,11,38,10,1
3,00:05:42,1,True,12,23,-11,45,10,1
3,00:02:44,1,False,26,12,14,23,10,1
4,00:14:18,1,True,12,26,-14,20,10,1
4,00:13:10,1,True,12,33,-21,31,10,1
4,00:12:02,2,True,12,33,-21,35,6,1
4,00:11:12,2,False,33,19,14,30,12,1
4,00:09:53,2,False,33,19,14,44,15,1
4,00:06:01,2,True,19,33,-14,53,10,1
4,00:04:26,1,False,33,19,14,20,10,1
4,00:02:14,2,False,33,26,7,29,10,1
4,00:01:46,2,False,33,26,7,51,5,1
4,00:00:44,2,True,26,33,-7,17,10,1
4,00:00:35,1,True,26,33,-7,31,10,1
4,00:00:19,2,True,26,33,-7,40,1,1
1,00:14:58,1,True,0,0,0,48,10,1
1,00:13:40,1,False,0,0,0,26,10,1
1,00:13:14,2,False,0,0,0,24,12,1
1,00:11:36,2,True,0,0,0,50,10,1
1,00:11:09,1,False,0,0,0,43,10,1
1,00:10:30,1,False,0,0,0,31,10,1
1,00:10:00,2,False,0,0,0,30,9,1
1,00:08:36,2,False,0,0,0,5,5,1
1,00:08:09,1,False,0,7,-7,55,10,1
1,00:04:52,1,True,7,0,7,26,15,1
1,00:03:08,2,False,0,7,-7,45,8,1
2,00:14:00,1,True,7,0,7,22,15,1
2,00:13:33,1,True,7,0,7,39,10,1
2,00:12:02,1,False,0,7,-7,24,10,1
2,00:11:31,2,False,0,7,-7,29,5,1
2,00:10:11,2,False,0,7,-7,46,6,1
2,00:09:22,1,True,7,0,7,30,10,1
2,00:08:18,1,True,7,0,7,14,10,1
2,00:07:23,1,True,7,7,0,30,10,1
2,00:07:03,1,False,7,14,-7,43,10,1
2,00:04:48,2,True,14,7,7,20,11,1
2,00:03:20,2,True,14,7,7,40,3,1
2,00:02:17,1,False,7,14,-7,11,15,1
2,00:02:10,1,False,7,14,-7,28,10,1
2,00:01:50,1,False,7,14,-7,41,10,1
3,00:14:53,1,False,9,14,-5,32,10,1
3,00:12:45,2,True,14,9,5,27,16,1
3,00:11:49,2,False,9,14,-5,27,10,1
3,00:10:40,2,False,9,14,-5,3,3,1
3,00:09:29,3,False,9,14,-5,2,2,1
3,00:08:56,1,False,9,21,-12,47,10,1
3,00:08:18,1,True,21,9,12,52,10,1
3,00:06:38,1,True,21,9,12,38,10,1
3,00:03:24,2,True,21,16,5,35,5,1
3,00:02:42,1,True,21,16,5,42,10,1
3,00:02:15,2,True,21,16,5,45,7,1
3,00:00:42,2,False,16,21,-5,52,4,1
4,00:15:00,2,False,16,21,-5,45,8,1
4,00:13:02,1,False,16,22,-6,37,10,1
4,00:11:27,2,True,22,16,6,49,10,1
4,00:09:31,1,True,22,19,3,50,10,1
4,00:08:27,2,False,19,22,-3,40,3,1
4,00:07:58,1,False,19,22,-3,30,10,1
4,00:07:14,1,False,19,22,-3,16,10,1
4,00:05:30,1,False,19,29,-10,40,10,1
4,00:04:55,2,False,19,29,-10,45,5,1
4,00:04:17,1,False,19,29,-10,53,10,1
4,00:03:08,1,False,19,29,-10,35,10,1
4,00:02:26,1,False,19,29,-10,25,10,1
4,00:02:19,1,False,19,29,-10,36,10,1
4,00:01:46,2,True,29,19,10,49,18,1
4,00:01:13,1,True,29,19,10,30,10,1
4,00:00:51,1,True,29,19,10,12,10,1
4,00:00:25,2,True,29,19,10,2,2,1
1,00:14:54,1,True,0,0,0,26,10,1
1,00:13:00,1,True,0,0,0,37,10,1
1,00:12:26,2,True,0,0,0,43,4,1
1,00:10:41,1,False,0,0,0,30,10,1
1,00:09:10,2,True,0,0,0,39,8,1
1,00:07:44,2,True,0,3,-3,25,16,1
1,00:06:59,1,False,3,0,3,43,10,1
1,00:05:33,2,True,0,3,-3,50,23,1
1,00:04:52,1,True,0,3,-3,15,10,1
1,00:00:01,2,True,7,10,-3,28,17,1
2,00:14:00,2,False,10,7,3,9,10,1
2,00:13:20,1,False,10,7,3,49,10,1
2,00:10:47,1,True,7,10,-3,38,10,1
2,00:07:45,2,False,11,7,4,38,7,1
2,00:02:48,1,True,7,11,-4,33,10,1
2,00:02:31,2,False,11,14,-3,49,9,1
2,00:02:14,1,True,14,11,3,49,10,1
2,00:01:45,1,True,14,11,3,21,10,1
2,00:01:14,1,False,11,14,-3,37,10,1
2,00:00:37,2,True,14,11,3,12,10,1
3,00:13:46,1,True,14,11,3,19,10,1
3,00:13:14,2,True,14,11,3,22,7,1
3,00:07:09,1,False,11,14,-3,35,10,1
3,00:06:05,2,True,14,11,3,23,8,1
3,00:04:48,1,True,14,14,0,25,10,1
3,00:03:15,2,True,14,14,0,35,10,1
3,00:00:01,2,False,14,21,-7,55,13,1
4,00:14:30,2,True,21,14,7,38,9,1
4,00:13:13,2,True,21,14,7,22,10,1
4,00:12:24,1,False,14,21,-7,52,10,1
4,00:11:55,1,True,21,14,7,47,10,1
4,00:08:55,1,False,17,21,-4,22,10,1
4,00:06:46,2,False,17,21,-4,35,9,1
4,00:05:53,1,True,21,17,4,38,10,1
4,00:05:35,1,True,21,17,4,52,10,1
4,00:03:02,1,False,17,24,-7,35,10,1
4,00:02:19,1,True,24,17,7,35,10,1
4,00:02:01,3,True,24,17,7,27,4,1
4,00:01:46,2,True,24,17,7,15,10,1
4,00:00:54,3,True,24,17,7,1,1,1
4,00:00:17,1,True,24,31,-7,44,10,1
4,00:00:08,2,False,31,24,7,53,10,1
1,00:14:00,2,False,0,0,0,13,13,1
1,00:10:28,2,False,0,0,0,28,15,1
1,00:09:13,2,True,0,0,0,36,14,1
1,00:08:17,1,False,0,0,0,38,10,1
1,00:07:56,1,False,0,0,0,48,10,1
1,00:04:39,1,True,0,2,-2,44,10,1
1,00:04:12,2,True,0,2,-2,48,6,1
1,00:03:41,1,False,2,0,2,52,10,1
1,00:03:11,1,False,2,0,2,42,10,1
1,00:02:37,1,False,2,0,2,30,10,1
1,00:00:01,1,False,2,7,-5,34,10,1
2,00:15:00,1,False,2,7,-5,53,10,1
2,00:11:42,1,True,7,3,4,51,10,1
2,00:09:46,1,True,7,10,-3,25,10,1
2,00:06:04,2,False,10,7,3,16,10,1
2,00:05:18,1,True,7,10,-3,52,10,1
2,00:03:42,2,True,7,10,-3,18,10,1
2,00:02:39,1,True,7,10,-3,45,10,1
2,00:01:49,2,True,7,17,-10,53,0,1
2,00:01:30,1,False,17,7,10,21,10,1
2,00:01:24,1,False,17,14,3,35,10,1
2,00:00:59,2,False,17,14,3,51,10,1
2,00:00:45,1,True,14,18,-4,35,10,1
3,00:14:19,2,True,14,18,-4,31,13,1
3,00:13:49,1,True,14,18,-4,49,10,1
3,00:13:14,2,True,14,18,-4,55,4,1
3,00:12:39,1,False,18,14,4,45,10,1
3,00:10:39,1,False,18,21,-3,25,10,1
3,00:10:07,2,False,18,21,-3,32,3,1
3,00:09:27,1,False,18,21,-3,40,10,1
3,00:02:57,2,True,24,18,6,18,10,1
3,00:02:06,2,True,24,18,6,34,6,1
3,00:01:00,1,True,24,18,6,42,10,1
4,00:13:22,1,False,18,24,-6,11,10,1
4,00:12:59,1,False,18,31,-13,33,10,1
4,00:12:20,1,True,31,18,13,53,10,1
4,00:10:52,1,True,31,25,6,35,10,1
4,00:05:45,2,False,25,31,-6,7,7,1
4,00:03:36,2,False,25,38,-13,22,9,1
4,00:02:07,2,False,25,41,-16,5,5,1
4,00:01:14,2,False,25,48,-23,39,10,1
1,00:11:33,1,False,0,0,0,20,10,1
1,00:07:14,1,False,0,0,0,37,10,1
1,00:04:37,1,True,3,0,3,50,10,1
1,00:02:53,2,True,3,0,3,14,10,1
1,00:01:58,1,True,3,0,3,35,10,1
1,00:00:12,2,True,3,0,3,14,0,1
2,00:14:52,1,True,3,7,-4,38,10,1
2,00:13:50,1,False,7,3,4,50,10,1
2,00:12:09,2,False,7,3,4,40,20,1
2,00:11:34,1,False,7,3,4,13,10,1
2,00:09:43,1,True,10,7,3,26,10,1
2,00:09:00,2,False,7,10,-3,51,8,1
2,00:07:31,2,False,7,10,-3,28,10,1
2,00:06:24,2,False,7,10,-3,38,10,1
2,00:01:31,1,False,7,10,-3,14,10,1
2,00:00:56,2,True,17,14,3,33,19,1
2,00:00:15,1,False,14,17,-3,44,10,1
3,00:14:48,1,False,17,17,0,41,10,1
3,00:13:12,2,True,17,17,0,21,10,1
3,00:10:36,2,True,17,17,0,13,7,1
3,00:09:47,1,True,17,17,0,48,10,1
3,00:08:42,1,True,17,17,0,3,10,1
3,00:00:24,2,True,17,23,-6,36,9,1
4,00:12:48,1,True,17,26,-9,36,10,1
4,00:11:20,1,False,26,17,9,20,10,1
4,00:07:37,1,False,26,20,6,42,10,1
4,00:04:20,2,False,26,20,6,39,10,1
4,00:02:52,1,False,26,27,-1,51,10,1
4,00:02:32,2,True,27,26,1,52,3,1
4,00:01:50,1,True,27,26,1,50,15,1
4,00:01:07,1,True,27,29,-2,42,10,1
1,00:13:48,2,True,0,0,0,37,7,1
1,00:12:50,2,False,0,0,0,50,12,1
1,00:09:15,2,False,0,7,-7,34,10,1
1,00:08:18,1,False,0,10,-10,35,10,1
1,00:06:09,1,True,10,0,10,29,10,1
1,00:02:51,2,False,0,10,-10,33,5,1
1,00:02:30,1,False,0,17,-17,26,10,1
1,00:01:03,2,True,17,0,17,30,7,1
2,00:09:27,1,True,17,0,17,20,10,1
2,00:08:04,2,True,17,0,17,37,9,1
2,00:06:23,2,True,17,0,17,13,10,1
2,00:01:51,1,True,17,7,10,29,10,1
2,00:00:49,1,False,7,17,-10,41,10,1
3,00:14:56,1,False,7,17,-10,15,10,1
3,00:11:48,2,False,7,20,-13,42,9,1
3,00:06:51,2,True,23,7,16,30,5,1
3,00:06:11,1,True,23,7,16,45,10,1
3,00:05:06,1,False,7,23,-16,42,10,1
3,00:01:57,1,True,30,7,23,43,10,1
4,00:15:00,2,False,7,30,-23,13,8,1
4,00:14:43,1,False,7,30,-23,25,10,1
4,00:13:58,2,False,7,30,-23,35,10,1
4,00:10:56,2,True,30,7,23,44,5,1
4,00:09:48,2,False,7,37,-30,28,11,1
4,00:09:07,1,True,37,7,30,49,10,1
4,00:05:16,1,True,37,13,24,29,10,1
4,00:04:23,1,True,37,13,24,18,10,1
4,00:03:09,2,True,37,20,17,33,10,1
4,00:02:17,1,True,37,27,10,7,7,1
4,00:02:07,2,True,37,34,3,27,10,1
4,00:00:50,3,False,34,37,-3,7,20,1
1,00:13:35,1,False,0,0,0,30,10,1
1,00:10:54,2,True,1,0,1,43,7,1
1,00:08:49,1,False,0,1,-1,3,10,1
1,00:08:17,1,False,0,1,-1,16,10,1
1,00:04:59,2,False,0,1,-1,34,10,1
1,00:04:17,2,False,0,8,-8,25,10,1
1,00:01:45,2,True,8,0,8,18,8,1
1,00:00:20,2,False,0,8,-8,45,7,1
2,00:11:16,1,True,8,3,5,29,10,1
2,00:08:43,1,False,3,8,-5,34,10,1
2,00:06:08,2,True,8,3,5,28,9,1
2,00:05:48,1,True,8,10,-2,6,10,1
2,00:03:37,2,True,8,10,-2,9,18,1
2,00:02:49,2,False,10,8,2,32,10,1
2,00:01:22,1,True,8,17,-9,17,10,1
2,00:00:59,1,False,17,8,9,43,10,1
3,00:13:45,1,False,17,8,9,46,10,1
3,00:11:45,1,True,8,17,-9,30,10,1
3,00:11:09,2,True,8,17,-9,38,2,1
3,00:09:46,2,False,17,8,9,36,10,1
3,00:06:14,1,False,17,8,9,30,10,1
3,00:04:24,1,True,8,17,-9,14,10,1
3,00:04:02,1,True,8,17,-9,31,10,1
3,00:03:39,2,True,8,17,-9,35,6,1
3,00:03:02,1,True,8,17,-9,47,10,1
3,00:01:56,2,False,17,8,9,39,13,1
3,00:01:10,1,False,17,8,9,23,10,1
3,00:00:05,1,False,17,8,9,18,10,1
4,00:11:10,1,True,8,20,-12,43,10,1
4,00:09:45,1,False,20,9,11,30,15,1
4,00:08:16,2,False,20,9,11,46,9,1
4,00:07:24,1,True,9,20,-11,16,10,1
4,00:06:33,2,True,9,20,-11,30,7,1
4,00:05:52,1,True,9,20,-11,38,10,1
4,00:03:56,1,False,20,9,11,26,20,1
4,00:03:24,2,False,20,9,11,30,16,1
4,00:03:00,1,False,20,9,11,52,10,1
1,00:13:06,1,False,0,0,0,30,10,1
1,00:10:34,2,False,0,0,0,13,10,1
1,00:05:13,2,True,2,0,2,46,5,1
1,00:03:25,1,False,0,2,-2,20,10,1
1,00:02:46,1,False,0,2,-2,48,10,1
1,00:02:02,1,True,2,0,2,45,10,1
1,00:00:25,2,True,2,0,2,32,10,1
2,00:12:43,1,False,7,2,5,42,10,1
2,00:12:23,1,False,7,2,5,26,10,1
2,00:11:21,2,False,7,2,5,15,10,1
2,00:08:07,1,True,9,7,2,24,10,1
2,00:03:34,2,True,9,10,-1,46,11,1
2,00:01:15,1,True,9,10,-1,20,10,1
2,00:00:52,1,False,10,9,1,34,10,1
3,00:14:49,1,True,9,10,-1,27,10,1
3,00:13:17,2,False,10,9,1,43,11,1
3,00:12:29,1,False,10,10,0,35,10,1
3,00:12:17,2,False,10,10,0,45,0,1
3,00:10:59,2,False,10,10,0,52,4,1
3,00:08:59,2,True,10,10,0,47,20,1
3,00:04:10,1,False,17,10,7,10,10,1
3,00:01:42,1,True,17,17,0,29,10,1
4,00:14:12,2,False,17,17,0,31,7,1
4,00:12:29,1,True,17,17,0,44,10,1
4,00:08:35,1,False,17,17,0,22,10,1
4,00:07:57,1,False,17,17,0,42,10,1
4,00:07:03,2,False,17,17,0,53,10,1
4,00:04:50,1,True,17,20,-3,35,10,1
4,00:03:32,1,False,20,17,3,43,10,1
4,00:02:31,2,False,20,17,3,29,10,1
4,00:02:24,1,False,20,24,-4,31,10,1
1,00:13:20,1,False,0,0,0,50,10,1
1,00:11:17,1,True,0,0,0,11,10,1
1,00:09:51,1,False,7,0,7,54,10,1
1,00:08:20,1,False,7,0,7,24,15,1
1,00:05:11,2,False,7,0,7,52,4,1
2,00:13:54,2,True,0,7,-7,27,19,1
2,00:13:16,1,False,7,0,7,23,10,1
2,00:11:47,2,True,0,7,-7,55,5,1
2,00:08:56,1,False,7,1,6,27,10,1
2,00:06:15,1,True,8,7,1,42,10,1
2,00:04:55,1,True,8,10,-2,35,10,1
2,00:03:32,1,False,10,8,2,25,10,1
2,00:02:42,2,False,10,8,2,33,10,1
2,00:02:18,2,False,10,8,2,18,9,1
2,00:01:48,1,False,10,9,1,35,10,1
2,00:01:08,1,True,9,10,-1,43,10,1
3,00:11:10,2,False,10,9,1,43,10,1
3,00:10:40,1,False,10,9,1,55,10,1
3,00:09:49,2,True,9,10,-1,51,6,1
3,00:08:33,2,True,9,10,-1,39,20,1
3,00:07:10,1,True,9,13,-4,35,10,1
3,00:06:20,2,True,9,13,-4,55,8,1
3,00:03:34,1,False,13,9,4,33,10,1
3,00:02:35,2,False,13,9,4,46,10,1
3,00:02:00,1,True,9,13,-4,53,10,1
3,00:00:50,1,True,9,13,-4,53,25,1
4,00:14:03,2,True,9,16,-7,39,6,1
4,00:13:02,2,True,9,16,-7,45,10,1
4,00:11:39,2,False,16,9,7,39,11,1
4,00:08:40,1,True,12,16,-4,54,10,1
4,00:05:14,2,True,12,19,-7,28,17,1
4,00:02:35,2,True,12,19,-7,43,19,1
4,00:01:44,1,True,12,22,-10,35,10,1
1,00:14:56,1,False,0,0,0,41,10,1
1,00:13:16,1,False,0,0,0,53,10,1
1,00:12:38,2,False,0,0,0,48,5,1
1,00:11:30,1,False,0,0,0,43,10,1
1,00:07:37,1,True,3,0,3,33,10,1
1,00:07:05,1,True,3,0,3,46,10,1
1,00:05:19,2,True,3,0,3,48,5,1
1,00:03:11,1,True,3,0,3,7,10,1
1,00:01:04,2,True,3,2,1,20,10,1
1,00:00:49,1,True,3,2,1,8,8,1
2,00:14:14,1,True,3,5,-2,35,10,1
2,00:13:40,1,True,3,5,-2,50,10,1
2,00:13:12,2,False,5,3,2,52,2,1
2,00:12:03,1,False,5,3,2,37,10,1
2,00:10:45,1,True,10,5,5,50,10,1
2,00:09:26,1,False,5,10,-5,18,10,1
2,00:08:15,1,True,10,5,5,54,10,1
2,00:08:01,1,False,5,10,-5,25,10,1
2,00:06:31,2,False,5,10,-5,7,7,1
2,00:05:53,2,False,5,17,-12,32,8,1
2,00:05:29,1,False,5,17,-12,47,10,1
2,00:03:06,1,True,17,5,12,9,10,1
2,00:01:57,1,False,5,17,-12,52,10,1
2,00:00:33,1,True,17,5,12,16,10,1
3,00:14:53,1,True,17,8,9,40,10,1
3,00:14:21,1,False,8,17,-9,54,10,1
3,00:13:46,1,False,8,17,-9,43,10,1
3,00:12:40,1,False,8,17,-9,32,10,1
3,00:11:30,1,False,8,24,-16,23,10,1
3,00:10:01,2,False,8,31,-23,47,10,1
3,00:09:35,1,False,8,31,-23,35,10,1
3,00:07:32,2,False,8,34,-26,35,7,1
3,00:04:05,1,True,34,8,26,20,10,1
3,00:03:00,1,False,8,34,-26,55,10,1
3,00:00:51,1,True,34,8,26,31,10,1
3,00:00:16,2,True,34,8,26,25,4,1
4,00:12:22,2,True,34,15,19,43,10,1
4,00:11:13,2,True,34,15,19,21,10,1
4,00:10:44,1,True,34,15,19,10,10,1
4,00:09:12,2,True,34,15,19,5,5,1
4,00:08:49,1,True,34,22,12,27,10,1
4,00:08:23,2,True,34,22,12,31,6,1
4,00:03:34,2,False,22,37,-15,38,7,1
4,00:02:29,3,False,22,37,-15,51,10,1
4,00:02:21,1,True,37,22,15,42,10,1
4,00:01:57,1,True,37,22,15,15,10,1
4,00:00:10,1,False,29,37,-8,33,10,1
1,00:14:29,2,False,0,0,0,38,10,1
1,00:13:04,1,True,7,0,7,50,15,1
1,00:12:25,2,True,7,0,7,46,11,1
1,00:07:46,2,True,7,1,6,50,10,1
1,00:05:25,2,False,1,7,-6,33,7,1
1,00:04:18,1,False,1,7,-6,18,10,1
1,00:03:00,1,False,1,10,-9,36,10,1
1,00:00:43,2,True,10,1,9,46,10,1
2,00:15:00,1,True,10,2,8,39,10,1
2,00:14:39,1,False,2,10,-8,38,10,1
2,00:12:18,2,False,2,13,-11,35,10,1
2,00:05:26,2,False,2,13,-11,25,5,1
2,00:04:43,1,False,2,13,-11,39,10,1
2,00:03:00,2,True,13,2,11,43,10,1
2,00:02:44,1,True,13,2,11,32,10,1
2,00:02:27,1,True,13,2,11,18,10,1
2,00:00:36,2,False,5,13,-8,29,16,1
3,00:14:55,1,False,5,16,-11,27,10,1
3,00:12:24,1,True,16,5,11,46,10,1
3,00:12:06,2,True,16,5,11,38,2,1
3,00:06:36,1,False,8,23,-15,42,10,1
3,00:06:05,2,False,8,23,-15,49,3,1
3,00:05:06,1,True,23,15,8,34,10,1
3,00:02:21,1,False,21,23,-2,53,10,1
3,00:01:29,2,True,23,21,2,54,7,1
3,00:00:51,2,True,23,28,-5,32,10,1
3,00:00:22,1,True,23,28,-5,43,10,1
4,00:14:49,1,False,28,23,5,45,10,1
4,00:14:29,1,False,28,30,-2,46,10,1
4,00:13:58,2,False,28,30,-2,50,6,1
4,00:11:22,2,False,28,30,-2,52,10,1
4,00:08:58,1,False,29,30,-1,48,10,1
4,00:08:31,1,True,30,29,1,50,10,1
4,00:08:05,2,True,30,29,1,43,3,1
4,00:07:37,1,True,30,29,1,24,10,1
4,00:04:26,1,True,30,30,0,45,10,1
4,00:03:10,2,True,30,30,0,30,5,1
4,00:01:17,2,True,30,30,0,5,4,1
4,00:01:11,1,True,30,37,-7,41,10,1
4,00:00:51,1,False,37,30,7,13,10,1
1,00:14:52,1,False,0,0,0,27,10,1
1,00:14:29,1,False,0,0,0,39,10,1
1,00:13:04,1,True,0,0,0,26,10,1
1,00:11:34,1,False,0,0,0,18,10,1
1,00:10:03,1,False,0,0,0,38,10,1
1,00:04:11,2,True,7,0,7,55,14,1
1,00:03:17,1,False,0,7,-7,10,10,1
1,00:02:43,2,False,0,7,-7,16,4,1
1,00:02:14,1,False,0,7,-7,22,10,1
1,00:01:42,2,False,0,7,-7,28,4,1
2,00:14:23,2,False,0,14,-14,25,11,1
2,00:12:59,2,True,14,0,14,51,15,1
2,00:11:14,1,False,0,14,-14,30,10,1
2,00:10:16,2,False,0,14,-14,45,10,1
2,00:09:06,1,True,14,0,14,50,15,1
2,00:05:40,1,False,0,14,-14,45,10,1
2,00:05:19,1,False,0,14,-14,33,10,1
2,00:04:39,2,False,0,14,-14,26,3,1
2,00:03:57,2,False,0,14,-14,18,10,1
2,00:03:05,1,False,0,14,-14,5,5,1
2,00:01:51,2,True,21,0,21,24,10,1
2,00:01:45,1,True,21,0,21,36,10,1
2,00:01:12,1,True,21,0,21,52,10,1
2,00:00:59,1,True,28,0,28,40,10,1
2,00:00:40,1,True,28,0,28,28,10,1
2,00:00:36,2,True,28,0,28,25,7,1
3,00:14:50,1,True,35,0,35,48,10,1
3,00:13:41,1,False,0,35,-35,36,10,1
3,00:12:05,1,False,0,35,-35,42,10,1
3,00:11:39,1,False,0,35,-35,31,10,1
3,00:09:44,2,False,0,38,-38,35,10,1
3,00:08:21,2,True,38,0,38,26,4,1
3,00:07:45,1,True,38,0,38,54,10,1
3,00:06:31,2,False,0,38,-38,40,7,1
3,00:04:41,1,False,0,41,-41,18,10,1
3,00:01:33,1,True,44,0,44,44,10,1
4,00:13:30,1,True,44,0,44,21,10,1
4,00:12:54,2,True,44,0,44,14,3,1
4,00:07:45,2,True,44,0,44,53,10,1
4,00:04:35,1,False,0,51,-51,45,10,1
4,00:03:20,2,False,0,51,-51,26,6,1
4,00:02:33,1,False,0,52,-52,35,10,1
1,00:10:49,2,True,0,0,0,26,12,1
1,00:08:09,1,False,3,7,-4,33,10,1
1,00:03:19,1,True,7,3,4,40,10,1
1,00:00:01,2,True,7,3,4,8,8,1
2,00:14:28,1,True,7,6,1,25,20,1
2,00:07:12,2,True,7,9,-2,27,15,1
2,00:02:28,2,False,9,10,-1,39,6,1
2,00:02:23,1,False,9,10,-1,45,10,1
2,00:02:05,2,False,9,10,-1,48,7,1
2,00:01:44,1,True,10,9,1,49,10,1
2,00:01:24,2,True,10,9,1,43,4,1
3,00:06:14,2,False,13,17,-4,43,12,1
3,00:04:22,1,True,17,13,4,35,10,1
3,00:03:45,2,True,17,13,4,41,4,1
3,00:01:19,1,True,17,13,4,48,10,1
4,00:14:21,2,False,13,17,-4,31,8,1
4,00:09:06,1,True,24,13,11,33,10,1
4,00:08:16,1,False,13,24,-11,32,10,1
4,00:07:18,1,False,13,25,-12,35,10,1
4,00:06:40,1,False,13,25,-12,46,10,1
4,00:01:45,2,False,13,25,-12,45,22,1
4,00:00:31,3,True,25,13,12,50,34,1
1,00:14:41,1,False,0,0,0,37,10,1
1,00:13:35,2,False,0,0,0,19,5,1
1,00:10:22,1,True,7,0,7,26,10,1
1,00:09:50,1,True,7,0,7,37,10,1
1,00:08:19,1,False,0,7,-7,28,10,1
1,00:07:10,2,False,0,7,-7,52,5,1
1,00:04:34,2,True,7,3,4,47,10,1
1,00:02:10,1,True,7,3,4,20,10,1
1,00:01:17,2,True,7,10,-3,33,7,1
1,00:00:14,2,True,7,10,-3,42,10,1
2,00:09:38,2,False,10,7,3,42,10,1
2,00:06:48,2,False,11,7,4,28,5,1
2,00:02:32,2,True,7,11,-4,36,10,1
2,00:01:34,2,False,14,7,7,41,10,1
2,00:01:25,1,False,14,7,7,51,10,1
2,00:00:55,1,True,7,14,-7,18,10,1
3,00:15:00,1,True,7,14,-7,39,10,1
3,00:13:50,2,True,7,14,-7,52,10,1
3,00:11:19,1,True,9,14,-5,55,10,1
3,00:10:25,2,False,14,9,5,36,10,1
3,00:09:07,2,False,14,9,5,20,5,1
3,00:07:52,1,False,14,16,-2,22,10,1
3,00:06:28,1,True,16,14,2,47,10,1
3,00:04:32,1,False,14,16,-2,4,4,1
3,00:04:12,1,False,14,23,-9,35,10,1
3,00:01:47,1,True,23,14,9,34,10,1
3,00:01:02,2,True,23,14,9,20,10,1
3,00:00:31,1,True,23,14,9,8,8,1
4,00:13:56,1,True,23,21,2,37,10,1
4,00:08:32,1,True,23,21,2,41,10,1
4,00:07:09,1,False,21,23,-2,27,10,1
4,00:03:01,2,True,23,21,2,34,15,1
4,00:01:51,1,False,24,23,1,43,10,1
4,00:01:47,2,False,24,23,1,48,5,1
1,00:14:30,2,False,0,0,0,31,10,1
1,00:13:40,1,True,0,0,0,51,10,1
1,00:13:04,1,True,0,0,0,37,10,1
1,00:09:19,2,False,7,0,7,17,10,1
1,00:08:21,1,False,7,3,4,11,10,1
1,00:05:51,1,True,3,8,-5,53,10,1
1,00:05:21,2,False,8,3,5,50,3,1
1,00:01:08,1,False,8,6,2,35,10,1
2,00:09:19,2,True,6,8,-2,30,10,1
2,00:09:00,1,False,8,13,-5,27,10,1
2,00:05:28,1,True,13,8,5,36,10,1
2,00:03:09,1,False,8,13,-5,23,10,1
2,00:02:45,2,False,8,13,-5,27,6,1
2,00:02:33,1,False,8,13,-5,38,10,1
2,00:01:50,1,False,8,13,-5,54,5,1
2,00:01:43,1,True,13,8,5,39,10,1
2,00:01:16,2,True,13,8,5,23,8,1
2,00:00:17,2,True,13,8,5,6,4,1
3,00:14:53,1,True,13,15,-2,25,10,1
3,00:11:05,1,False,15,13,2,53,10,1
3,00:10:16,2,True,13,15,-2,44,10,1
3,00:09:26,1,True,13,15,-2,26,10,1
3,00:07:01,2,True,13,22,-9,29,5,1
3,00:06:29,3,True,13,22,-9,26,8,1
3,00:06:06,1,False,22,13,9,53,10,1
3,00:05:27,2,False,22,13,9,44,11,1
3,00:03:23,1,True,16,22,-6,25,10,1
3,00:01:50,2,True,16,22,-6,48,9,1
3,00:00:01,1,False,22,16,6,28,10,1
4,00:13:03,2,False,22,19,3,34,11,1
4,00:11:30,2,True,19,22,-3,30,14,1
4,00:10:49,1,False,22,19,3,49,10,1
4,00:09:30,2,True,19,22,-3,42,5,1
4,00:09:04,1,True,19,22,-3,35,10,1
4,00:06:47,2,True,19,22,-3,9,10,1
4,00:05:37,1,False,22,19,3,46,10,1
4,00:03:01,2,True,19,22,-3,25,10,1
4,00:02:32,1,True,19,22,-3,38,10,1
4,00:02:07,3,True,19,22,-3,42,6,1
4,00:01:58,1,False,22,19,3,36,10,1
4,00:01:18,1,False,22,19,3,15,10,1
4,00:00:58,2,False,22,26,-4,21,17,1
4,00:00:52,3,False,22,26,-4,30,8,1
4,00:00:40,2,False,22,26,-4,47,5,1
4,00:00:24,2,False,22,26,-4,52,15,1
4,00:00:12,3,True,26,22,4,45,2,1
1,00:14:29,2,False,0,0,0,36,9,1
1,00:13:26,1,True,0,0,0,29,10,1
1,00:12:19,2,True,0,0,0,40,10,1
1,00:11:43,1,False,0,0,0,34,10,1
1,00:10:05,2,False,0,0,0,23,10,1
1,00:06:57,2,False,0,8,-8,37,8,1
1,00:05:33,1,False,0,8,-8,50,10,1
1,00:01:23,1,True,8,7,1,27,10,1
1,00:00:43,1,True,8,7,1,42,10,1
2,00:13:44,2,False,7,8,-1,21,6,1
2,00:13:17,1,False,7,8,-1,31,10,1
2,00:11:47,1,False,7,8,-1,43,10,1
2,00:10:02,2,True,8,7,1,50,11,1
2,00:06:47,1,True,8,14,-6,53,10,1
2,00:06:14,2,True,8,14,-6,47,4,1
2,00:04:15,1,True,8,14,-6,25,10,1
2,00:03:15,2,True,8,14,-6,33,13,1
2,00:01:05,1,True,8,14,-6,52,10,1
3,00:14:32,1,True,8,17,-9,50,10,1
3,00:13:59,2,True,8,17,-9,55,5,1
3,00:12:55,2,True,8,17,-9,55,20,1
3,00:11:26,2,False,17,8,9,29,5,1
3,00:09:25,2,False,17,8,9,15,6,1
3,00:08:35,1,False,17,8,9,3,3,1
3,00:08:12,1,False,17,15,2,41,10,1
3,00:07:45,2,False,17,15,2,46,5,1
3,00:07:12,1,False,17,15,2,51,10,1
3,00:04:51,1,True,15,20,-5,47,10,1
3,00:00:15,2,False,20,15,5,44,9,1
4,00:14:09,2,True,15,20,-5,27,10,1
4,00:12:03,1,False,20,15,5,41,10,1
4,00:11:33,1,True,15,27,-12,31,10,1
4,00:09:55,2,True,15,27,-12,51,5,1
4,00:09:02,2,False,27,22,5,35,4,1
4,00:07:05,1,True,22,27,-5,51,10,1
4,00:05:46,2,False,27,22,5,42,4,1
4,00:03:20,2,False,27,22,5,7,7,1
4,00:01:17,1,True,22,27,-5,27,10,1
4,00:00:52,2,True,22,27,-5,46,10,1
4,00:00:45,1,False,27,22,5,44,10,1
4,00:00:30,3,False,27,22,5,38,4,1
4,00:00:18,2,False,27,22,5,31,10,1
1,00:14:51,1,True,0,0,0,27,10,1
1,00:12:06,1,True,0,0,0,51,10,1
1,00:11:42,2,False,0,0,0,32,6,1
1,00:10:40,1,False,0,0,0,25,10,1
1,00:09:26,1,False,0,0,0,8,8,1
1,00:09:06,1,False,0,7,-7,23,10,1
1,00:03:21,1,True,10,0,10,51,10,1
1,00:01:33,1,False,0,10,-10,16,10,1
2,00:14:22,1,True,17,0,17,35,10,1
2,00:12:17,1,False,0,17,-17,37,10,1
2,00:07:05,2,False,0,17,-17,43,8,1
2,00:03:00,2,True,17,0,17,41,5,1
2,00:01:54,1,True,17,3,14,35,10,1
2,00:00:58,1,False,3,17,-14,25,10,1
2,00:00:50,2,False,3,24,-21,18,18,1
2,00:00:24,1,True,24,3,21,46,10,1
3,00:14:53,1,False,3,24,-21,27,10,1
3,00:14:05,2,False,3,24,-21,31,6,1
3,00:11:35,2,True,24,3,21,16,9,1
3,00:10:29,1,False,3,24,-21,44,10,1
3,00:09:38,1,True,24,3,21,42,10,1
3,00:08:55,2,True,24,3,21,38,6,1
3,00:06:15,1,False,3,24,-21,36,10,1
3,00:04:11,2,True,24,3,21,42,7,1
3,00:02:25,1,True,24,4,20,35,10,1
3,00:00:55,1,True,24,4,20,46,10,1
3,00:00:07,2,True,24,4,20,54,2,1
4,00:12:35,1,False,4,25,-21,35,10,1
4,00:12:01,1,False,4,25,-21,48,10,1
4,00:10:51,1,True,25,4,21,15,10,1
4,00:08:15,1,False,7,25,-18,30,10,1
4,00:07:44,1,False,7,25,-18,47,10,1
4,00:04:30,1,True,25,7,18,37,10,1
4,00:02:59,1,True,25,7,18,26,10,1
1,00:12:57,1,True,0,0,0,29,10,1
1,00:11:24,1,True,0,7,-7,31,10,1
1,00:09:44,1,True,0,14,-14,32,10,1
1,00:08:25,2,False,14,0,14,37,15,1
1,00:07:28,1,False,14,3,11,31,10,1
1,00:07:08,1,False,14,3,11,44,10,1
1,00:04:29,2,True,3,14,-11,24,12,1
2,00:12:13,1,True,11,14,-3,44,10,1
2,00:09:02,1,True,11,17,-6,34,10,1
2,00:07:52,1,True,11,20,-9,22,10,1
2,00:07:15,2,True,11,20,-9,28,4,1
2,00:06:42,1,True,11,20,-9,34,10,1
2,00:05:10,1,False,20,11,9,9,10,1
2,00:02:52,1,False,20,13,7,23,10,1
2,00:02:19,2,False,20,13,7,46,8,1
2,00:01:28,2,True,13,20,-7,46,5,1
2,00:00:56,2,True,13,20,-7,28,6,1
2,00:00:18,2,True,13,20,-7,25,13,1
3,00:14:48,1,True,13,23,-10,37,10,1
3,00:13:49,1,False,23,13,10,8,10,1
3,00:11:26,1,False,23,27,-4,35,10,1
3,00:10:18,1,True,27,23,4,54,10,1
3,00:09:49,1,False,23,27,-4,39,10,1
3,00:09:20,2,False,23,27,-4,32,3,1
3,00:07:38,1,False,23,30,-7,35,10,1
3,00:07:07,1,True,30,23,7,48,10,1
3,00:05:17,1,True,30,24,6,30,15,1
3,00:03:40,2,True,30,24,6,49,7,1
3,00:01:45,1,False,24,33,-9,35,10,1
3,00:00:50,1,False,24,33,-9,50,10,1
4,00:10:28,2,True,33,24,9,42,10,1
4,00:10:11,1,True,33,31,2,33,10,1
4,00:09:07,2,True,33,31,2,29,14,1
4,00:06:29,2,True,33,31,2,40,8,1
4,00:06:04,1,True,33,31,2,32,10,1
4,00:03:58,2,True,33,34,-1,40,5,1
4,00:02:17,2,True,33,34,-1,45,9,1
4,00:01:38,2,True,33,37,-4,35,10,1
1,00:14:46,1,False,0,0,0,30,10,1
1,00:13:53,2,False,0,0,0,44,8,1
1,00:08:36,2,False,8,0,8,37,25,1
1,00:05:26,2,True,0,11,-11,44,11,1
1,00:04:58,1,False,11,0,11,52,10,1
1,00:01:40,2,False,11,0,11,42,10,1
2,00:12:52,1,False,11,3,8,25,10,1
2,00:09:32,2,True,3,11,-8,47,10,1
2,00:08:47,1,False,11,3,8,49,10,1
2,00:07:22,1,False,11,3,8,38,10,1
2,00:05:58,2,False,11,3,8,31,3,1
2,00:05:17,1,False,11,10,1,23,10,1
2,00:04:47,2,False,11,10,1,20,7,1
2,00:02:24,2,False,11,13,-2,47,10,1
2,00:02:17,1,False,11,20,-9,38,10,1
2,00:01:51,2,False,11,20,-9,51,10,1
2,00:01:24,2,True,20,12,8,35,10,1
3,00:14:47,1,True,20,12,8,40,10,1
3,00:12:26,2,True,20,12,8,22,10,1
3,00:11:52,1,True,20,12,8,52,10,1
3,00:10:42,2,False,12,20,-8,10,4,1
3,00:06:36,1,True,23,12,11,36,10,1
3,00:05:40,1,True,23,12,11,36,20,1
3,00:05:07,2,True,23,12,11,40,16,1
3,00:02:57,1,False,12,23,-11,8,10,1
3,00:02:37,2,False,12,23,-11,15,3,1
3,00:02:09,1,False,12,23,-11,31,10,1
3,00:01:39,1,False,12,23,-11,50,10,1
4,00:12:24,2,True,23,15,8,49,10,1
4,00:11:50,1,True,23,15,8,30,10,1
4,00:10:51,1,True,23,15,8,15,10,1
4,00:09:39,1,False,23,23,0,54,10,1
4,00:07:40,1,True,23,30,-7,34,10,1
4,00:07:10,2,True,23,30,-7,41,3,1
4,00:05:08,1,False,30,23,7,22,10,1
4,00:04:44,2,False,30,23,7,25,3,1
4,00:00:53,1,True,23,31,-8,35,10,1
4,00:00:48,1,True,23,31,-8,45,10,1
4,00:00:14,2,False,31,23,8,17,7,1
1,00:13:40,1,False,0,0,0,25,10,1
1,00:12:21,2,False,0,0,0,8,8,1
1,00:11:10,1,True,7,7,0,25,10,1
1,00:10:51,1,False,7,7,0,52,10,1
1,00:09:49,1,False,7,7,0,42,10,1
1,00:08:33,1,False,7,8,-1,40,10,1
1,00:08:05,2,False,7,8,-1,48,2,1
1,00:04:34,2,True,8,7,1,9,9,1
1,00:02:53,1,False,14,8,6,32,10,1
1,00:02:21,2,False,14,8,6,38,4,1
1,00:01:12,1,False,14,8,6,46,10,1
1,00:00:36,1,True,8,21,-13,36,10,1
2,00:13:18,2,False,21,15,6,50,5,1
2,00:10:54,2,True,15,21,-6,35,10,1
2,00:08:13,1,True,15,24,-9,37,10,1
2,00:07:23,2,False,24,22,2,29,10,1
2,00:06:20,1,True,22,24,-2,38,10,1
2,00:05:50,1,True,22,24,-2,53,10,1
2,00:02:41,2,False,24,25,-1,26,8,1
2,00:02:26,1,False,24,25,-1,40,10,1
2,00:01:33,2,True,25,24,1,29,5,1
2,00:01:17,1,True,25,24,1,6,6,1
2,00:00:58,1,True,25,31,-6,38,15,1
3,00:14:24,2,False,31,25,6,48,10,1
3,00:12:13,1,True,25,34,-9,35,10,1
3,00:11:06,2,False,34,25,9,25,10,1
3,00:10:00,3,False,34,25,9,20,5,1
3,00:08:15,1,False,34,32,2,48,10,1
3,00:07:33,1,True,32,34,-2,51,10,1
3,00:04:43,1,True,32,34,-2,25,10,1
3,00:04:06,2,True,32,34,-2,25,10,1
3,00:03:36,1,True,32,34,-2,39,10,1
3,00:01:21,1,False,34,32,2,19,10,1
3,00:00:50,1,False,34,32,2,30,10,1
3,00:00:05,2,False,34,32,2,37,3,1
4,00:14:41,2,False,34,32,2,43,10,1
4,00:14:02,1,True,32,34,-2,53,10,1
4,00:11:01,2,True,32,34,-2,51,9,1
4,00:10:03,1,False,34,32,2,29,10,1
4,00:08:00,1,True,32,34,-2,39,10,1
4,00:07:37,1,False,34,32,2,39,10,1
4,00:06:40,2,False,34,32,2,19,4,1
4,00:05:11,2,False,34,32,2,10,10,1
4,00:02:46,1,True,39,34,5,15,10,1
4,00:02:12,2,True,39,34,5,33,5,1
4,00:00:30,1,False,34,39,-5,44,10,1
4,00:00:23,1,True,39,34,5,44,10,1
1,00:14:51,1,False,0,0,0,47,10,1
1,00:11:46,2,False,0,2,-2,51,4,1
1,00:10:59,1,False,0,2,-2,27,10,1
1,00:09:53,2,False,0,2,-2,16,10,1
1,00:05:26,1,True,5,0,5,29,10,1
2,00:15:00,2,True,5,0,5,5,12,1
2,00:14:11,1,True,5,0,5,18,10,1
2,00:12:48,2,True,5,0,5,35,6,1
2,00:12:28,1,True,5,0,5,45,10,1
2,00:11:51,2,True,5,0,5,50,5,1
2,00:11:10,1,False,0,5,-5,50,10,1
2,00:10:46,1,False,0,5,-5,39,10,1
2,00:06:01,1,True,8,0,8,25,10,1
2,00:05:37,2,True,8,0,8,25,10,1
2,00:04:26,2,True,8,0,8,38,8,1
2,00:03:07,1,False,0,8,-8,14,10,1
2,00:02:40,1,False,0,15,-15,29,10,1
2,00:02:33,2,False,0,15,-15,27,12,1
2,00:02:03,1,False,0,15,-15,55,10,1
2,00:01:28,1,True,15,0,15,13,10,1
2,00:01:03,1,False,0,15,-15,23,10,1
2,00:00:45,1,False,0,15,-15,45,10,1
2,00:00:17,2,False,0,15,-15,32,6,1
3,00:14:53,1,False,0,15,-15,27,10,1
3,00:11:54,1,False,0,15,-15,16,10,1
3,00:10:50,1,False,0,15,-15,27,10,1
3,00:10:10,2,False,0,15,-15,33,4,1
3,00:08:09,1,True,15,0,15,36,10,1
3,00:06:12,2,True,15,0,15,26,10,1
3,00:05:30,1,True,15,0,15,13,10,1
3,00:03:13,2,True,15,0,15,2,2,1
3,00:01:22,1,False,7,15,-8,36,10,1
4,00:14:34,1,False,7,22,-15,28,15,1
4,00:12:12,2,False,7,22,-15,1,13,1
4,00:10:41,2,False,7,22,-15,15,10,1
4,00:08:19,1,False,7,29,-22,53,10,1
4,00:07:39,2,True,29,7,22,50,3,1
4,00:07:03,1,True,29,7,22,35,10,1
4,00:05:54,2,True,29,14,15,50,6,1
4,00:04:34,2,False,14,29,-15,43,8,1
4,00:03:52,1,False,14,29,-15,25,10,1
4,00:02:26,1,False,14,36,-22,45,10,1
4,00:02:08,2,True,36,14,22,50,10,1
4,00:01:57,2,True,36,14,22,44,16,1
4,00:01:10,1,False,14,36,-22,50,10,1
1,00:13:21,2,True,0,0,0,49,10,1
1,00:11:43,1,False,0,0,0,27,10,1
1,00:09:44,2,False,0,0,0,12,11,1
1,00:05:58,1,False,0,7,-7,18,10,1
1,00:04:39,1,False,0,7,-7,32,10,1
1,00:03:34,2,False,0,7,-7,12,10,1
1,00:01:35,1,False,0,16,-16,53,10,1
2,00:13:58,1,False,0,16,-16,32,10,1
2,00:12:29,1,False,0,16,-16,49,10,1
2,00:10:08,1,True,16,0,16,53,10,1
2,00:08:50,1,True,16,6,10,52,10,1
2,00:07:10,1,False,6,16,-10,11,10,1
2,00:05:25,2,False,6,23,-17,17,10,1
2,00:03:50,2,True,23,6,17,48,13,1
2,00:01:40,1,False,6,24,-18,14,10,1
2,00:01:32,1,False,6,31,-25,20,10,1
3,00:14:53,1,False,6,31,-25,28,10,1
3,00:14:10,2,False,6,31,-25,35,3,1
3,00:13:50,1,False,6,31,-25,46,10,1
3,00:12:46,2,True,31,6,25,53,10,1
3,00:10:44,2,True,31,6,25,17,10,1
3,00:08:55,2,True,31,21,10,38,7,1
3,00:07:59,1,False,21,31,-10,29,10,1
3,00:06:20,1,True,31,21,10,26,10,1
3,00:04:37,2,True,31,21,10,44,4,1
3,00:03:39,2,False,21,31,-10,25,3,1
3,00:01:49,1,False,21,38,-17,36,10,1
4,00:13:23,1,True,38,21,17,43,10,1
4,00:12:40,2,True,38,21,17,40,7,1
4,00:10:07,2,True,38,24,14,45,10,1
4,00:09:20,1,False,24,38,-14,52,10,1
4,00:04:07,2,False,24,41,-17,43,6,1
4,00:01:20,2,True,44,24,20,52,10,1
4,00:00:54,2,True,44,24,20,40,10,1
4,00:00:29,2,True,44,24,20,35,20,1
4,00:00:23,3,True,44,24,20,18,3,1
4,00:00:01,1,True,44,24,20,7,7,1
1,00:14:54,1,True,0,0,0,32,10,1
1,00:13:21,1,True,0,0,0,42,10,1
1,00:12:58,1,False,0,0,0,46,10,1
1,00:11:40,2,False,0,0,0,35,10,1
1,00:10:55,1,False,0,0,0,23,10,1
1,00:09:26,1,False,0,7,-7,37,10,1
1,00:07:44,2,False,0,7,-7,43,15,1
1,00:05:47,2,True,7,0,7,30,15,1
1,00:03:53,1,False,0,7,-7,20,10,1
1,00:02:50,2,False,0,7,-7,12,2,1
1,00:01:06,1,False,0,14,-14,52,10,1
2,00:14:43,1,False,0,17,-17,35,10,1
2,00:11:29,2,False,0,17,-17,33,10,1
2,00:10:36,1,False,0,20,-20,35,10,1
2,00:09:49,2,False,0,20,-20,49,10,1
2,00:08:45,1,True,20,0,20,30,10,1
2,00:05:24,1,False,3,20,-17,48,10,1
2,00:04:14,2,True,20,3,17,48,9,1
2,00:03:03,1,True,20,3,17,15,10,1
2,00:02:23,2,True,20,4,16,35,10,1
2,00:01:48,1,False,4,20,-16,32,10,1
2,00:00:55,1,True,20,4,16,25,10,1
2,00:00:23,1,True,20,4,16,12,10,1
3,00:14:11,1,False,11,27,-16,37,10,1
3,00:13:16,2,False,11,27,-16,33,14,1
3,00:10:53,1,False,11,27,-16,35,10,1
3,00:09:51,1,False,11,27,-16,47,10,1
3,00:08:10,1,True,27,11,16,13,10,1
3,00:06:55,2,True,27,11,16,39,2,1
3,00:06:28,1,False,11,27,-16,45,10,1
3,00:03:55,1,False,11,27,-16,34,10,1
3,00:03:09,2,True,27,11,16,34,10,1
4,00:13:02,1,True,27,17,10,44,10,1
4,00:12:30,1,True,27,17,10,25,10,1
4,00:11:06,1,True,27,17,10,14,10,1
4,00:09:39,1,False,17,27,-10,50,10,1
4,00:08:59,1,True,27,17,10,50,10,1
4,00:08:29,2,True,27,17,10,49,9,1
4,00:07:28,1,True,27,17,10,38,10,1
4,00:03:47,2,False,24,27,-3,40,5,1
4,00:02:23,1,False,24,27,-3,1,10,1
4,00:02:19,2,False,24,27,-3,8,3,1
4,00:00:50,1,True,27,24,3,40,10,1
1,00:14:28,2,False,0,0,0,36,10,1
1,00:13:10,2,False,0,0,0,54,3,1
1,00:09:21,2,True,0,7,-7,23,7,1
1,00:08:12,2,True,0,7,-7,35,9,1
1,00:06:18,1,False,7,0,7,16,10,1
1,00:03:10,1,True,0,7,-7,20,10,1
1,00:01:05,2,True,0,7,-7,13,13,1
1,00:00:15,2,True,0,14,-14,18,7,1
2,00:12:45,2,True,0,14,-14,19,10,1
2,00:11:20,1,True,0,14,-14,51,10,1
2,00:10:17,1,True,0,15,-15,35,10,1
2,00:07:41,1,False,15,1,14,35,10,1
2,00:05:45,1,True,1,15,-14,35,10,1
2,00:01:57,1,True,1,15,-14,25,10,1
2,00:01:12,1,False,15,1,14,45,10,1
2,00:00:53,2,True,1,15,-14,53,10,1
3,00:14:53,1,True,1,22,-21,10,10,1
3,00:13:01,2,True,1,22,-21,48,5,1
3,00:12:16,1,True,1,22,-21,10,10,1
3,00:11:08,2,True,1,22,-21,3,3,1
3,00:10:03,1,True,1,29,-28,4,4,1
3,00:08:43,2,True,1,36,-35,36,6,1
3,00:07:10,2,False,36,4,32,24,7,1
3,00:05:25,1,False,36,4,32,50,10,1
3,00:00:13,2,True,6,36,-30,37,10,1
4,00:12:56,2,True,6,39,-33,27,18,1
4,00:11:35,2,False,39,6,33,27,10,1
4,00:08:48,2,True,6,39,-33,44,10,1
4,00:08:20,1,False,39,6,33,31,10,1
4,00:07:55,2,False,39,6,33,25,4,1
4,00:06:36,2,False,39,6,33,19,10,1
4,00:05:50,1,False,39,12,27,34,10,1
4,00:05:30,2,False,39,12,27,28,4,1
4,00:02:24,1,True,12,39,-27,42,10,1
4,00:02:16,1,True,12,39,-27,54,10,1
4,00:02:06,2,False,39,12,27,51,5,1
4,00:00:51,1,True,15,39,-24,44,10,1
4,00:00:34,3,False,39,15,24,48,7,1
4,00:00:28,0,True,15,39,-24,32,0,1
1,00:10:57,1,False,0,0,0,20,10,1
1,00:07:54,1,False,0,3,-3,46,10,1
1,00:07:08,1,True,3,0,3,37,10,1
1,00:06:00,1,True,3,0,3,25,10,1
1,00:02:04,2,False,0,3,-3,6,9,1
1,00:01:13,1,False,0,3,-3,43,10,1
1,00:00:44,2,False,0,3,-3,48,5,1
1,00:00:01,1,True,3,0,3,30,10,1
2,00:12:29,1,True,3,7,-4,29,10,1
2,00:10:41,2,False,7,3,4,44,10,1
2,00:10:00,1,True,3,7,-4,52,10,1
2,00:07:00,1,True,3,8,-5,35,10,1
2,00:06:18,2,True,3,8,-5,31,14,1
2,00:03:25,2,True,3,8,-5,47,5,1
2,00:02:15,2,False,8,3,5,45,14,1
2,00:00:55,2,False,8,3,5,18,14,1
3,00:14:00,2,True,3,8,-5,22,19,1
3,00:10:34,2,True,3,8,-5,45,16,1
3,00:06:35,2,False,8,3,5,34,7,1
3,00:02:39,1,False,8,3,5,43,10,1
3,00:01:15,2,False,8,4,4,25,20,1
3,00:00:13,1,True,4,8,-4,39,10,1
4,00:14:15,1,False,8,4,4,47,10,1
4,00:13:52,2,False,8,4,4,51,6,1
4,00:12:43,2,True,4,8,-4,47,10,1
4,00:07:40,2,False,9,4,5,48,12,1
4,00:07:05,2,True,4,9,-5,15,10,1
4,00:05:38,1,True,4,16,-12,40,10,1
4,00:04:20,1,False,16,4,12,41,10,1
4,00:02:55,1,True,4,16,-12,50,10,1
4,00:02:38,2,False,16,4,12,53,3,1
4,00:02:34,1,False,16,4,12,38,10,1
4,00:01:10,1,False,16,4,12,17,10,1
1,00:14:54,1,False,0,0,0,36,10,1
1,00:13:35,1,True,0,0,0,30,10,1
1,00:12:46,2,True,0,0,0,45,10,1
1,00:10:32,2,False,0,0,0,6,8,1
1,00:09:50,1,False,0,0,0,15,10,1
1,00:09:07,2,False,0,0,0,15,10,1
1,00:07:27,2,False,0,0,0,51,4,1
1,00:06:09,2,False,0,0,0,6,6,1
1,00:05:28,2,False,0,7,-7,37,6,1
1,00:04:38,1,True,7,0,7,21,10,1
1,00:03:27,2,True,7,0,7,40,4,1
1,00:03:07,1,True,7,0,7,47,10,1
1,00:00:42,2,False,0,7,-7,25,10,1
2,00:14:16,1,False,0,10,-10,17,10,1
2,00:11:23,1,True,10,0,10,38,10,1
2,00:09:02,1,False,0,13,-13,35,10,1
2,00:08:30,2,False,0,13,-13,41,4,1
2,00:07:02,2,True,13,0,13,45,5,1
2,00:06:19,1,True,13,0,13,38,10,1
2,00:03:11,2,True,13,3,10,40,10,1
2,00:02:02,2,False,3,13,-10,33,10,1
2,00:01:24,1,False,3,14,-11,35,10,1
2,00:00:24,1,False,3,14,-11,54,10,1
3,00:13:12,1,False,3,14,-11,38,20,1
3,00:10:59,1,True,14,3,11,50,10,1
3,00:10:17,2,True,14,3,11,53,7,1
3,00:09:38,1,False,3,14,-11,45,10,1
3,00:08:52,2,False,3,14,-11,38,3,1
3,00:05:17,1,False,3,17,-14,35,10,1
3,00:04:34,1,False,3,17,-14,49,10,1
3,00:02:53,1,True,17,3,14,20,10,1
3,00:01:29,3,True,17,3,14,13,3,1
3,00:00:02,1,True,17,6,11,33,10,1
4,00:14:40,2,True,17,6,11,30,13,1
4,00:13:59,1,True,17,6,11,38,10,1
4,00:08:31,1,False,9,17,-8,47,10,1
4,00:07:29,1,False,9,17,-8,41,10,1
4,00:04:11,1,False,9,24,-15,41,10,1
4,00:02:22,2,False,9,24,-15,19,10,1
4,00:02:15,1,False,9,24,-15,29,10,1
4,00:02:10,2,False,9,24,-15,31,8,1
4,00:02:00,1,True,24,9,15,54,10,1
4,00:01:45,2,True,24,9,15,44,10,1
1,00:14:51,1,False,0,0,0,17,10,1
1,00:13:22,2,False,0,0,0,31,6,1
1,00:12:59,1,True,0,0,0,15,10,1
1,00:11:02,2,True,0,7,-7,42,4,1
1,00:09:56,2,False,7,0,7,51,6,1
1,00:08:39,2,False,7,0,7,41,8,1
1,00:07:17,1,False,7,0,7,12,10,1
1,00:06:13,1,False,7,3,4,35,10,1
1,00:02:45,2,False,7,3,4,50,19,1
1,00:02:09,1,True,3,7,-4,36,10,1
1,00:00:41,1,True,3,7,-4,25,10,1
2,00:14:36,1,True,3,7,-4,8,8,1
2,00:14:05,1,True,3,14,-11,41,10,1
2,00:12:56,2,True,3,14,-11,55,9,1
2,00:12:04,1,False,14,3,11,6,10,1
2,00:10:25,1,False,14,3,11,35,10,1
2,00:09:24,2,False,14,3,11,28,3,1
2,00:08:54,1,False,14,11,3,21,10,1
2,00:08:19,2,False,14,11,3,28,3,1
2,00:05:14,2,True,11,14,-3,23,6,1
2,00:03:12,1,True,11,14,-3,40,10,1
2,00:02:54,1,False,14,11,3,38,10,1
2,00:01:45,1,False,14,14,0,35,10,1
2,00:01:38,2,False,14,14,0,40,5,1
2,00:01:16,1,False,14,14,0,53,10,1
2,00:00:49,1,True,14,14,0,44,10,1
2,00:00:26,2,True,14,14,0,26,10,1
2,00:00:14,1,True,14,14,0,16,10,1
3,00:14:54,1,True,14,21,-7,41,10,1
3,00:10:10,1,True,17,21,-4,40,10,1
3,00:09:42,2,True,17,21,-4,44,6,1
3,00:08:25,2,False,21,17,4,49,1,1
3,00:05:25,1,False,21,20,1,35,10,1
3,00:02:49,1,True,20,21,-1,27,10,1
3,00:02:22,2,True,20,21,-1,32,5,1
3,00:01:00,2,True,20,21,-1,45,7,1
3,00:00:25,1,False,21,20,1,52,10,1
4,00:11:22,1,True,28,21,7,45,10,1
4,00:10:51,2,True,28,21,7,49,6,1
4,00:09:17,2,True,28,21,7,54,14,1
4,00:05:29,2,False,21,28,-7,15,19,1
4,00:00:46,1,False,21,36,-15,35,10,1
4,00:00:39,2,False,21,36,-15,43,2,1
4,00:00:32,1,True,36,21,15,54,10,1
4,00:00:24,2,True,36,21,15,47,3,1
1,00:14:40,1,False,0,0,0,40,10,1
1,00:13:49,2,False,0,0,0,40,10,1
1,00:12:47,1,False,0,0,0,18,10,1
1,00:06:41,2,True,0,9,-9,11,5,1
1,00:06:10,1,False,16,0,16,38,10,1
1,00:00:45,1,False,16,7,9,11,10,1
2,00:13:41,2,False,16,7,9,43,8,1
2,00:12:06,2,True,7,16,-9,22,10,1
2,00:09:41,2,True,7,16,-9,51,4,1
2,00:09:03,1,False,16,7,9,48,10,1
2,00:02:17,1,False,16,10,6,49,10,1
2,00:02:08,1,False,16,10,6,26,10,1
3,00:14:50,1,True,13,16,-3,34,10,1
3,00:11:15,2,True,13,16,-3,48,10,1
3,00:08:56,2,True,13,16,-3,29,12,1
3,00:07:47,1,True,13,16,-3,13,8,1
3,00:07:28,1,True,13,23,-10,16,10,1
3,00:05:43,1,False,23,13,10,34,10,1
3,00:04:00,1,True,13,23,-10,16,10,1
4,00:14:46,1,False,23,13,10,27,10,1
4,00:14:19,1,False,23,13,10,46,10,1
4,00:12:34,2,True,13,23,-10,38,10,1
4,00:12:04,1,True,13,23,-10,20,10,1
4,00:09:07,2,True,13,30,-17,30,10,1
4,00:06:37,1,False,30,13,17,40,10,1
4,00:05:45,2,False,30,20,10,50,10,1
4,00:03:49,2,True,20,30,-10,44,5,1
4,00:02:39,3,False,30,20,10,43,2,1
4,00:01:30,1,True,20,30,-10,12,10,1
4,00:01:25,1,True,20,30,-10,26,10,1
4,00:01:18,2,True,20,30,-10,31,5,1
1,00:13:48,2,False,0,0,0,28,20,1
1,00:12:48,1,True,0,0,0,24,10,1
1,00:12:28,1,True,0,0,0,36,10,1
1,00:09:46,1,True,0,0,0,46,10,1
1,00:08:57,2,True,0,0,0,41,15,1
1,00:07:22,1,False,0,0,0,18,10,1
1,00:05:18,2,False,0,3,-3,34,6,1
1,00:04:47,1,False,0,3,-3,45,10,1
1,00:04:03,1,True,3,0,3,51,10,1
1,00:03:25,2,True,3,0,3,46,5,1
1,00:01:24,2,True,3,0,3,33,7,1
2,00:14:41,3,False,7,3,4,10,4,1
2,00:14:14,1,False,7,10,-3,32,10,1
2,00:12:23,2,True,10,7,3,51,20,1
2,00:11:02,1,False,7,10,-3,4,10,1
2,00:07:53,2,False,7,10,-3,49,9,1
2,00:06:26,1,True,10,7,3,35,10,1
2,00:04:50,1,True,10,7,3,36,10,1
2,00:00:55,2,False,10,10,0,26,19,1
2,00:00:17,1,True,10,10,0,52,10,1
3,00:14:54,1,False,10,13,-3,41,10,1
3,00:14:25,1,True,13,10,3,38,10,1
3,00:13:15,1,True,13,10,3,25,10,1
3,00:08:25,1,False,16,13,3,36,10,1
3,00:07:51,1,False,16,13,3,47,10,1
3,00:06:23,1,True,13,16,-3,53,10,1
3,00:05:18,1,True,13,16,-3,42,10,1
3,00:02:57,1,True,13,19,-6,35,10,1
4,00:14:29,1,True,15,19,-4,45,10,1
4,00:10:11,1,False,19,22,-3,22,15,1
4,00:08:19,2,False,19,22,-3,44,6,1
4,00:04:36,2,True,25,19,6,47,10,1
4,00:03:09,2,False,19,25,-6,53,10,1
4,00:01:28,1,False,19,28,-9,45,10,1
4,00:01:19,2,False,19,28,-9,48,7,1
4,00:01:12,1,False,19,28,-9,55,10,1
4,00:01:04,1,True,28,19,9,44,10,1
4,00:00:55,2,True,28,19,9,40,6,1
4,00:00:28,2,True,28,19,9,27,3,1
1,00:14:50,1,True,0,0,0,24,10,1
1,00:13:25,1,False,0,0,0,54,10,1
1,00:12:52,2,False,0,0,0,47,3,1
1,00:11:44,2,False,0,0,0,39,5,1
1,00:08:31,2,True,3,0,3,30,5,1
1,00:08:03,1,True,3,0,3,52,10,1
1,00:06:02,1,False,0,4,-4,39,10,1
1,00:04:50,2,False,0,4,-4,51,9,1
1,00:02:40,2,True,4,0,4,11,6,1
1,00:02:16,1,True,4,7,-3,29,10,1
1,00:01:34,1,True,4,7,-3,42,10,1
1,00:00:21,1,False,7,4,3,14,10,1
1,00:00:00,2,False,7,4,3,10,6,1
2,00:12:30,2,True,11,7,4,37,5,1
2,00:10:29,1,True,11,7,4,54,10,1
2,00:06:45,2,True,11,14,-3,22,10,1
2,00:05:10,2,False,14,11,3,47,7,1
2,00:03:45,2,True,11,14,-3,51,16,1
2,00:00:50,1,False,14,11,3,49,10,1
2,00:00:41,1,True,11,21,-10,29,10,1
2,00:00:31,2,True,11,21,-10,38,1,1
2,00:00:21,1,True,11,21,-10,46,10,1
2,00:00:11,1,False,21,11,10,53,10,1
3,00:12:18,1,True,14,21,-7,48,10,1
3,00:11:09,1,True,14,22,-8,35,10,1
3,00:08:09,1,False,22,14,8,40,10,1
3,00:07:00,2,True,14,29,-15,30,11,1
3,00:06:22,1,True,14,29,-15,44,10,1
3,00:03:01,2,False,29,14,15,20,5,1
3,00:02:23,1,False,29,14,15,26,10,1
4,00:12:46,1,True,14,32,-18,35,10,1
4,00:10:59,1,False,32,14,18,54,10,1
4,00:10:06,2,False,32,14,18,48,4,1
4,00:07:17,1,False,32,21,11,46,10,1
4,00:04:21,1,True,21,32,-11,19,10,1
4,00:03:52,1,True,21,32,-11,37,10,1
4,00:02:12,1,True,21,39,-18,8,10,1
4,00:01:39,2,True,21,39,-18,22,10,1
4,00:01:23,2,True,21,39,-18,49,18,1
4,00:00:40,1,False,39,21,18,23,10,1
4,00:00:35,2,False,39,21,18,16,3,1
4,00:00:01,3,True,28,39,-11,45,17,1
1,00:11:18,2,True,0,0,0,4,4,1
1,00:10:17,1,True,0,7,-7,51,10,1
1,00:09:16,1,False,7,0,7,48,10,1
1,00:07:51,1,False,7,3,4,35,10,1
1,00:07:00,2,False,7,3,4,27,10,1
1,00:05:15,2,False,7,3,4,11,7,1
1,00:04:19,2,False,7,10,-3,33,4,1
1,00:00:03,1,False,7,11,-4,45,10,1
2,00:14:00,2,True,11,8,3,35,10,1
2,00:12:37,1,False,8,11,-3,28,10,1
2,00:10:14,2,False,8,11,-3,6,6,1
2,00:08:29,2,False,8,18,-10,45,10,1
2,00:07:08,2,True,18,8,10,43,4,1
2,00:06:35,1,True,18,8,10,31,10,1
2,00:05:49,1,True,18,8,10,2,2,1
2,00:04:56,2,True,18,15,3,10,7,1
2,00:03:51,1,True,18,15,3,48,10,1
2,00:02:34,1,False,15,18,-3,2,10,1
2,00:02:28,1,False,15,18,-3,28,10,1
2,00:02:08,1,False,15,18,-3,40,10,1
2,00:02:03,2,False,15,18,-3,47,3,1
2,00:01:55,1,True,18,15,3,51,10,1
3,00:14:51,1,True,18,15,3,54,10,1
3,00:14:27,2,False,15,18,-3,52,6,1
3,00:12:54,1,False,15,18,-3,17,10,1
3,00:12:10,2,False,15,25,-10,28,10,1
3,00:10:33,1,True,25,15,10,28,10,1
3,00:09:43,2,False,22,25,-3,34,5,1
3,00:07:46,1,False,22,25,-3,25,10,1
3,00:06:57,2,False,22,25,-3,44,3,1
3,00:05:28,1,True,25,22,3,40,10,1
3,00:02:16,1,True,25,25,0,52,10,1
3,00:00:08,2,True,25,25,0,44,30,1
4,00:14:07,2,False,25,25,0,8,7,1
4,00:13:43,1,False,25,25,0,22,10,1
4,00:10:33,1,False,25,25,0,40,10,1
4,00:10:02,2,False,25,25,0,41,9,1
4,00:09:13,1,True,25,25,0,34,10,1
4,00:08:03,2,True,25,25,0,34,10,1
4,00:07:10,2,True,25,32,-7,38,10,1
4,00:06:03,1,False,32,25,7,44,10,1
4,00:04:33,1,False,32,26,6,35,10,1
4,00:03:30,1,True,26,32,-6,24,10,1
4,00:03:05,2,True,26,32,-6,27,7,1
4,00:02:46,2,True,26,32,-6,37,10,1
4,00:00:26,1,True,26,33,-7,35,10,1
4,00:00:11,1,True,26,33,-7,40,15,1
4,00:00:02,1,False,33,26,7,45,5,1
1,00:13:46,1,True,0,0,0,29,10,1
1,00:13:25,2,True,0,0,0,33,6,1
1,00:12:46,1,True,0,0,0,39,10,1
1,00:10:39,1,False,0,0,0,46,15,1
1,00:10:19,2,False,0,0,0,40,9,1
1,00:08:17,2,False,0,0,0,30,10,1
1,00:07:10,1,False,0,0,0,19,10,1
1,00:03:40,1,True,7,0,7,42,10,1
1,00:02:39,1,True,7,0,7,30,10,1
1,00:01:38,2,True,7,0,7,17,10,1
1,00:00:10,2,True,7,3,4,38,7,1
2,00:13:38,1,False,3,7,-4,41,10,1
2,00:12:58,1,True,7,3,4,47,10,1
2,00:11:36,2,True,7,3,4,36,10,1
2,00:10:50,2,True,7,3,4,22,10,1
2,00:07:24,1,True,7,6,1,48,15,1
2,00:06:58,2,True,7,6,1,43,10,1
2,00:06:18,1,True,7,6,1,32,10,1
2,00:03:56,1,True,7,6,1,9,9,1
2,00:03:36,1,True,7,13,-6,30,10,1
2,00:03:15,1,True,7,13,-6,42,10,1
2,00:02:14,1,True,7,13,-6,53,10,1
2,00:01:49,1,False,13,7,6,46,10,1
2,00:00:25,1,True,7,13,-6,33,10,1
3,00:13:30,1,False,13,7,6,32,10,1
3,00:13:03,2,False,13,7,6,38,4,1
3,00:11:48,2,False,13,7,6,52,10,1
3,00:10:57,2,True,7,13,-6,20,14,1
3,00:08:10,1,True,7,16,-9,46,10,1
3,00:07:00,2,False,16,7,9,52,10,1
3,00:05:00,2,False,16,7,9,49,11,1
3,00:03:53,2,True,7,16,-9,51,14,1
3,00:02:20,2,True,7,16,-9,33,7,1
3,00:01:12,2,True,7,19,-12,35,10,1
3,00:00:28,1,True,7,19,-12,46,10,1
4,00:12:51,1,False,19,7,12,53,10,1
4,00:11:12,1,True,7,19,-12,3,10,1
4,00:10:52,1,True,7,19,-12,26,10,1
4,00:10:14,1,False,19,7,12,51,10,1
4,00:08:23,2,False,19,7,12,40,13,1
4,00:05:57,1,True,7,19,-12,29,10,1
4,00:03:26,1,False,19,14,5,32,10,1
4,00:02:34,2,True,14,19,-5,30,15,1
1,00:12:58,1,False,7,0,7,22,10,1
1,00:12:03,2,False,7,0,7,13,1,1
1,00:11:46,1,False,7,7,0,37,10,1
1,00:09:24,1,True,7,7,0,35,10,1
1,00:07:41,1,True,7,7,0,25,10,1
1,00:07:20,1,True,7,15,-8,35,10,1
1,00:06:55,1,True,7,15,-8,45,10,1
2,00:14:26,2,False,15,7,8,17,7,1
2,00:13:47,1,False,15,7,8,35,10,1
2,00:12:10,1,True,7,15,-8,13,10,1
2,00:09:46,2,False,15,7,8,47,10,1
2,00:08:18,2,True,7,15,-8,8,10,1
2,00:03:15,2,True,7,25,-18,25,10,1
2,00:02:35,1,True,7,25,-18,51,10,1
2,00:01:49,1,True,7,33,-26,45,10,1
2,00:01:39,1,False,33,7,26,48,10,1
2,00:01:02,2,False,33,7,26,35,10,1
2,00:00:53,2,False,33,14,19,37,10,1
2,00:00:22,1,True,14,33,-19,27,10,1
2,00:00:01,2,True,14,33,-19,50,10,1
3,00:13:21,1,True,14,33,-19,28,10,1
3,00:11:45,2,True,14,33,-19,10,3,1
3,00:07:38,1,True,14,40,-26,20,10,1
3,00:06:18,1,True,14,40,-26,49,10,1
3,00:05:45,1,True,14,40,-26,36,10,1
3,00:05:04,2,True,14,40,-26,35,9,1
3,00:04:12,1,True,14,40,-26,26,10,1
3,00:02:06,2,True,14,40,-26,43,9,1
4,00:14:29,1,True,14,47,-33,48,10,1
4,00:14:04,2,True,14,47,-33,41,3,1
4,00:11:23,1,True,14,47,-33,12,10,1
4,00:07:38,1,True,14,50,-36,49,10,1
4,00:05:50,1,False,50,17,33,35,10,1
4,00:01:27,1,True,17,53,-36,35,10,1
4,00:01:09,3,True,17,53,-36,36,9,1
1,00:14:54,1,True,0,0,0,37,10,1
1,00:12:47,1,True,0,0,0,49,10,1
1,00:07:40,2,False,0,7,-7,26,10,1
1,00:06:10,2,False,0,7,-7,35,12,1
1,00:05:00,1,True,7,0,7,44,10,1
1,00:03:40,2,False,0,7,-7,46,4,1
1,00:01:52,1,False,0,8,-8,37,10,1
2,00:15:00,2,True,8,0,8,51,24,1
2,00:13:08,1,True,9,6,3,38,10,1
2,00:09:06,2,False,6,9,-3,40,19,1
2,00:06:59,1,True,9,6,3,25,10,1
2,00:06:20,1,True,9,6,3,44,10,1
2,00:04:46,1,True,9,6,3,48,10,1
2,00:03:50,2,True,9,6,3,47,9,1
2,00:03:30,1,True,9,6,3,37,10,1
2,00:02:09,1,True,9,13,-4,45,10,1
2,00:01:53,2,True,9,13,-4,51,4,1
2,00:01:45,1,False,13,9,4,39,10,1
2,00:01:08,2,False,13,9,4,18,10,1
2,00:00:44,1,False,13,12,1,35,10,1
2,00:00:40,2,False,13,12,1,44,1,1
2,00:00:30,1,False,13,12,1,52,10,1
3,00:09:23,1,False,13,14,-1,19,10,1
3,00:08:13,1,False,13,14,-1,52,10,1
3,00:06:46,2,False,13,14,-1,24,10,1
3,00:04:20,1,True,17,13,4,43,10,1
3,00:02:11,2,False,13,17,-4,21,8,1
3,00:00:54,1,True,17,13,4,33,10,1
3,00:00:02,2,True,17,13,4,50,6,1
4,00:15:00,1,False,13,17,-4,49,10,1
4,00:14:40,1,False,13,17,-4,39,10,1
4,00:13:20,2,False,13,17,-4,30,14,1
4,00:10:10,2,False,13,18,-5,45,13,1
4,00:09:15,2,False,13,18,-5,24,2,1
4,00:05:05,2,False,13,25,-12,51,7,1
4,00:04:20,1,True,25,13,12,36,10,1
4,00:03:34,1,True,25,13,12,26,10,1
4,00:02:40,1,True,25,20,5,45,10,1
4,00:00:50,2,True,25,20,5,49,6,1
1,00:10:09,2,False,0,0,0,39,15,1
1,00:08:49,1,False,0,0,0,52,10,1
1,00:07:56,2,False,0,0,0,50,8,1
1,00:04:46,2,False,0,0,0,26,6,1
1,00:03:54,1,False,0,3,-3,14,10,1
1,00:02:17,1,False,0,3,-3,51,10,1
2,00:12:04,1,True,3,0,3,16,10,1
2,00:11:26,2,True,3,0,3,15,11,1
2,00:07:14,2,True,3,0,3,41,10,1
2,00:02:26,2,False,0,3,-3,50,7,1
3,00:14:50,1,False,1,3,-2,30,10,1
3,00:13:37,1,False,1,3,-2,46,10,1
3,00:12:20,1,True,3,1,2,47,10,1
3,00:10:25,2,True,3,1,2,12,3,1
3,00:10:09,1,True,3,8,-5,45,10,1
3,00:04:09,2,True,3,8,-5,16,1,1
3,00:00:32,1,False,15,3,12,33,20,1
3,00:00:01,2,False,15,3,12,30,23,1
4,00:11:50,2,True,3,15,-12,23,10,1
4,00:10:20,2,True,3,15,-12,46,6,1
4,00:08:53,2,False,15,3,12,32,7,1
4,00:02:59,1,False,17,3,14,50,10,1
4,00:00:50,2,True,3,17,-14,42,13,1
1,00:14:54,1,True,0,0,0,36,10,1
1,00:11:50,1,False,0,0,0,42,10,1
1,00:09:35,1,True,0,0,0,23,10,1
1,00:08:38,2,True,0,0,0,37,7,1
1,00:06:40,1,False,0,0,0,45,10,1
1,00:04:06,1,False,0,1,-1,30,15,1
1,00:02:29,1,False,0,1,-1,49,5,1
2,00:14:04,1,True,1,0,1,52,10,1
2,00:12:32,1,True,1,7,-6,42,10,1
2,00:11:51,1,True,1,14,-13,24,10,1
2,00:11:17,2,True,1,14,-13,30,4,1
2,00:10:52,1,True,1,14,-13,38,10,1
2,00:08:36,1,False,14,1,13,30,10,1
2,00:07:39,1,False,14,1,13,41,10,1
2,00:04:12,2,True,1,14,-13,35,9,1
2,00:03:22,1,False,14,1,13,29,10,1
2,00:02:10,2,True,1,14,-13,39,10,1
2,00:01:41,1,True,1,17,-16,35,10,1
2,00:01:34,1,False,17,1,16,42,10,1
2,00:01:17,2,False,17,1,16,33,1,1
2,00:00:59,1,False,17,1,16,26,10,1
3,00:13:09,2,True,4,17,-13,47,10,1
3,00:11:59,1,False,17,4,13,53,10,1
3,00:10:08,2,True,4,17,-13,43,10,1
3,00:08:11,1,False,20,4,16,51,10,1
3,00:06:15,2,True,4,20,-16,38,9,1
3,00:04:53,2,True,4,20,-16,23,8,1
3,00:02:59,1,True,4,27,-23,46,10,1
3,00:02:39,2,True,4,27,-23,46,10,1
3,00:01:43,2,False,27,4,23,54,10,1
3,00:01:26,1,False,27,4,23,40,10,1
3,00:00:36,1,False,27,4,23,27,10,1
4,00:14:54,1,False,27,11,16,33,10,1
4,00:13:21,1,True,11,27,-16,35,10,1
4,00:12:55,1,True,11,34,-23,30,10,1
4,00:11:00,2,False,34,11,23,21,10,1
4,00:09:20,2,False,34,11,23,51,20,1
4,00:08:21,1,True,11,35,-24,35,10,1
4,00:06:54,2,False,35,11,24,44,10,1
4,00:00:01,3,False,35,11,24,28,1,1
1,00:14:55,1,True,0,0,0,24,10,1
1,00:13:55,2,True,0,0,0,38,10,1
1,00:13:24,2,False,0,0,0,32,8,1
1,00:11:46,1,False,0,3,-3,37,15,1
1,00:11:10,2,False,0,3,-3,47,5,1
1,00:10:52,1,True,3,0,3,54,10,1
1,00:08:55,2,True,3,0,3,42,8,1
1,00:08:20,1,True,3,0,3,34,10,1
1,00:06:52,1,True,3,0,3,15,10,1
1,00:05:56,2,True,3,7,-4,33,12,1
1,00:04:15,1,False,7,3,4,44,10,1
1,00:03:02,1,True,3,7,-4,26,10,1
1,00:01:55,2,False,7,3,4,44,9,1
1,00:00:03,2,False,7,3,4,26,15,1
2,00:14:43,1,False,7,6,1,33,10,1
2,00:11:34,1,False,7,6,1,24,10,1
2,00:09:20,1,True,6,7,-1,25,10,1
2,00:08:48,2,True,6,7,-1,32,3,1
2,00:07:18,1,True,6,7,-1,30,10,1
2,00:05:55,1,False,14,6,8,40,10,1
2,00:03:44,2,True,6,14,-8,22,9,1
2,00:02:42,1,False,14,6,8,47,10,1
2,00:02:33,1,True,6,14,-8,27,10,1
2,00:02:28,1,True,6,14,-8,13,10,1
2,00:02:04,2,True,6,14,-8,9,6,1
3,00:14:34,1,False,21,6,15,50,10,1
3,00:12:21,2,True,6,21,-15,47,8,1
3,00:09:39,2,True,6,28,-22,37,12,1
3,00:09:15,1,False,28,6,22,43,10,1
3,00:07:20,2,False,28,6,22,34,7,1
3,00:06:10,2,True,6,28,-22,28,10,1
3,00:03:30,2,True,6,31,-25,32,13,1
4,00:14:27,2,False,31,9,22,35,10,1
4,00:11:15,2,True,9,32,-23,35,8,1
4,00:09:31,2,True,9,32,-23,7,7,1
4,00:08:01,2,True,9,32,-23,26,9,1
4,00:04:40,2,True,9,35,-26,35,10,1
4,00:03:46,1,True,9,35,-26,46,10,1
4,00:03:15,2,True,9,35,-26,52,4,1
4,00:02:29,2,False,35,9,26,12,11,1
4,00:01:27,1,True,11,35,-24,47,10,1
4,00:01:01,1,False,35,11,24,37,10,1
1,00:11:36,1,True,0,0,0,22,10,1
1,00:10:23,2,False,0,0,0,42,10,1
1,00:09:16,2,False,0,0,0,25,5,1
1,00:08:13,2,False,0,0,0,25,10,1
1,00:07:03,2,False,0,0,0,43,9,1
1,00:05:56,2,False,0,0,0,53,10,1
1,00:04:56,1,True,0,1,-1,35,10,1
1,00:03:50,2,True,0,1,-1,47,10,1
1,00:01:42,1,False,1,1,0,35,10,1
2,00:13:22,1,False,3,1,2,42,10,1
2,00:13:09,1,False,3,1,2,52,10,1
2,00:07:58,2,False,3,1,2,20,30,1
2,00:07:20,1,True,1,3,-2,8,10,1
2,00:04:25,2,True,1,3,-2,44,3,1
2,00:02:21,1,False,3,1,2,29,10,1
2,00:02:02,1,True,1,3,-2,32,10,1
2,00:01:53,1,True,1,3,-2,51,10,1
2,00:00:28,1,True,1,3,-2,48,10,1
2,00:00:21,1,False,3,1,2,33,10,1
3,00:14:54,1,False,3,4,-1,40,10,1
3,00:14:19,2,False,3,4,-1,45,5,1
3,00:13:54,1,False,3,4,-1,53,10,1
3,00:12:03,1,False,4,4,0,53,10,1
3,00:11:41,2,False,4,4,0,52,9,1
3,00:10:21,2,False,4,4,0,6,10,1
3,00:09:37,1,False,4,4,0,16,10,1
3,00:06:04,2,False,4,4,0,28,7,1
3,00:05:16,1,False,4,4,0,40,10,1
3,00:03:07,1,True,4,4,0,50,10,1
3,00:01:48,1,False,4,4,0,45,10,1
4,00:14:06,1,False,4,11,-7,25,10,1
4,00:13:51,1,False,4,11,-7,42,10,1
4,00:13:17,1,True,11,4,7,50,10,1
4,00:11:55,2,True,11,4,7,24,10,1
4,00:11:28,1,False,11,11,0,52,10,1
4,00:10:43,2,False,11,11,0,48,6,1
4,00:09:40,2,False,11,11,0,39,9,1
4,00:08:01,2,False,11,14,-3,52,10,1
4,00:03:28,1,True,14,12,2,49,10,1
4,00:03:08,2,True,14,12,2,50,9,1
4,00:02:10,2,False,12,17,-5,33,12,1
4,00:01:37,2,True,17,12,5,37,10,1
4,00:01:08,1,False,12,17,-5,32,10,1
4,00:01:02,2,False,12,17,-5,33,9,1
4,00:00:56,1,False,12,17,-5,45,10,1
1,00:12:16,1,False,0,0,0,28,10,1
1,00:12:00,2,False,0,0,0,34,4,1
1,00:10:43,2,False,0,0,0,53,3,1
1,00:09:37,2,True,0,0,0,29,3,1
1,00:06:03,1,True,0,10,-10,35,10,1
1,00:05:39,2,True,0,10,-10,38,7,1
1,00:04:37,1,False,10,0,10,31,10,1
1,00:03:21,2,False,10,0,10,52,10,1
1,00:02:20,2,True,0,17,-17,8,22,1
2,00:14:52,1,True,0,24,-24,39,10,1
2,00:13:17,2,True,0,24,-24,50,10,1
2,00:11:31,1,False,24,0,24,34,10,1
2,00:06:26,1,False,24,3,21,29,10,1
2,00:06:03,1,False,24,3,21,17,10,1
2,00:05:31,2,False,24,3,21,13,6,1
2,00:04:02,1,False,24,3,21,1,1,1
2,00:03:04,2,False,24,10,14,12,6,1
2,00:02:33,2,False,24,10,14,26,6,1
2,00:01:53,1,False,24,10,14,51,10,1
2,00:01:48,1,False,24,10,14,40,10,1
2,00:01:28,2,False,24,13,11,27,18,1
2,00:00:38,1,True,13,24,-11,52,10,1
2,00:00:32,2,False,24,13,11,51,3,1
2,00:00:27,1,False,24,13,11,43,10,1
2,00:00:02,2,False,24,13,11,10,10,1
3,00:12:45,2,False,24,19,5,28,4,1
3,00:11:36,1,False,24,19,5,20,10,1
3,00:10:17,1,False,24,22,2,35,10,1
3,00:07:16,1,True,22,24,-2,21,10,1
3,00:06:16,2,False,24,22,2,44,10,1
3,00:04:57,1,False,24,22,2,11,10,1
3,00:03:54,1,True,28,24,4,54,10,1
3,00:00:25,1,False,24,35,-11,15,15,1
4,00:14:00,2,True,35,24,11,40,10,1
4,00:09:32,2,True,35,27,8,35,10,1
4,00:08:04,2,True,35,27,8,53,7,1
4,00:02:18,2,False,27,38,-11,28,10,1
4,00:00:55,1,False,27,38,-11,47,10,1
4,00:00:42,2,False,27,38,-11,55,2,1
4,00:00:30,2,True,38,27,11,50,14,1
4,00:00:12,3,True,38,27,11,41,5,1
4,00:00:01,1,True,38,27,11,15,10,1
1,00:14:53,1,True,0,0,0,27,10,1
1,00:13:08,2,True,0,0,0,55,9,1
1,00:11:58,1,False,0,0,0,45,10,1
1,00:11:26,2,False,0,0,0,39,4,1
1,00:09:18,2,False,0,0,0,16,5,1
1,00:08:04,2,False,0,0,0,27,5,1
1,00:07:14,1,False,0,0,0,32,10,1
1,00:02:24,1,True,0,3,-3,23,10,1
1,00:00:41,2,True,0,3,-3,35,10,1
2,00:11:36,1,True,3,3,0,37,10,1
2,00:10:47,2,True,3,3,0,51,9,1
2,00:07:35,2,False,3,10,-7,42,7,1
2,00:06:08,2,True,10,3,7,34,4,1
2,00:05:27,1,True,10,3,7,27,10,1
2,00:03:05,1,True,10,10,0,28,10,1
2,00:02:39,1,True,10,10,0,39,10,1
2,00:02:18,1,False,10,10,0,53,10,1
3,00:14:54,1,False,10,10,0,26,10,1
3,00:12:57,2,False,10,10,0,40,7,1
3,00:11:28,1,True,10,10,0,33,10,1
3,00:08:42,2,True,17,10,7,50,11,1
3,00:07:58,1,False,10,17,-7,38,10,1
3,00:07:16,2,False,10,17,-7,32,4,1
3,00:06:34,1,False,10,17,-7,25,10,1
3,00:04:19,2,False,10,24,-14,33,7,1
3,00:02:09,2,False,10,24,-14,40,15,1
3,00:01:15,2,True,24,10,14,28,10,1
3,00:00:30,1,True,24,10,14,15,10,1
4,00:14:39,1,True,24,13,11,34,10,1
4,00:13:54,2,True,24,13,11,40,4,1
4,00:09:52,2,False,13,24,-11,55,10,1
4,00:01:53,1,False,14,31,-17,34,10,1
4,00:01:47,1,False,14,31,-17,46,10,1
4,00:01:32,1,True,31,14,17,27,10,1
4,00:01:09,2,True,31,14,17,12,10,1
1,00:14:01,1,True,0,0,0,46,10,1
1,00:13:33,1,True,0,0,0,30,10,1
1,00:12:54,2,True,0,0,0,24,4,1
1,00:12:25,1,True,0,0,0,19,10,1
1,00:11:56,1,True,0,0,0,3,3,1
1,00:10:27,1,True,0,3,-3,35,10,1
1,00:07:21,2,True,0,3,-3,43,10,1
1,00:06:24,2,True,0,3,-3,55,10,1
1,00:05:01,2,False,3,0,3,49,15,1
1,00:03:08,2,False,3,0,3,51,10,1
2,00:13:25,1,True,1,3,-2,47,10,1
2,00:12:05,2,False,3,1,2,52,10,1
2,00:11:15,1,False,3,1,2,13,15,1
2,00:11:05,2,False,3,1,2,25,3,1
2,00:10:05,1,True,1,3,-2,45,10,1
2,00:08:44,2,False,3,1,2,50,10,1
2,00:10:05,1,True,1,3,-2,45,10,1
2,00:07:04,1,False,3,2,1,46,10,1
2,00:03:04,1,True,2,6,-4,35,10,1
2,00:02:42,2,True,2,6,-4,40,5,1
2,00:02:25,1,True,2,6,-4,49,10,1
2,00:02:08,1,False,6,2,4,47,10,1
2,00:01:01,1,False,6,2,4,25,10,1
2,00:00:30,1,False,6,2,4,51,10,1
2,00:00:02,2,False,6,2,4,37,10,1
3,00:14:00,1,True,9,6,3,53,10,1
3,00:13:29,2,False,6,9,-3,50,3,1
3,00:12:54,1,False,6,9,-3,45,10,1
3,00:11:45,2,False,6,9,-3,33,9,1
3,00:09:38,2,False,6,9,-3,7,7,1
3,00:07:53,2,False,6,12,-6,12,12,1
3,00:07:21,1,False,6,12,-6,30,10,1
3,00:06:15,2,False,6,12,-6,45,5,1
3,00:05:44,1,True,12,6,6,43,10,1
3,00:05:12,1,True,12,13,-1,37,10,1
3,00:03:15,1,True,12,13,-1,20,10,1
3,00:02:47,1,True,12,21,-9,35,10,1
3,00:02:20,2,True,12,21,-9,39,6,1
3,00:01:00,1,False,21,12,9,13,10,1
4,00:15:00,1,False,21,12,9,38,10,1
4,00:14:40,2,False,21,12,9,35,7,1
4,00:12:41,1,True,12,21,-9,48,10,1
4,00:12:00,1,False,21,12,9,48,10,1
4,00:09:26,1,False,21,15,6,54,10,1
4,00:07:32,2,True,15,21,-6,23,3,1
4,00:07:06,1,True,15,21,-6,26,10,1
4,00:04:05,1,True,15,21,-6,37,10,1
4,00:02:50,1,False,21,15,6,35,10,1
4,00:01:37,1,True,15,21,-6,31,10,1
4,00:01:31,2,True,15,21,-6,35,6,1
4,00:00:52,1,False,21,15,6,40,10,1
4,00:00:38,1,False,21,15,6,8,8,1
4,00:00:31,1,False,21,22,-1,44,10,1
4,00:00:17,3,True,22,21,1,50,10,1
1,00:14:51,1,False,0,0,0,7,10,1
1,00:10:47,1,False,0,0,0,34,10,1
1,00:08:54,2,False,0,0,0,26,10,1
1,00:07:29,2,True,0,0,0,26,5,1
1,00:05:37,1,False,0,0,0,46,10,1
1,00:05:00,2,False,0,0,0,51,5,1
1,00:03:08,2,True,0,0,0,48,12,1
1,00:02:30,1,False,0,0,0,46,10,1
1,00:01:31,1,False,0,0,0,35,10,1
1,00:01:05,1,False,0,0,0,21,10,1
2,00:14:30,1,False,0,3,-3,35,10,1
2,00:13:45,1,False,0,3,-3,45,10,1
2,00:11:11,1,True,3,0,3,25,10,1
2,00:09:12,1,False,0,3,-3,48,10,1
2,00:05:46,1,True,6,0,6,33,10,1
2,00:05:26,1,False,0,6,-6,45,10,1
2,00:05:03,1,False,0,6,-6,33,10,1
2,00:03:53,2,False,0,6,-6,28,5,1
2,00:03:09,1,False,0,13,-13,16,15,1
2,00:01:46,1,False,0,13,-13,18,10,1
2,00:01:14,2,False,0,13,-13,29,10,1
2,00:00:56,1,False,0,13,-13,35,10,1
2,00:00:28,2,False,0,13,-13,15,10,1
3,00:13:49,2,False,0,16,-16,22,11,1
3,00:08:38,1,False,0,16,-16,42,10,1
3,00:08:13,2,False,0,16,-16,45,7,1
3,00:06:50,2,False,0,16,-16,55,9,1
3,00:03:38,2,True,16,0,16,25,10,1
3,00:01:13,2,False,0,16,-16,52,16,1
3,00:00:50,1,False,0,16,-16,20,10,1
3,00:00:00,1,False,0,16,-16,8,8,1
4,00:12:53,1,True,23,0,23,50,10,1
4,00:12:01,2,False,0,30,-30,25,10,1
4,00:07:51,2,False,0,30,-30,39,9,1
4,00:05:09,2,False,0,37,-37,25,10,1
4,00:04:48,1,False,0,37,-37,40,10,1
4,00:04:12,2,False,0,37,-37,44,6,1
1,00:14:33,2,True,0,0,0,43,10,1
1,00:13:26,1,False,0,0,0,18,10,1
1,00:10:51,2,False,0,0,0,32,12,1
1,00:09:40,2,False,0,3,-3,36,9,1
1,00:09:16,1,False,0,3,-3,47,10,1
1,00:07:46,1,True,3,3,0,35,10,1
1,00:03:39,2,False,3,3,0,26,18,1
1,00:01:13,2,False,3,3,0,6,6,1
1,00:00:35,2,False,3,10,-7,32,10,1
2,00:14:13,1,True,10,3,7,18,10,1
2,00:13:43,2,True,10,3,7,24,4,1
2,00:13:21,1,True,10,3,7,37,10,1
2,00:10:39,2,False,3,10,-7,30,18,1
2,00:07:50,2,False,3,13,-10,47,10,1
2,00:03:50,2,False,6,13,-7,19,11,1
2,00:01:50,2,False,6,13,-7,45,6,1
2,00:01:27,1,False,6,13,-7,29,10,1
2,00:00:35,2,False,6,20,-14,32,10,1
3,00:14:28,2,False,6,20,-14,41,10,1
3,00:13:52,1,False,6,20,-14,52,10,1
3,00:12:00,1,True,20,6,14,28,10,1
3,00:11:19,2,True,20,6,14,25,13,1
3,00:02:10,1,True,23,13,10,41,10,1
3,00:01:38,1,True,23,13,10,54,10,1
3,00:00:59,2,False,13,23,-10,51,5,1
4,00:15:00,2,False,13,23,-10,24,3,1
4,00:12:34,1,True,26,13,13,19,10,1
4,00:11:23,1,True,26,20,6,24,10,1
4,00:09:15,2,True,26,27,-1,49,15,1
4,00:07:03,2,False,27,26,1,4,8,1
4,00:01:00,1,False,27,32,-5,35,10,1
4,00:00:53,2,False,27,32,-5,42,3,1
4,00:00:48,1,True,32,27,5,50,10,1
4,00:00:39,1,True,32,27,5,31,10,1
1,00:14:56,1,True,0,0,0,35,10,1
1,00:12:55,1,False,0,0,0,19,10,1
1,00:12:29,1,False,0,0,0,30,10,1
1,00:10:57,1,False,0,0,0,45,10,1
1,00:09:11,2,True,0,0,0,52,9,1
1,00:05:40,2,False,1,0,1,20,5,1
1,00:04:10,2,False,1,0,1,24,12,1
1,00:02:37,2,True,0,1,-1,27,6,1
1,00:01:44,2,True,0,8,-8,41,6,1
1,00:00:00,2,False,8,0,8,5,4,1
2,00:13:11,1,False,8,7,1,44,10,1
2,00:12:44,2,False,8,7,1,41,7,1
2,00:12:02,1,False,8,7,1,18,10,1
2,00:11:22,1,False,8,7,1,7,7,1
2,00:11:06,1,False,8,14,-6,38,10,1
2,00:08:45,1,False,8,14,-6,42,10,1
2,00:08:25,1,True,14,8,6,30,10,1
2,00:07:02,2,True,14,11,3,35,10,1
2,00:04:10,1,False,11,14,-3,49,10,1
2,00:03:37,2,False,11,14,-3,54,5,1
2,00:03:00,1,True,14,11,3,38,10,1
2,00:00:41,2,False,14,14,0,44,10,1
2,00:00:35,1,True,14,14,0,53,10,1
2,00:00:24,1,True,14,14,0,41,10,1
3,00:14:16,1,False,17,14,3,42,10,1
3,00:13:42,2,False,17,14,3,44,8,1
3,00:11:25,1,True,14,17,-3,25,10,1
3,00:09:44,1,True,14,17,-3,15,10,1
3,00:07:30,2,True,14,24,-10,50,10,1
3,00:06:56,2,False,24,14,10,44,10,1
3,00:04:33,1,True,14,24,-10,45,10,1
3,00:03:57,1,True,14,24,-10,34,10,1
3,00:01:13,2,False,27,14,13,50,10,1
4,00:14:35,1,True,17,27,-10,37,10,1
4,00:13:58,1,True,17,27,-10,17,10,1
4,00:12:51,2,True,17,27,-10,10,3,1
4,00:12:28,1,True,17,34,-17,37,10,1
4,00:12:09,2,True,17,34,-17,40,7,1
4,00:09:21,1,False,34,17,17,31,15,1
4,00:08:59,2,False,34,17,17,38,8,1
4,00:07:41,2,True,17,34,-17,46,9,1
4,00:06:10,2,True,17,34,-17,35,11,1
4,00:03:40,2,True,17,37,-20,35,10,1
4,00:02:42,2,True,17,37,-20,49,10,1
4,00:02:23,2,False,37,17,20,41,10,1
4,00:02:16,1,False,37,17,20,25,10,1
4,00:01:56,2,False,37,17,20,9,5,1
1,00:13:47,2,True,0,0,0,44,10,1
1,00:12:18,2,False,0,0,0,14,9,1
1,00:09:13,1,False,0,3,-3,47,10,1
1,00:08:14,1,False,0,3,-3,17,10,1
1,00:07:45,1,False,0,10,-10,38,10,1
1,00:04:10,2,True,10,0,10,47,15,1
2,00:12:10,1,True,10,5,5,54,10,1
2,00:11:28,1,True,10,5,5,30,10,1
2,00:10:30,2,True,10,12,-2,17,5,1
2,00:09:22,1,True,10,12,-2,45,10,1
2,00:07:32,1,False,12,10,2,39,10,1
2,00:07:05,1,False,12,17,-5,34,10,1
2,00:06:28,2,False,12,17,-5,38,6,1
2,00:04:36,1,True,17,12,5,18,10,1
2,00:02:41,2,False,19,17,2,51,10,1
2,00:02:08,2,True,17,19,-2,24,10,1
2,00:01:56,2,True,17,26,-9,29,10,1
2,00:00:01,1,False,26,17,9,54,10,1
3,00:11:23,1,True,17,29,-12,35,10,1
3,00:07:30,2,False,29,17,12,42,10,1
3,00:06:04,1,True,17,29,-12,17,10,1
3,00:05:47,2,True,17,29,-12,24,3,1
3,00:02:20,1,True,17,32,-15,35,10,1
3,00:01:21,1,True,17,32,-15,48,10,1
3,00:00:38,1,False,32,17,15,37,10,1
3,00:00:01,2,False,32,17,15,40,13,1
4,00:13:27,1,True,20,32,-12,55,10,1
4,00:12:52,1,False,32,20,12,38,10,1
4,00:12:38,1,False,32,20,12,25,10,1
4,00:12:00,2,False,32,20,12,21,6,1
4,00:10:59,2,False,32,20,12,10,10,1
4,00:09:40,1,False,32,20,12,1,10,1
4,00:08:19,2,False,32,20,12,45,11,1
4,00:03:39,1,True,20,32,-12,15,10,1
4,00:03:17,1,True,20,32,-12,31,10,1
4,00:02:45,3,True,20,32,-12,39,2,1
4,00:02:23,1,False,32,20,12,52,10,1
4,00:02:01,3,False,32,20,12,38,16,1
1,00:14:32,2,False,0,0,0,39,10,1
1,00:11:50,2,True,0,0,0,30,5,1
1,00:09:15,2,True,0,0,0,39,7,1
1,00:09:14,1,True,0,0,0,3,3,1
1,00:06:49,2,False,3,0,3,41,10,1
1,00:04:56,1,False,3,0,3,27,10,1
1,00:02:13,2,True,0,3,-3,16,24,1
2,00:15:00,1,False,3,0,3,33,10,1
2,00:13:10,1,False,3,0,3,22,10,1
2,00:12:16,1,True,7,3,4,46,10,1
2,00:10:30,2,True,7,3,4,28,6,1
2,00:09:21,2,True,7,3,4,17,10,1
2,00:08:00,2,True,7,6,1,55,10,1
2,00:06:48,2,False,6,7,-1,33,3,1
2,00:06:10,1,False,6,7,-1,16,10,1
2,00:05:26,1,False,6,7,-1,5,5,1
2,00:04:12,2,False,6,7,-1,1,1,1
2,00:03:15,1,False,6,14,-8,50,10,1
2,00:02:48,2,False,6,14,-8,52,8,1
2,00:01:19,2,True,14,6,8,27,7,1
3,00:12:56,2,False,6,14,-8,48,5,1
3,00:11:13,2,True,14,6,8,51,10,1
3,00:10:28,1,True,14,6,8,25,10,1
3,00:07:45,1,True,14,9,5,25,20,1
3,00:06:58,1,False,9,14,-5,36,10,1
3,00:05:15,1,False,9,14,-5,23,10,1
3,00:04:58,1,False,9,21,-12,21,10,1
3,00:03:36,1,False,9,21,-12,32,10,1
3,00:02:55,1,False,9,21,-12,45,10,1
3,00:01:45,2,True,21,9,12,20,5,1
3,00:00:38,2,True,21,9,12,9,9,1
4,00:14:45,1,True,21,12,9,38,10,1
4,00:14:25,2,True,21,12,9,41,7,1
4,00:13:46,1,False,12,21,-9,51,10,1
4,00:12:58,1,False,12,21,-9,35,10,1
4,00:12:28,2,False,12,21,-9,31,6,1
4,00:11:56,1,False,12,21,-9,18,10,1
4,00:10:29,1,False,12,24,-12,35,10,1
4,00:10:06,1,False,12,24,-12,50,10,1
4,00:09:05,1,True,24,12,12,43,10,1
4,00:08:27,1,True,24,12,12,31,10,1
4,00:05:59,2,True,24,12,12,36,11,1
4,00:00:45,1,False,12,38,-26,43,10,1
1,00:13:38,1,True,0,0,0,24,10,1
1,00:12:58,1,True,0,0,0,38,10,1
1,00:12:20,2,True,0,0,0,45,3,1
1,00:08:22,1,True,1,0,1,52,10,1
1,00:05:50,2,True,1,0,1,46,5,1
1,00:03:35,2,True,1,1,0,45,1,1
1,00:03:05,1,True,1,1,0,50,10,1
1,00:00:18,1,False,1,1,0,17,10,1
2,00:15:00,1,True,8,1,7,27,10,1
2,00:09:27,1,False,1,8,-7,26,10,1
2,00:07:50,2,False,1,8,-7,6,6,1
2,00:06:36,1,False,1,15,-14,48,10,1
2,00:05:54,2,True,15,1,14,51,10,1
2,00:01:49,2,False,1,15,-14,40,11,1
2,00:01:13,1,False,1,15,-14,26,10,1
2,00:01:08,2,False,1,15,-14,31,5,1
2,00:00:35,1,False,1,15,-14,46,10,1
3,00:11:55,1,True,15,1,14,9,10,1
3,00:11:20,1,True,15,1,14,21,10,1
3,00:10:40,1,False,1,15,-14,51,10,1
3,00:09:55,1,False,1,15,-14,16,10,1
3,00:07:29,2,True,22,1,21,51,4,1
3,00:03:04,2,False,4,22,-18,15,8,1
4,00:14:44,1,False,11,22,-11,30,10,1
4,00:14:20,2,False,11,22,-11,36,4,1
4,00:12:20,1,True,22,11,11,35,10,1
4,00:10:47,1,True,22,11,11,10,10,1
4,00:10:17,1,True,22,19,3,30,10,1
4,00:08:23,1,True,22,19,3,48,10,1
4,00:06:35,1,True,22,19,3,23,10,1
4,00:01:25,2,True,22,27,-5,26,10,1
4,00:01:21,1,True,22,27,-5,45,10,1
4,00:01:11,2,True,22,27,-5,51,4,1
1,00:10:11,2,False,0,0,0,43,10,1
1,00:08:11,2,False,0,3,-3,47,6,1
1,00:07:11,2,True,3,0,3,41,4,1
1,00:06:31,1,True,3,0,3,26,10,1
1,00:05:09,1,True,3,0,3,14,10,1
1,00:03:01,2,True,3,3,0,29,16,1
1,00:01:21,2,False,3,3,0,28,5,1
2,00:13:12,2,False,3,3,0,49,10,1
2,00:11:05,1,False,3,6,-3,34,10,1
2,00:08:33,2,True,6,3,3,43,7,1
2,00:08:04,1,True,6,3,3,19,10,1
2,00:04:32,2,False,10,6,4,27,10,1
2,00:02:47,1,True,6,10,-4,33,20,1
2,00:01:33,2,True,6,10,-4,17,15,1
2,00:01:22,2,True,6,17,-11,12,10,1
2,00:01:14,1,True,6,17,-11,32,10,1
2,00:00:53,1,True,6,17,-11,45,10,1
2,00:00:38,2,True,6,17,-11,50,5,1
2,00:00:23,2,False,17,6,11,52,10,1
3,00:14:12,2,True,6,17,-11,34,8,1
3,00:11:17,1,False,17,6,11,5,20,1
3,00:08:52,1,False,17,8,9,32,10,1
3,00:07:38,2,False,17,8,9,45,7,1
3,00:05:16,1,True,8,20,-12,35,10,1
3,00:03:58,1,True,8,20,-12,45,10,1
3,00:03:16,1,True,8,20,-12,51,10,1
3,00:02:35,1,False,20,8,12,22,10,1
3,00:00:54,1,False,20,15,5,42,10,1
4,00:14:07,1,True,15,20,-5,35,10,1
4,00:13:30,1,True,15,20,-5,17,10,1
4,00:12:38,1,True,15,20,-5,17,10,1
4,00:10:10,2,False,27,15,12,36,7,1
4,00:07:55,1,True,15,27,-12,14,10,1
4,00:06:51,1,True,15,27,-12,44,10,1
4,00:06:30,2,True,15,27,-12,49,5,1
4,00:06:17,1,False,27,15,12,26,10,1
4,00:05:22,1,False,27,15,12,7,7,1
4,00:03:00,2,True,22,27,-5,46,13,1
4,00:01:55,1,True,22,30,-8,35,10,1
4,00:01:24,1,False,30,22,8,3,3,1
4,00:01:08,2,False,30,28,2,17,7,1
4,00:00:08,2,False,30,28,2,53,10,1
1,00:14:18,2,False,0,0,0,34,5,1
1,00:13:01,2,False,0,0,0,45,5,1
1,00:12:00,1,True,0,0,0,36,15,1
1,00:10:54,2,True,0,0,0,24,3,1
1,00:10:24,1,True,0,7,-7,53,10,1
1,00:07:20,2,False,7,0,7,23,3,1
1,00:05:24,2,False,7,0,7,33,6,1
1,00:03:37,1,True,0,8,-8,35,10,1
1,00:01:21,1,True,0,8,-8,34,10,1
1,00:00:20,2,False,8,0,8,36,10,1
2,00:14:03,2,False,8,3,5,49,4,1
2,00:11:31,1,False,8,3,5,55,10,1
2,00:10:23,1,True,3,8,-5,45,10,1
2,00:09:10,1,True,3,8,-5,32,10,1
2,00:07:15,2,True,3,15,-12,26,10,1
2,00:05:06,1,False,15,3,12,25,10,1
2,00:04:38,1,False,15,3,12,37,10,1
2,00:01:45,2,True,3,22,-19,37,10,1
2,00:01:37,1,True,3,22,-19,49,10,1
2,00:01:32,1,False,22,3,19,47,10,1
3,00:14:55,1,True,6,22,-16,28,10,1
3,00:14:14,2,True,6,22,-16,28,10,1
3,00:13:13,1,True,6,22,-16,55,10,1
3,00:12:30,1,False,22,6,16,41,10,1
3,00:11:01,2,False,22,6,16,5,5,1
3,00:05:00,2,False,22,16,6,44,10,1
3,00:04:23,1,True,16,22,-6,20,10,1
3,00:03:55,2,True,16,22,-6,17,13,1
3,00:02:50,2,True,16,22,-6,35,8,1
4,00:13:35,2,True,16,23,-7,20,10,1
4,00:12:55,2,True,16,23,-7,41,4,1
4,00:11:54,2,False,23,16,7,41,8,1
4,00:10:26,2,False,23,19,4,37,8,1
4,00:09:18,1,False,23,19,4,49,10,1
4,00:08:04,2,True,19,23,-4,52,14,1
4,00:06:52,1,True,19,23,-4,15,10,1
4,00:06:18,1,True,19,30,-11,23,10,1
4,00:03:24,1,False,30,19,11,46,15,1
4,00:01:16,1,True,19,33,-14,35,10,1
1,00:14:53,1,False,0,0,0,32,10,1
1,00:14:31,2,False,0,0,0,26,4,1
1,00:13:48,1,False,0,0,0,22,10,1
1,00:13:05,2,False,0,0,0,23,11,1
1,00:09:45,1,True,3,0,3,25,10,1
1,00:08:14,1,False,0,3,-3,35,10,1
1,00:06:24,2,False,0,3,-3,48,7,1
1,00:05:30,1,True,3,0,3,49,10,1
1,00:01:58,2,True,3,1,2,24,10,1
2,00:13:35,1,False,8,3,5,43,10,1
2,00:12:04,1,False,8,3,5,55,10,1
2,00:11:24,2,True,3,8,-5,51,6,1
2,00:10:32,1,True,3,9,-6,35,10,1
2,00:09:12,1,True,3,9,-6,50,10,1
2,00:08:15,1,False,9,3,6,40,10,1
2,00:07:23,1,False,9,3,6,20,10,1
2,00:05:19,1,False,9,10,-1,25,10,1
2,00:02:21,2,True,17,9,8,21,10,1
2,00:01:45,1,True,17,16,1,39,10,1
2,00:01:34,2,True,17,16,1,50,15,1
2,00:00:55,2,False,16,17,-1,26,7,1
2,00:00:22,1,True,17,16,1,36,10,1
2,00:00:20,1,True,17,16,1,47,10,1
3,00:14:55,1,True,17,16,1,41,10,1
3,00:12:51,2,False,16,17,-1,27,9,1
3,00:04:42,2,True,17,17,0,38,7,1
3,00:04:22,1,True,17,17,0,50,10,1
3,00:04:06,2,False,17,17,0,54,4,1
3,00:03:18,1,False,17,17,0,38,10,1
4,00:14:14,2,False,17,17,0,3,13,1
4,00:12:53,2,False,17,17,0,53,10,1
4,00:10:30,1,True,19,17,2,47,10,1
4,00:09:46,1,False,17,19,-2,52,10,1
4,00:09:06,2,False,17,19,-2,39,10,1
4,00:07:42,2,False,17,19,-2,15,4,1
4,00:06:19,2,False,17,19,-2,11,10,1
4,00:03:25,1,True,26,20,6,50,10,1
4,00:02:59,1,False,20,26,-6,49,10,1
4,00:00:47,1,False,20,27,-7,46,10,1
4,00:00:40,2,False,20,27,-7,53,3,1
1,00:14:15,2,False,0,0,0,38,6,1
1,00:12:44,2,False,0,0,0,48,8,1
1,00:11:12,2,True,0,0,0,53,7,1
1,00:10:09,1,False,0,0,0,22,10,1
1,00:08:53,1,True,0,0,0,55,10,1
1,00:07:57,1,False,0,0,0,48,20,1
1,00:07:35,2,False,0,0,0,40,12,1
1,00:05:09,1,False,0,3,-3,43,5,1
1,00:02:34,1,True,3,0,3,41,10,1
2,00:12:09,1,True,3,0,3,7,7,1
2,00:11:18,2,True,3,0,3,6,6,1
2,00:10:21,2,True,3,7,-4,36,9,1
2,00:09:30,1,False,7,3,4,47,10,1
2,00:08:29,1,False,7,3,4,23,10,1
2,00:07:20,2,False,7,3,4,36,6,1
2,00:06:56,1,True,3,7,-4,29,10,1
2,00:05:03,2,True,3,7,-4,8,6,1
2,00:02:37,2,True,3,15,-12,30,7,1
2,00:01:44,1,True,3,15,-12,49,10,1
2,00:00:48,1,False,15,3,12,25,10,1
2,00:00:29,2,False,15,3,12,45,10,1
2,00:00:14,2,True,3,15,-12,40,10,1
3,00:12:16,1,True,10,16,-6,46,10,1
3,00:11:33,1,True,10,16,-6,21,10,1
3,00:09:32,2,True,10,23,-13,27,9,1
3,00:06:56,2,False,23,10,13,25,9,1
3,00:03:35,1,True,10,23,-13,48,10,1
4,00:12:18,2,False,25,10,15,27,21,1
4,00:11:16,1,True,10,25,-15,33,10,1
4,00:10:35,1,False,25,10,15,36,10,1
4,00:10:16,1,False,25,10,15,16,10,1
4,00:08:21,1,False,25,10,15,50,10,1
4,00:06:27,1,True,10,28,-18,35,10,1
4,00:05:50,2,True,10,28,-18,42,3,1
4,00:04:50,2,True,10,28,-18,55,10,1
4,00:04:20,1,False,28,10,18,43,10,1
4,00:03:00,2,False,28,10,18,23,10,1
4,00:02:13,3,False,28,10,18,15,15,1
4,00:00:19,1,True,17,31,-14,48,10,1
1,00:13:42,1,True,0,0,0,11,10,1
1,00:13:25,1,True,0,7,-7,34,10,1
1,00:10:26,1,True,0,7,-7,46,15,1
1,00:10:14,2,True,0,7,-7,50,19,1
1,00:08:53,2,True,0,7,-7,18,8,1
1,00:07:30,1,True,0,7,-7,24,10,1
1,00:06:43,2,True,0,7,-7,19,5,1
1,00:02:39,2,False,21,0,21,47,8,1
1,00:01:25,2,True,0,21,-21,43,10,1
2,00:15:00,1,True,0,21,-21,14,10,1
2,00:14:01,1,True,0,21,-21,25,10,1
2,00:13:07,2,True,0,21,-21,47,5,1
2,00:12:30,1,False,21,0,21,7,10,1
2,00:10:55,2,False,21,0,21,28,10,1
2,00:06:52,1,True,0,21,-21,53,10,1
2,00:06:33,1,True,0,21,-21,40,10,1
2,00:05:56,2,True,0,21,-21,35,5,1
2,00:04:51,2,True,0,21,-21,26,10,1
2,00:03:47,1,True,0,21,-21,14,10,1
2,00:02:26,2,False,28,0,28,50,10,1
2,00:01:41,1,True,0,28,-28,39,10,1
2,00:01:20,2,True,0,28,-28,38,9,1
2,00:00:32,1,True,0,31,-31,35,10,1
2,00:00:21,2,False,31,0,31,52,10,1
3,00:13:42,2,False,31,3,28,27,14,1
3,00:11:31,2,False,31,3,28,39,7,1
3,00:06:30,1,True,3,31,-28,49,10,1
3,00:00:18,1,True,3,32,-29,30,10,1
4,00:14:26,2,False,32,3,29,48,10,1
4,00:13:41,2,False,32,10,22,20,12,1
4,00:12:45,1,True,10,32,-22,52,10,1
4,00:11:33,1,False,32,10,22,47,10,1
4,00:10:18,2,False,32,10,22,31,10,1
4,00:03:13,2,True,13,35,-22,26,19,1
4,00:00:31,1,True,13,38,-25,35,10,1
4,00:00:23,1,True,13,38,-25,53,10,1
1,00:10:38,1,True,7,0,7,50,10,1
1,00:05:16,1,False,0,13,-13,26,10,1
1,00:04:36,2,False,0,13,-13,33,3,1
1,00:01:50,2,True,13,0,13,55,7,1
2,00:13:03,2,False,0,16,-16,30,15,1
2,00:09:56,1,True,16,0,16,20,10,1
2,00:09:37,1,True,16,7,9,32,10,1
2,00:08:33,2,False,7,16,-9,52,7,1
2,00:07:21,2,False,7,16,-9,13,4,1
2,00:05:46,1,True,16,7,9,27,10,1
2,00:04:27,1,True,16,7,9,45,10,1
2,00:03:00,1,False,7,16,-9,44,10,1
2,00:02:46,2,False,7,16,-9,38,4,1
2,00:01:36,1,True,23,7,16,29,10,1
2,00:01:15,2,True,23,7,16,46,5,1
2,00:00:16,2,False,7,23,-16,47,10,1
2,00:00:10,3,False,7,23,-16,42,5,1
3,00:13:51,2,True,26,7,19,35,6,1
3,00:13:12,1,True,26,7,19,25,10,1
3,00:10:40,1,False,10,26,-16,35,10,1
3,00:10:05,1,False,10,26,-16,49,10,1
3,00:09:21,2,True,26,10,16,12,5,1
3,00:08:16,1,True,26,10,16,3,3,1
3,00:08:01,1,True,26,17,9,29,10,1
3,00:07:41,1,True,26,17,9,41,10,1
3,00:04:38,1,True,26,17,9,19,10,1
3,00:01:32,1,True,26,17,9,11,10,1
3,00:00:42,1,True,26,20,6,35,10,1
4,00:10:15,1,True,28,20,8,55,10,1
4,00:09:34,1,False,20,28,-8,40,10,1
4,00:08:30,1,False,20,28,-8,25,10,1
4,00:07:55,1,False,20,35,-15,35,10,1
4,00:06:47,1,False,20,35,-15,51,10,1
4,00:05:11,1,True,35,20,15,23,10,1
4,00:02:28,1,False,27,42,-15,40,10,1
4,00:02:03,1,True,42,27,15,45,10,1
4,00:01:52,2,True,42,27,15,40,5,1
1,00:14:35,1,True,0,0,0,42,5,1
1,00:13:12,2,False,0,0,0,53,20,1
1,00:12:11,1,False,0,0,0,22,10,1
1,00:10:32,2,True,0,0,0,18,10,1
1,00:09:26,1,True,0,0,0,6,6,1
1,00:09:03,1,True,0,7,-7,19,20,1
1,00:09:00,2,True,0,7,-7,25,14,1
1,00:07:25,2,True,0,7,-7,54,5,1
1,00:06:49,1,False,7,0,7,40,10,1
1,00:06:24,2,False,7,0,7,34,4,1
1,00:04:34,1,False,7,0,7,17,10,1
1,00:03:10,2,True,0,7,-7,22,1,1
1,00:02:56,1,True,0,14,-14,28,10,1
1,00:02:10,1,False,14,0,14,37,10,1
2,00:10:01,1,True,3,21,-18,24,10,1
2,00:09:26,1,True,3,21,-18,35,10,1
2,00:08:07,1,False,21,3,18,30,10,1
2,00:06:53,1,True,3,21,-18,40,10,1
2,00:03:05,2,True,3,24,-21,41,4,1
2,00:01:50,1,True,3,24,-21,12,10,1
2,00:01:22,2,True,3,24,-21,6,4,1
2,00:00:54,2,False,31,3,28,28,7,1
3,00:12:58,2,True,3,31,-28,37,10,1
3,00:12:40,1,True,3,31,-28,50,10,1
3,00:11:40,1,False,31,3,28,25,10,1
3,00:11:12,2,False,31,3,28,27,8,1
3,00:10:02,1,True,3,31,-28,42,10,1
3,00:09:35,1,False,31,3,28,54,10,1
3,00:09:17,1,False,31,3,28,43,10,1
3,00:07:23,2,False,31,3,28,32,8,1
3,00:04:04,2,True,3,32,-29,32,13,1
3,00:02:10,2,False,32,3,29,50,5,1
4,00:14:25,2,True,3,32,-29,21,10,1
4,00:13:11,1,False,39,3,36,48,10,1
4,00:10:33,1,True,3,40,-37,30,15,1
4,00:10:08,2,True,3,40,-37,51,10,1
4,00:08:58,2,False,40,3,37,31,5,1
4,00:05:19,1,False,40,10,30,41,10,1
4,00:04:30,1,False,40,10,30,6,10,1
4,00:03:00,3,False,40,17,23,7,7,1
4,00:01:04,2,True,24,47,-23,48,3,1
1,00:14:56,1,False,0,0,0,30,10,1
1,00:14:03,2,False,0,0,0,42,8,1
1,00:13:21,1,True,0,0,0,54,10,1
1,00:11:25,1,True,0,3,-3,35,10,1
1,00:08:55,1,False,3,0,3,9,10,1
1,00:08:21,1,False,3,0,3,21,10,1
1,00:07:47,2,False,3,0,3,30,1,1
1,00:06:49,1,True,0,3,-3,38,10,1
1,00:06:25,1,True,0,3,-3,28,10,1
1,00:04:31,1,True,0,3,-3,1,1,1
1,00:04:08,1,True,0,10,-10,49,10,1
1,00:03:33,2,True,0,10,-10,54,5,1
1,00:01:38,1,False,10,0,10,29,10,1
1,00:00:41,1,False,10,0,10,40,15,1
2,00:13:48,2,True,0,10,-10,9,8,1
2,00:12:44,1,True,0,10,-10,48,10,1
2,00:11:18,2,False,10,0,10,47,6,1
2,00:08:27,1,False,10,0,10,6,6,1
2,00:08:14,1,False,10,7,3,25,10,1
2,00:07:35,2,False,10,7,3,30,5,1
2,00:03:20,2,False,10,7,3,45,13,1
2,00:02:38,1,True,7,10,-3,25,10,1
2,00:02:32,1,True,7,17,-10,17,10,1
2,00:02:27,1,True,7,17,-10,35,10,1
2,00:01:36,1,False,17,7,10,54,10,1
2,00:00:46,2,False,17,7,10,49,10,1
2,00:00:29,2,True,7,17,-10,54,15,1
3,00:14:54,1,True,7,17,-10,9,10,1
3,00:13:23,1,True,7,17,-10,31,10,1
3,00:11:33,1,True,7,17,-10,51,10,1
3,00:05:39,1,True,7,17,-10,13,10,1
3,00:05:10,2,True,7,17,-10,13,10,1
3,00:02:18,2,True,7,17,-10,8,5,1
4,00:13:39,1,True,8,24,-16,39,10,1
4,00:11:24,2,False,24,11,13,31,10,1
4,00:10:30,1,False,24,11,13,46,10,1
4,00:09:37,2,True,11,24,-13,46,6,1
4,00:06:57,2,True,11,27,-16,40,10,1
4,00:05:02,2,True,11,34,-23,35,10,1
4,00:04:07,2,False,34,11,23,51,12,1
4,00:03:24,3,False,34,11,23,46,7,1
4,00:01:48,1,True,18,34,-16,16,10,1
1,00:14:49,1,True,0,0,0,38,10,1
1,00:12:18,1,False,0,0,0,40,10,1
1,00:09:25,1,False,0,3,-3,30,15,1
1,00:08:16,1,True,3,0,3,36,10,1
1,00:07:48,1,True,3,0,3,54,10,1
1,00:04:33,1,True,10,3,7,33,10,1
1,00:03:10,2,False,3,10,-7,38,5,1
1,00:02:25,1,False,3,10,-7,32,10,1
1,00:00:53,2,False,3,17,-14,20,10,1
1,00:00:25,1,False,3,17,-14,36,10,1
2,00:15:00,2,False,3,17,-14,41,5,1
2,00:12:58,1,True,17,3,14,18,15,1
2,00:12:50,1,True,17,3,14,38,10,1
2,00:12:27,2,True,17,3,14,44,4,1
2,00:10:28,1,False,3,18,-15,35,10,1
2,00:08:51,1,True,18,3,15,20,10,1
2,00:06:14,2,False,3,18,-15,10,10,1
2,00:04:53,1,False,3,18,-15,48,10,1
2,00:04:29,2,False,3,18,-15,48,10,1
2,00:02:59,1,True,18,4,14,35,10,1
2,00:02:02,1,False,4,18,-14,36,10,1
2,00:01:19,1,False,4,18,-14,24,10,1
2,00:00:52,1,True,25,4,21,35,10,1
3,00:13:25,2,False,4,25,-21,44,14,1
3,00:08:57,1,False,4,28,-24,40,10,1
3,00:08:23,2,False,4,28,-24,46,4,1
3,00:05:40,1,True,28,4,24,3,10,1
3,00:04:30,1,True,28,4,24,39,5,1
3,00:03:05,2,False,4,28,-24,36,10,1
3,00:01:26,2,True,35,11,24,22,11,1
4,00:13:32,2,False,11,35,-24,43,10,1
4,00:11:50,2,False,11,38,-27,35,10,1
4,00:08:16,2,True,38,11,27,33,10,1
4,00:07:17,1,False,11,38,-27,28,10,1
4,00:05:49,2,False,11,38,-27,41,10,1
4,00:04:40,1,True,38,11,27,37,10,1
4,00:03:50,1,True,38,11,27,47,10,1
4,00:00:26,2,False,11,38,-27,8,7,1
1,00:14:23,2,False,0,0,0,35,7,1
1,00:12:52,2,True,0,0,0,40,5,1
1,00:11:09,1,False,0,0,0,22,10,1
1,00:11:00,2,False,0,0,0,28,4,1
1,00:08:51,1,True,0,3,-3,51,10,1
1,00:06:29,2,False,3,0,3,21,10,1
1,00:06:07,1,False,3,7,-4,40,10,1
1,00:03:10,2,True,7,3,4,40,10,1
2,00:13:32,1,False,4,7,-3,28,10,1
2,00:12:23,1,True,7,4,3,42,10,1
2,00:08:24,1,True,8,4,4,17,10,1
2,00:04:27,2,True,8,7,1,45,10,1
2,00:01:46,1,True,8,7,1,41,10,1
2,00:01:00,1,False,7,8,-1,44,10,1
2,00:00:34,1,False,7,8,-1,41,10,1
3,00:14:38,1,True,8,7,1,35,10,1
3,00:11:17,2,False,10,8,2,54,10,1
3,00:07:30,2,False,10,9,1,29,9,1
3,00:06:56,1,False,10,9,1,51,10,1
3,00:01:52,2,True,11,11,0,45,5,1
3,00:01:21,1,True,11,11,0,52,10,1
4,00:13:35,2,False,11,14,-3,37,2,1
4,00:12:30,2,True,14,11,3,44,8,1
4,00:10:02,2,True,14,14,0,36,9,1
4,00:09:36,1,True,14,14,0,47,10,1
4,00:08:45,2,True,14,14,0,51,6,1
4,00:05:44,2,False,14,14,0,41,10,1
4,00:04:40,2,True,14,14,0,54,14,1
4,00:02:59,2,True,14,14,0,18,25,1
4,00:01:39,1,True,14,21,-7,26,10,1
4,00:01:31,1,True,14,21,-7,41,10,1
4,00:01:02,2,True,14,21,-7,45,6,1
1,00:14:50,1,False,0,0,0,37,10,1
1,00:13:50,2,False,0,0,0,19,6,1
1,00:05:56,2,False,0,3,-3,40,7,1
1,00:02:08,1,False,0,10,-10,39,10,1
1,00:00:39,1,False,0,13,-13,35,10,1
1,00:00:03,2,False,0,13,-13,34,11,1
2,00:12:57,1,True,13,3,10,50,10,1
2,00:11:03,1,False,3,16,-13,34,10,1
2,00:10:41,1,True,16,3,13,48,10,1
2,00:08:58,1,True,16,4,12,35,10,1
2,00:08:02,1,True,16,4,12,46,10,1
2,00:07:25,2,True,16,4,12,48,8,1
2,00:05:55,2,False,4,16,-12,50,8,1
2,00:04:52,2,False,4,16,-12,39,10,1
2,00:04:23,1,False,4,16,-12,14,10,1
2,00:02:39,2,False,4,19,-15,41,10,1
2,00:02:34,1,False,4,19,-15,52,10,1
2,00:02:14,1,True,19,4,15,47,10,1
2,00:01:59,2,True,19,4,15,41,4,1
2,00:01:45,1,True,19,4,15,27,10,1
2,00:01:36,1,True,19,11,8,43,10,1
2,00:01:31,1,True,19,11,8,53,10,1
2,00:01:14,2,False,11,19,-8,44,10,1
3,00:13:30,2,True,19,11,8,52,6,1
3,00:11:36,2,False,11,19,-8,9,4,1
3,00:09:48,2,False,11,19,-8,20,10,1
3,00:07:51,2,False,11,26,-15,50,10,1
3,00:06:29,2,True,26,11,15,21,10,1
3,00:04:19,2,True,26,18,8,15,10,1
3,00:00:29,1,False,18,26,-8,40,10,1
4,00:15:00,1,True,26,18,8,24,10,1
4,00:13:41,1,False,18,26,-8,49,10,1
4,00:11:53,1,False,18,26,-8,45,10,1
4,00:11:38,2,False,18,26,-8,50,5,1
4,00:10:40,2,True,26,18,8,31,8,1
4,00:10:01,1,True,26,18,8,18,10,1
4,00:08:13,1,True,26,18,8,6,6,1
4,00:07:51,1,True,26,26,0,50,10,1
4,00:05:36,2,False,26,26,0,6,6,1
4,00:03:12,1,True,33,26,7,19,10,1
4,00:01:35,2,False,26,33,-7,45,10,1
4,00:01:01,1,False,26,40,-14,41,10,1
4,00:00:19,1,True,40,26,14,46,10,1
1,00:14:54,1,True,0,0,0,32,10,1
1,00:13:52,2,True,0,0,0,49,6,1
1,00:13:37,1,False,0,0,0,52,10,1
1,00:12:32,1,False,0,0,0,40,10,1
1,00:12:16,1,False,0,7,-7,33,10,1
1,00:11:13,1,False,0,7,-7,50,10,1
1,00:07:45,2,False,0,7,-7,28,16,1
1,00:05:47,1,True,7,0,7,51,10,1
1,00:05:08,1,True,7,0,7,31,10,1
1,00:04:19,1,True,7,0,7,17,15,1
1,00:03:35,2,True,7,0,7,12,10,1
1,00:00:28,1,False,7,14,-7,45,10,1
2,00:13:23,1,True,14,7,7,14,10,1
2,00:12:10,2,True,14,7,7,9,15,1
2,00:11:25,2,False,7,14,-7,47,10,1
2,00:06:58,1,True,14,9,5,14,10,1
2,00:06:38,1,True,14,16,-2,28,10,1
2,00:03:56,1,False,16,14,2,16,10,1
2,00:01:17,1,False,16,21,-5,7,10,1
2,00:00:16,1,True,21,16,5,47,10,1
3,00:10:03,1,True,21,16,5,16,10,1
3,00:09:32,2,True,21,16,5,22,4,1
3,00:05:23,1,True,21,16,5,29,10,1
3,00:03:33,1,True,21,19,2,29,10,1
3,00:02:46,2,True,21,19,2,49,10,1
3,00:01:34,2,False,19,21,-2,25,10,1
3,00:00:30,1,True,21,19,2,39,10,1
4,00:14:40,2,True,21,19,2,55,7,1
4,00:08:33,1,False,19,24,-5,35,10,1
4,00:07:54,2,False,19,24,-5,38,7,1
4,00:06:12,3,False,19,24,-5,52,6,1
4,00:05:18,1,True,24,19,5,36,10,1
4,00:03:55,1,True,24,22,2,35,10,1
4,00:01:11,1,False,22,26,-4,37,10,1
4,00:01:06,1,False,22,26,-4,52,10,1
4,00:00:50,1,True,26,22,4,45,10,1
4,00:00:33,2,True,26,22,4,40,5,1
1,00:12:58,2,True,0,0,0,34,3,1
1,00:10:35,2,False,0,0,0,30,5,1
1,00:08:50,2,False,0,0,0,54,5,1
1,00:04:34,1,True,0,3,-3,30,10,1
1,00:03:59,2,True,0,3,-3,35,5,1
1,00:02:56,2,True,0,3,-3,43,7,1
1,00:01:57,2,False,3,0,3,54,10,1
1,00:00:50,1,False,3,0,3,40,10,1
2,00:14:25,2,False,3,0,3,20,3,1
2,00:14:00,1,False,3,7,-4,41,10,1
2,00:12:44,1,True,7,3,4,55,10,1
2,00:11:52,1,False,3,7,-4,29,10,1
2,00:08:51,2,False,3,14,-11,25,10,1
2,00:04:47,2,True,14,3,11,41,7,1
2,00:02:25,2,False,3,14,-11,19,6,1
2,00:02:01,2,False,3,14,-11,26,10,1
2,00:00:12,2,True,14,3,11,24,10,1
3,00:14:25,2,False,3,14,-11,38,4,1
3,00:09:22,2,True,14,4,10,24,5,1
3,00:00:48,2,False,9,14,-5,40,12,1
4,00:15:00,2,True,14,9,5,16,6,1
4,00:14:07,2,True,14,9,5,42,4,1
4,00:11:29,2,False,9,14,-5,25,8,1
4,00:10:45,1,False,9,14,-5,16,10,1
4,00:08:51,2,False,9,14,-5,3,13,1
4,00:08:19,1,False,9,14,-5,25,10,1
4,00:06:58,1,False,9,14,-5,24,15,1
4,00:06:32,1,False,9,14,-5,43,10,1
4,00:02:45,1,True,14,9,5,53,10,1
4,00:02:22,3,True,14,9,5,48,5,1
4,00:01:33,2,True,14,9,5,8,10,1
1,00:14:52,1,True,0,0,0,31,10,1
1,00:14:16,1,True,0,0,0,45,10,1
1,00:13:42,1,False,0,0,0,54,10,1
1,00:11:48,3,False,0,0,0,45,1,1
1,00:11:30,1,False,0,7,-7,44,10,1
1,00:11:03,1,True,7,0,7,51,10,1
1,00:10:46,1,True,7,0,7,20,10,1
1,00:09:59,2,True,7,0,7,9,9,1
1,00:07:57,1,True,7,3,4,43,10,1
1,00:06:40,2,False,3,7,-4,50,6,1
1,00:05:30,2,False,3,7,-4,11,10,1
1,00:05:11,1,False,3,7,-4,23,10,1
1,00:03:45,2,False,3,7,-4,55,15,1
1,00:02:30,2,True,7,3,4,37,9,1
1,00:01:50,1,True,7,6,1,35,10,1
1,00:00:02,2,False,6,7,-1,45,7,1
2,00:13:17,1,True,7,9,-2,49,10,1
2,00:11:58,1,False,9,7,2,27,10,1
2,00:10:30,1,False,9,7,2,8,8,1
2,00:09:32,1,False,9,14,-5,44,10,1
2,00:09:08,2,False,9,14,-5,50,4,1
2,00:06:26,1,True,14,9,5,27,10,1
2,00:06:10,2,True,14,9,5,34,3,1
2,00:04:53,2,True,14,9,5,35,18,1
2,00:03:12,2,False,9,14,-5,7,8,1
2,00:02:34,1,False,9,14,-5,45,10,1
2,00:01:42,1,True,14,9,5,4,4,1
2,00:01:35,1,True,14,16,-2,31,10,1
2,00:01:28,1,True,14,16,-2,55,10,1
2,00:01:14,1,False,16,14,2,34,10,1
2,00:01:06,2,False,16,14,2,25,1,1
2,00:00:43,1,False,16,14,2,15,15,1
3,00:14:53,1,False,16,17,-1,41,10,1
3,00:13:16,1,True,17,16,1,20,10,1
3,00:12:07,1,True,17,16,1,46,10,1
3,00:11:31,2,True,17,16,1,52,4,1
3,00:10:35,1,False,16,17,-1,31,10,1
3,00:10:21,1,False,16,24,-8,10,10,1
3,00:08:29,1,False,16,24,-8,54,10,1
3,00:04:49,1,True,26,16,10,46,10,1
3,00:04:31,1,False,16,26,-10,26,10,1
3,00:01:51,2,False,16,33,-17,53,12,1
3,00:00:50,1,True,33,16,17,36,10,1
4,00:15:00,2,False,16,33,-17,51,5,1
4,00:12:56,1,False,16,33,-17,15,20,1
4,00:12:17,1,True,33,16,17,44,10,1
4,00:09:01,1,False,17,33,-16,41,10,1
4,00:08:32,1,False,17,33,-16,55,10,1
4,00:07:35,3,True,33,17,16,47,2,1
4,00:07:06,1,True,33,17,16,30,10,1
4,00:05:57,2,True,33,17,16,22,2,1
4,00:05:01,2,True,33,23,10,24,9,1
4,00:03:06,1,True,33,23,10,45,10,1
4,00:02:51,1,True,33,23,10,30,10,1
4,00:02:38,2,True,33,23,10,28,8,1
4,00:02:10,1,True,33,26,7,35,10,1
4,00:02:03,2,True,33,26,7,37,8,1
4,00:01:05,1,False,26,36,-10,35,10,1
4,00:00:52,1,False,26,36,-10,52,10,1
4,00:00:43,1,True,36,26,10,42,10,1
4,00:00:32,2,True,36,26,10,37,5,1
4,00:00:01,2,True,36,26,10,34,20,1
1,00:14:54,1,False,0,0,0,39,10,1
1,00:06:55,1,True,0,3,-3,26,10,1
1,00:05:59,2,True,0,3,-3,40,9,1
1,00:04:39,2,False,3,0,3,45,10,1
1,00:00:28,1,True,0,3,-3,17,10,1
2,00:14:50,1,True,0,10,-10,50,10,1
2,00:13:50,1,False,10,0,10,39,10,1
2,00:12:27,2,False,10,0,10,26,11,1
2,00:11:08,2,True,0,10,-10,55,5,1
2,00:09:03,2,False,10,0,10,28,3,1
2,00:07:17,2,False,10,0,10,12,10,1
2,00:06:51,1,False,10,7,3,44,10,1
2,00:05:13,1,False,10,7,3,36,10,1
2,00:04:42,2,False,10,7,3,39,7,1
2,00:03:46,1,True,7,10,-3,55,10,1
2,00:02:49,1,False,10,7,3,42,10,1
2,00:02:20,1,False,10,7,3,41,20,1
2,00:01:23,1,False,10,17,-7,33,10,1
2,00:01:15,1,True,17,10,7,54,10,1
2,00:00:55,2,True,17,10,7,47,3,1
2,00:00:09,2,True,17,10,7,40,10,1
3,00:14:00,2,False,17,17,0,51,9,1
3,00:13:02,1,False,17,17,0,40,10,1
3,00:11:24,1,False,17,17,0,8,9,1
3,00:10:12,1,False,17,20,-3,32,10,1
3,00:08:45,2,False,17,20,-3,45,10,1
3,00:07:08,2,True,20,17,3,35,14,1
3,00:05:19,1,True,20,24,-4,43,10,1
3,00:04:17,2,True,20,24,-4,55,10,1
3,00:03:07,2,False,24,20,4,41,8,1
3,00:01:47,1,False,24,23,1,39,10,1
4,00:07:52,1,True,26,31,-5,42,10,1
4,00:06:15,2,False,31,26,5,33,10,1
4,00:05:08,1,True,26,31,-5,49,10,1
4,00:04:36,2,True,26,31,-5,55,4,1
4,00:04:01,1,False,31,26,5,38,10,1
4,00:02:32,2,False,31,27,4,38,7,1
1,00:11:12,2,False,0,0,0,42,19,1
1,00:10:10,1,True,0,0,0,46,10,1
1,00:07:58,2,True,0,3,-3,40,5,1
1,00:06:25,2,False,5,0,5,49,4,1
1,00:05:05,1,True,0,5,-5,29,10,1
1,00:04:20,1,True,0,5,-5,10,10,1
1,00:01:04,1,True,0,12,-12,16,10,1
2,00:14:02,2,False,12,0,12,44,20,1
2,00:13:36,3,True,0,12,-12,53,7,1
2,00:11:52,1,True,0,12,-12,30,10,1
2,00:08:03,2,True,0,12,-12,35,12,1
2,00:06:37,1,True,0,15,-15,33,10,1
2,00:06:10,1,False,15,0,15,25,10,1
2,00:04:56,2,False,15,0,15,7,7,1
2,00:03:38,3,False,15,0,15,3,3,1
2,00:01:56,1,True,7,15,-8,27,10,1
3,00:11:13,1,True,14,28,-14,19,20,1
3,00:08:38,1,False,28,21,7,44,10,1
3,00:02:35,1,False,28,24,4,32,10,1
3,00:00:57,2,True,24,28,-4,37,10,1
4,00:15:00,2,False,28,24,4,38,10,1
4,00:12:33,2,False,28,27,1,15,12,1
4,00:12:04,1,False,28,27,1,31,10,1
4,00:10:37,2,False,28,27,1,51,15,1
4,00:07:42,1,True,27,31,-4,29,10,1
4,00:06:01,2,False,38,33,5,26,19,1
4,00:00:48,1,True,36,38,-2,5,10,1
4,00:00:33,3,True,36,38,-2,10,5,1
4,00:00:22,2,True,36,38,-2,31,10,1
4,00:00:09,2,True,36,38,-2,46,10,1
1,00:14:25,1,True,0,0,0,45,10,1
1,00:13:50,1,False,0,0,0,54,10,1
1,00:12:40,1,False,0,0,0,43,10,1
1,00:11:43,1,False,0,0,0,32,10,1
1,00:09:50,1,False,0,0,0,19,10,1
1,00:08:33,2,False,0,7,-7,44,6,1
1,00:02:50,1,False,4,7,-3,52,10,1
1,00:00:49,2,True,7,4,3,25,10,1
2,00:12:59,1,True,7,7,0,15,10,1
2,00:12:19,1,True,7,7,0,25,10,1
2,00:11:24,2,True,7,7,0,17,18,1
2,00:10:51,1,False,7,7,0,42,10,1
2,00:09:52,2,True,7,7,0,54,9,1
2,00:07:33,1,True,7,7,0,20,10,1
2,00:07:01,1,True,7,14,-7,37,10,1
2,00:04:25,2,False,14,7,7,14,20,1
2,00:03:40,1,True,7,14,-7,40,10,1
2,00:03:10,1,False,14,7,7,31,10,1
2,00:02:27,2,False,14,7,7,7,3,1
2,00:01:44,1,False,14,14,0,48,10,1
2,00:01:16,2,True,14,14,0,30,10,1
2,00:01:09,1,True,14,21,-7,28,10,1
2,00:00:49,2,True,14,21,-7,42,10,1
3,00:10:29,1,False,21,14,7,13,10,1
3,00:09:42,1,False,21,14,7,24,10,1
3,00:06:43,1,True,14,21,-7,27,10,1
3,00:06:20,1,True,14,21,-7,38,10,1
3,00:02:14,2,False,21,14,7,49,10,1
3,00:00:18,2,True,14,21,-7,44,6,1
3,00:00:02,1,True,14,21,-7,35,10,1
4,00:12:43,1,True,14,22,-8,21,10,1
4,00:10:34,1,True,14,29,-15,31,10,1
4,00:10:00,2,True,14,29,-15,35,6,1
4,00:08:36,2,False,29,14,15,41,11,1
4,00:07:39,1,True,14,29,-15,21,10,1
4,00:06:31,2,True,14,29,-15,36,15,1
4,00:04:55,2,False,29,14,15,50,5,1
1,00:13:10,1,False,0,0,0,41,10,1
1,00:12:12,1,True,0,0,0,32,10,1
1,00:11:33,2,True,0,0,0,39,3,1
1,00:10:29,2,True,0,0,0,51,7,1
1,00:09:25,1,False,0,0,0,55,10,1
1,00:08:45,1,True,0,0,0,29,10,1
1,00:07:27,2,True,0,1,-1,35,10,1
1,00:06:01,1,False,1,0,1,47,10,1
1,00:01:39,2,False,1,2,-1,28,15,1
2,00:15:00,2,False,1,9,-8,31,22,1
2,00:14:07,1,True,9,1,8,16,10,1
2,00:13:40,1,True,9,1,8,28,10,1
2,00:11:15,1,True,9,1,8,41,10,1
2,00:10:47,2,True,9,1,8,47,4,1
2,00:09:40,1,True,9,1,8,52,10,1
2,00:09:21,2,True,9,1,8,55,7,1
2,00:08:48,1,False,1,9,-8,11,10,1
2,00:07:09,1,False,1,16,-15,34,10,1
2,00:05:06,2,False,1,16,-15,52,16,1
2,00:02:52,1,False,1,16,-15,31,10,1
2,00:02:39,2,False,1,16,-15,30,11,1
2,00:02:02,1,True,16,1,15,41,10,1
2,00:01:19,1,True,16,1,15,32,25,1
2,00:00:53,1,True,16,8,8,43,10,1
3,00:14:51,1,True,16,8,8,46,10,1
3,00:14:28,2,True,16,8,8,51,5,1
3,00:13:20,1,False,8,16,-8,45,10,1
3,00:12:48,2,False,8,16,-8,39,4,1
3,00:12:28,1,False,8,16,-8,25,10,1
3,00:11:28,2,False,8,16,-8,21,6,1
3,00:10:33,1,False,8,23,-15,33,10,1
3,00:08:26,2,True,23,8,15,34,7,1
3,00:06:37,1,False,8,23,-15,52,10,1
3,00:06:00,2,False,8,23,-15,48,6,1
3,00:04:11,1,False,8,24,-16,35,10,1
3,00:03:20,1,True,24,8,16,43,10,1
3,00:02:03,2,True,24,8,16,33,10,1
3,00:01:39,1,True,24,8,16,10,10,1
3,00:00:08,1,True,24,11,13,26,10,1
4,00:14:20,1,True,24,11,13,37,10,1
4,00:11:53,1,False,11,24,-13,38,5,1
4,00:11:40,2,False,11,24,-13,40,3,1
4,00:11:17,1,False,11,24,-13,44,10,1
4,00:08:17,2,True,24,11,13,12,10,1
4,00:07:52,1,True,24,18,6,26,10,1
4,00:07:32,2,True,24,18,6,33,3,1
4,00:04:02,1,False,18,24,-6,4,10,1
4,00:02:56,1,False,18,24,-6,19,10,1
4,00:02:40,2,False,18,24,-6,22,7,1
4,00:02:28,1,False,18,24,-6,35,10,1
4,00:02:10,1,False,18,24,-6,45,10,1
4,00:01:52,1,True,24,18,6,51,10,1
1,00:14:53,1,False,0,0,0,32,10,1
1,00:13:34,1,True,0,0,0,45,10,1
1,00:13:12,1,False,0,0,0,52,10,1
1,00:11:44,1,False,0,0,0,29,10,1
1,00:09:45,2,True,7,0,7,27,10,1
1,00:09:00,1,True,7,0,7,38,10,1
1,00:07:18,1,False,0,7,-7,40,10,1
1,00:06:23,2,False,0,7,-7,35,5,1
1,00:04:54,1,True,10,0,10,31,10,1
1,00:04:10,2,True,10,0,10,48,10,1
1,00:03:19,1,False,0,10,-10,40,10,1
1,00:01:54,1,False,0,10,-10,29,10,1
1,00:00:00,2,False,0,10,-10,10,8,1
2,00:13:14,1,True,17,0,17,2,12,1
2,00:12:27,2,True,17,0,17,37,10,1
2,00:10:48,2,False,0,17,-17,41,3,1
2,00:08:27,1,False,0,17,-17,25,10,1
2,00:05:40,1,True,24,0,24,23,10,1
2,00:05:21,2,True,24,0,24,23,10,1
2,00:03:58,1,True,24,0,24,50,10,1
2,00:02:48,1,True,24,0,24,23,10,1
2,00:01:35,1,True,24,3,21,40,10,1
2,00:01:15,1,True,24,3,21,27,10,1
2,00:00:45,1,True,24,3,21,13,10,1
3,00:13:39,2,False,6,24,-18,54,6,1
3,00:11:07,1,True,24,7,17,47,10,1
3,00:09:45,1,False,7,24,-17,52,10,1
3,00:07:31,1,False,7,24,-17,16,10,1
3,00:07:23,2,False,7,24,-17,23,3,1
3,00:03:55,2,False,7,24,-17,35,15,1
3,00:03:16,1,True,24,7,17,24,10,1
3,00:01:08,1,False,7,24,-17,22,10,1
4,00:15:00,2,False,7,24,-17,10,10,1
4,00:13:56,2,False,7,27,-20,40,10,1
4,00:12:53,1,True,27,7,20,9,10,1
4,00:10:44,2,True,27,14,13,42,7,1
4,00:09:11,1,False,14,27,-13,26,10,1
4,00:05:36,1,True,27,14,13,40,10,1
4,00:04:38,2,True,27,14,13,55,6,1
4,00:04:00,1,False,14,27,-13,33,10,1
4,00:02:41,2,False,14,27,-13,15,10,1
4,00:02:03,1,False,14,34,-20,27,10,1
4,00:01:57,2,False,14,34,-20,34,3,1
4,00:00:33,2,False,14,37,-23,37,8,1
1,00:14:31,2,True,0,0,0,27,10,1
1,00:12:13,1,False,0,3,-3,35,10,1
1,00:11:42,2,False,0,3,-3,44,1,1
1,00:08:06,1,False,3,3,0,26,10,1
1,00:06:13,2,True,3,3,0,28,8,1
1,00:04:45,2,False,3,3,0,33,4,1
1,00:03:51,1,True,3,3,0,34,10,1
1,00:02:24,1,False,3,3,0,33,10,1
1,00:01:10,1,True,3,3,0,54,10,1
1,00:00:49,1,True,3,3,0,42,10,1
2,00:15:00,2,True,3,3,0,38,19,1
2,00:13:40,2,True,3,6,-3,37,8,1
2,00:12:27,1,False,6,3,3,35,10,1
2,00:11:38,2,False,6,3,3,33,8,1
2,00:07:47,2,True,10,6,4,32,10,1
2,00:05:45,2,False,6,10,-4,36,14,1
2,00:04:50,2,True,10,6,4,38,5,1
2,00:02:29,2,True,10,9,1,35,10,1
2,00:01:52,1,False,9,10,-1,41,10,1
2,00:01:43,1,True,10,9,1,35,10,1
2,00:01:36,2,True,10,9,1,28,3,1
2,00:01:07,2,True,10,9,1,23,10,1
3,00:13:11,1,False,12,10,2,50,10,1
3,00:10:47,1,True,10,15,-5,35,10,1
3,00:09:12,2,False,15,10,5,50,3,1
3,00:08:55,1,False,15,10,5,45,10,1
3,00:06:59,2,False,15,10,5,21,17,1
3,00:06:14,2,False,15,17,-2,38,8,1
3,00:05:30,1,False,15,17,-2,50,10,1
3,00:04:59,1,True,17,15,2,49,10,1
3,00:02:18,2,True,17,22,-5,34,8,1
3,00:01:33,1,False,22,17,5,35,10,1
3,00:00:55,1,False,22,17,5,13,10,1
3,00:00:30,1,False,22,24,-2,34,10,1
4,00:12:35,1,False,22,24,-2,47,10,1
4,00:10:43,1,False,22,27,-5,35,10,1
4,00:10:08,1,False,22,27,-5,51,10,1
4,00:09:48,1,True,27,22,5,45,10,1
4,00:07:24,2,True,27,29,-2,49,10,1
4,00:07:05,1,False,29,27,2,37,10,1
4,00:05:31,2,False,29,27,2,25,10,1
4,00:04:53,1,False,29,27,2,49,10,1
1,00:14:54,1,False,0,0,0,35,10,1
1,00:13:37,2,True,0,0,0,49,10,1
1,00:11:32,1,True,0,0,0,14,10,1
1,00:08:45,2,False,0,0,0,37,14,1
1,00:04:28,1,True,0,0,0,37,10,1
1,00:03:50,2,True,0,0,0,27,12,1
1,00:01:33,1,False,3,0,3,17,10,1
2,00:14:06,2,True,0,3,-3,18,19,1
2,00:13:25,1,False,3,0,3,44,10,1
2,00:11:10,1,False,3,3,0,51,10,1
2,00:09:43,2,True,3,3,0,29,5,1
2,00:04:07,1,True,3,13,-10,35,10,1
2,00:03:00,1,True,3,13,-10,47,10,1
2,00:01:26,1,True,3,20,-17,13,10,1
2,00:01:00,1,True,3,20,-17,24,10,1
2,00:00:50,1,True,3,20,-17,39,10,1
2,00:00:41,1,False,20,3,17,54,10,1
2,00:00:36,2,False,20,3,17,52,8,1
2,00:00:24,1,False,20,3,17,8,8,1
2,00:00:03,2,False,20,3,17,7,7,1
3,00:13:36,2,True,10,20,-10,34,10,1
3,00:10:11,1,True,10,20,-10,49,15,1
3,00:08:30,2,False,20,10,10,13,10,1
3,00:06:46,2,False,20,10,10,27,8,1
3,00:06:19,1,False,20,10,10,38,10,1
3,00:03:49,2,True,10,20,-10,35,4,1
3,00:00:01,1,True,10,20,-10,53,10,1
4,00:14:37,2,True,10,20,-10,37,10,1
4,00:12:38,1,True,10,23,-13,35,10,1
4,00:11:30,1,True,10,23,-13,47,10,1
4,00:07:07,2,False,23,13,10,44,4,1
4,00:04:10,2,True,13,23,-10,52,26,1
4,00:03:00,1,True,13,24,-11,46,10,1
4,00:02:36,1,False,24,13,11,34,10,1
4,00:00:39,2,True,13,27,-14,35,10,1
1,00:13:47,2,False,0,0,0,46,5,1
1,00:12:45,1,False,0,0,0,7,7,1
1,00:11:33,1,False,0,3,-3,46,10,1
1,00:09:03,1,True,3,3,0,34,10,1
1,00:05:46,2,False,3,3,0,49,6,1
1,00:04:56,2,True,3,3,0,47,7,1
1,00:04:09,1,True,3,3,0,6,10,1
1,00:03:37,1,True,3,3,0,25,10,1
1,00:02:01,1,True,3,3,0,31,10,1
1,00:01:03,2,True,3,3,0,26,5,1
1,00:00:46,1,True,3,10,-7,31,10,1
2,00:14:00,2,False,10,3,7,48,11,1
2,00:13:29,1,True,3,10,-7,48,10,1
2,00:11:59,1,True,3,10,-7,1,1,1
2,00:11:04,2,True,3,17,-14,30,9,1
2,00:07:00,2,False,17,3,14,50,10,1
2,00:05:14,1,True,3,17,-14,28,10,1
2,00:03:29,1,True,3,20,-17,35,10,1
2,00:03:02,2,True,3,20,-17,42,3,1
2,00:01:38,1,False,20,3,17,19,10,1
2,00:00:55,2,False,20,3,17,34,6,1
2,00:00:22,2,False,20,3,17,55,10,1
3,00:14:33,2,True,3,23,-20,44,10,1
3,00:13:34,1,True,3,23,-20,54,10,1
3,00:12:58,2,True,3,23,-20,52,8,1
3,00:11:58,1,True,3,23,-20,36,10,1
3,00:11:23,2,True,3,23,-20,42,4,1
3,00:10:40,1,False,23,3,20,37,10,1
3,00:09:05,1,False,23,10,13,36,10,1
3,00:08:24,1,False,23,10,13,47,10,1
3,00:05:36,1,False,23,10,13,29,10,1
3,00:03:20,2,True,10,23,-13,47,3,1
3,00:02:40,1,True,10,23,-13,51,10,1
3,00:00:56,2,False,23,10,13,15,10,1
4,00:14:21,1,True,10,23,-13,16,10,1
4,00:13:04,2,True,10,23,-13,33,10,1
4,00:11:10,2,True,10,23,-13,43,11,1
4,00:09:58,2,False,23,10,13,27,10,1
4,00:09:39,1,True,17,23,-6,49,10,1
4,00:09:00,2,True,17,23,-6,52,7,1
4,00:07:23,1,False,23,17,6,14,10,1
4,00:05:42,2,True,17,23,-6,35,10,1
4,00:04:42,2,True,17,23,-6,50,10,1
4,00:04:17,1,False,23,17,6,47,10,1
4,00:02:47,1,False,23,17,6,26,10,1
4,00:01:06,1,True,20,26,-6,35,10,1
4,00:01:01,2,True,20,26,-6,43,2,1
4,00:00:36,2,True,20,26,-6,54,10,1
1,00:14:39,1,False,0,0,0,37,10,1
1,00:12:02,2,False,0,0,0,32,5,1
1,00:10:13,1,True,0,0,0,25,10,1
1,00:08:43,1,True,0,0,0,11,10,1
1,00:05:03,2,False,7,0,7,42,5,1
1,00:03:51,2,False,7,0,7,27,9,1
2,00:15:00,2,False,7,10,-3,8,8,1
2,00:11:52,2,False,7,13,-6,20,10,1
2,00:09:58,2,False,7,20,-13,45,10,1
2,00:07:09,2,False,7,27,-20,31,9,1
2,00:00:56,1,False,7,28,-21,53,10,1
3,00:14:46,1,False,7,31,-24,32,10,1
3,00:13:13,2,True,31,7,24,38,8,1
3,00:09:31,2,True,31,7,24,29,10,1
3,00:08:31,1,True,31,7,24,7,7,1
3,00:03:13,2,True,31,14,17,32,10,1
3,00:02:45,1,True,31,14,17,45,10,1
3,00:00:01,1,False,14,31,-17,26,10,1
4,00:09:26,1,False,14,32,-18,32,10,1
4,00:06:57,2,True,32,14,18,46,8,1
4,00:05:34,2,True,32,14,18,45,20,1
4,00:03:16,2,False,14,32,-18,10,15,1
4,00:02:37,2,False,14,32,-18,27,10,1
1,00:14:09,2,False,0,0,0,35,15,1
1,00:09:56,1,False,0,0,0,12,10,1
1,00:09:38,1,False,0,0,0,23,10,1
1,00:09:14,2,False,0,0,0,28,5,1
1,00:08:00,2,True,0,0,0,34,10,1
1,00:06:56,1,True,0,0,0,46,10,1
1,00:03:15,2,False,0,7,-7,2,2,1
1,00:02:58,1,False,0,14,-14,39,10,1
2,00:15:00,1,False,0,14,-14,38,10,1
2,00:14:23,2,False,0,14,-14,51,10,1
2,00:12:26,2,True,14,3,11,40,5,1
2,00:11:16,2,True,14,3,11,49,10,1
2,00:07:31,1,True,21,3,18,13,10,1
2,00:07:12,1,True,21,3,18,28,10,1
2,00:06:37,2,True,21,3,18,33,5,1
2,00:04:44,1,False,3,21,-18,35,10,1
2,00:02:34,2,False,3,24,-21,35,10,1
2,00:02:14,1,True,24,3,21,38,10,1
2,00:02:07,2,True,24,3,21,43,5,1
2,00:01:23,2,True,24,3,21,52,10,1
2,00:00:32,1,False,3,24,-21,26,10,1
2,00:00:26,1,False,3,31,-28,50,10,1
3,00:14:11,2,True,31,3,28,47,13,1
3,00:07:46,1,False,3,34,-31,36,10,1
3,00:04:37,2,True,34,3,31,26,10,1
3,00:02:08,1,False,3,34,-31,30,10,1
4,00:13:56,1,False,5,34,-29,45,10,1
4,00:12:21,2,False,5,34,-29,55,18,1
4,00:10:59,1,True,34,5,29,46,10,1
4,00:09:42,1,False,5,34,-29,12,10,1
4,00:08:25,2,True,36,5,31,37,8,1
4,00:07:47,1,True,36,5,31,48,10,1
4,00:05:30,1,False,5,36,-31,37,10,1
4,00:05:14,2,False,5,36,-31,40,7,1
4,00:03:51,1,False,5,36,-31,48,10,1
4,00:03:00,1,True,36,5,31,46,10,1
4,00:02:43,1,True,36,5,31,36,10,1
4,00:01:03,1,True,36,5,31,47,10,1
1,00:14:55,1,True,0,0,0,30,10,1
1,00:13:37,2,True,0,0,0,45,10,1
1,00:12:50,1,False,0,0,0,19,10,1
1,00:11:20,1,True,0,0,0,11,10,1
1,00:11:06,1,True,0,0,0,22,10,1
1,00:10:10,1,True,0,0,0,47,10,1
1,00:09:23,1,False,0,0,0,31,10,1
1,00:07:34,1,True,7,0,7,49,10,1
1,00:07:11,2,True,7,0,7,55,4,1
1,00:06:16,2,False,0,7,-7,38,10,1
1,00:05:02,1,False,0,10,-10,35,10,1
1,00:00:59,2,True,10,0,10,5,5,1
1,00:00:13,1,False,7,10,-3,54,10,1
2,00:14:11,1,False,7,10,-3,40,10,1
2,00:13:57,2,False,7,10,-3,38,8,1
2,00:13:08,1,False,7,13,-6,21,10,1
2,00:12:43,1,False,7,13,-6,32,10,1
2,00:08:42,1,True,13,10,3,35,10,1
2,00:07:53,1,False,10,13,-3,50,10,1
2,00:06:34,1,False,10,13,-3,37,10,1
2,00:04:41,1,False,10,13,-3,4,4,1
2,00:04:15,1,False,10,21,-11,35,10,1
2,00:02:28,1,True,21,10,11,30,10,1
2,00:01:36,2,True,21,10,11,36,14,1
2,00:00:27,2,True,21,10,11,7,7,1
2,00:00:16,1,True,21,17,4,54,10,1
2,00:00:09,2,False,17,21,-4,50,4,1
3,00:14:52,1,False,17,21,-4,49,10,1
3,00:13:25,1,True,21,17,4,35,10,1
3,00:12:33,1,False,17,21,-4,43,10,1
3,00:11:58,1,False,17,21,-4,20,10,1
3,00:10:59,1,False,17,21,-4,4,10,1
3,00:09:19,1,True,21,17,4,39,10,1
3,00:07:50,1,True,21,17,4,52,10,1
3,00:07:14,2,False,17,21,-4,52,4,1
3,00:06:49,1,False,17,21,-4,41,10,1
3,00:04:32,1,True,24,17,7,52,10,1
3,00:04:01,2,False,17,24,-7,52,4,1
3,00:02:15,1,False,17,27,-10,35,10,1
3,00:00:01,1,True,27,20,7,35,10,1
4,00:15:00,2,True,27,20,7,36,9,1
4,00:13:46,2,True,27,20,7,47,11,1
4,00:12:24,2,False,20,27,-7,10,7,1
4,00:11:15,2,False,20,27,-7,22,6,1
4,00:10:03,1,False,20,27,-7,43,10,1
4,00:09:23,1,True,27,20,7,46,10,1
4,00:07:05,1,True,27,21,6,35,10,1
4,00:06:44,1,True,27,21,6,50,10,1
4,00:05:49,2,False,21,27,-6,50,10,1
4,00:02:44,2,True,29,21,8,41,9,1
4,00:02:38,1,False,21,36,-15,25,10,1
4,00:02:30,1,False,21,36,-15,36,10,1
1,00:14:23,1,False,0,0,0,39,10,1
1,00:13:14,1,False,7,0,7,36,10,1
1,00:10:29,1,False,7,0,7,45,10,1
1,00:10:14,1,True,0,7,-7,45,10,1
1,00:09:31,2,True,0,7,-7,30,10,1
1,00:05:45,2,False,10,0,10,20,10,1
1,00:04:29,1,True,0,10,-10,45,10,1
1,00:02:46,1,False,10,0,10,47,15,1
1,00:01:26,2,False,10,1,9,35,10,1
2,00:14:38,1,False,12,1,11,43,10,1
2,00:12:47,2,True,1,12,-11,29,10,1
2,00:10:22,2,True,1,12,-11,33,6,1
2,00:08:12,1,False,12,1,11,48,10,1
2,00:05:42,1,False,12,1,11,38,10,1
2,00:03:00,2,False,12,8,4,52,10,1
2,00:02:27,2,True,8,12,-4,12,9,1
2,00:01:29,1,True,8,15,-7,50,10,1
2,00:01:03,1,False,15,8,7,40,10,1
2,00:00:27,1,False,15,8,7,8,10,1
3,00:13:24,2,False,15,15,0,43,11,1
3,00:10:55,2,True,22,15,7,46,14,1
3,00:08:59,1,True,22,15,7,53,10,1
3,00:06:15,2,False,15,22,-7,2,2,1
3,00:05:59,1,False,15,29,-14,15,10,1
3,00:05:26,2,False,15,29,-14,21,4,1
3,00:02:44,2,False,15,29,-14,29,17,1
4,00:10:43,2,False,15,29,-14,22,8,1
4,00:08:22,2,False,15,36,-21,41,15,1
4,00:07:40,1,True,36,15,21,39,10,1
4,00:07:24,2,True,36,15,21,31,2,1
4,00:06:32,2,True,36,15,21,25,10,1
4,00:05:28,1,True,36,15,21,14,10,1
4,00:03:23,2,True,36,22,14,46,7,1
4,00:02:01,2,False,22,36,-14,3,3,1
4,00:01:52,1,False,22,43,-21,41,10,1
4,00:01:32,3,False,22,43,-21,46,5,1
4,00:01:20,2,True,43,22,21,30,10,1
4,00:01:15,3,True,43,22,21,23,3,1
1,00:14:31,2,True,0,0,0,39,10,1
1,00:13:32,2,False,0,0,0,36,10,1
1,00:10:53,1,False,0,0,0,40,10,1
1,00:08:42,2,True,0,0,0,14,9,1
1,00:08:17,1,True,0,7,-7,17,10,1
1,00:07:50,1,True,0,7,-7,31,10,1
1,00:02:43,1,False,14,0,14,34,10,1
2,00:14:45,2,True,0,14,-14,54,10,1
2,00:14:17,1,True,0,14,-14,41,10,1
2,00:13:40,2,True,0,14,-14,39,9,1
2,00:12:16,1,True,0,14,-14,15,10,1
2,00:09:40,2,True,0,16,-16,51,4,1
2,00:08:49,2,True,0,16,-16,30,8,1
2,00:05:14,1,False,16,0,16,22,10,1
2,00:04:15,2,False,16,0,16,38,10,1
2,00:02:08,1,False,16,0,16,50,5,1
2,00:01:47,1,False,16,0,16,40,10,1
2,00:01:38,1,False,16,0,16,24,10,1
2,00:01:02,2,False,16,3,13,40,5,1
2,00:00:28,2,True,3,16,-13,54,10,1
3,00:13:25,1,True,3,16,-13,38,10,1
3,00:12:57,1,False,16,3,13,50,10,1
3,00:09:11,1,False,16,3,13,12,10,1
3,00:08:40,1,False,16,10,6,31,10,1
3,00:06:25,2,False,16,10,6,47,5,1
3,00:05:28,2,True,10,23,-13,44,9,1
3,00:02:18,2,False,23,10,13,21,11,1
4,00:15:00,1,True,10,23,-13,38,10,1
4,00:14:40,2,True,10,23,-13,45,3,1
4,00:11:23,1,False,23,17,6,23,10,1
4,00:09:51,1,False,23,17,6,40,10,1
4,00:08:52,2,False,23,17,6,25,10,1
4,00:07:10,1,True,20,23,-3,47,10,1
4,00:06:16,2,True,20,23,-3,45,8,1
4,00:03:37,1,False,23,27,-4,48,10,1
4,00:03:01,1,True,27,23,4,46,10,1
4,00:02:11,2,True,27,24,3,38,7,1
1,00:14:54,1,True,0,0,0,35,10,1
1,00:13:35,2,True,0,0,0,39,7,1
1,00:12:44,2,True,0,0,0,24,15,1
1,00:09:56,1,False,3,0,3,33,10,1
1,00:08:08,1,False,3,0,3,36,10,1
1,00:07:04,1,True,0,3,-3,33,10,1
1,00:06:15,1,False,3,0,3,29,10,1
1,00:04:07,2,False,3,0,3,13,7,1
1,00:02:40,2,False,3,3,0,35,10,1
2,00:14:24,1,True,3,3,0,46,10,1
2,00:13:38,2,False,3,3,0,52,10,1
2,00:12:16,1,False,3,3,0,18,10,1
2,00:11:24,2,False,3,3,0,11,3,1
2,00:11:05,1,False,3,10,-7,37,10,1
2,00:07:29,1,True,10,6,4,35,10,1
2,00:05:58,1,False,6,10,-4,50,10,1
2,00:04:07,2,True,10,6,4,21,5,1
2,00:02:20,1,True,10,6,4,53,10,1
2,00:01:59,2,True,10,6,4,38,7,1
2,00:01:47,1,True,10,6,4,23,10,1
2,00:01:01,2,True,10,9,1,12,10,1
3,00:11:39,1,True,13,15,-2,10,10,1
3,00:11:12,1,True,13,15,-2,21,10,1
3,00:09:56,1,True,13,15,-2,31,10,1
3,00:09:19,2,True,13,15,-2,35,6,1
3,00:08:45,1,True,13,15,-2,46,10,1
3,00:07:10,1,False,15,19,-4,48,10,1
3,00:05:27,2,False,15,19,-4,53,17,1
3,00:04:25,1,True,19,15,4,39,10,1
4,00:13:34,2,False,18,19,-1,16,15,1
4,00:12:25,2,True,19,18,1,38,10,1
4,00:11:45,1,False,18,19,-1,42,10,1
4,00:08:28,1,True,22,18,4,27,10,1
4,00:07:40,1,False,18,22,-4,32,10,1
4,00:06:49,1,False,18,22,-4,47,10,1
4,00:05:05,1,True,22,18,4,28,10,1
4,00:02:46,1,False,25,22,3,43,10,1
4,00:02:32,2,False,25,22,3,40,7,1
1,00:10:14,1,False,0,7,-7,43,10,1
1,00:07:30,2,False,0,7,-7,34,10,1
1,00:07:09,1,False,0,7,-7,23,10,1
1,00:04:40,1,True,7,0,7,24,10,1
1,00:04:20,1,False,0,7,-7,52,10,1
1,00:04:02,2,False,0,7,-7,47,5,1
1,00:03:35,3,False,0,7,-7,43,1,1
1,00:00:07,2,True,10,0,10,37,7,1
2,00:12:53,2,False,0,10,-10,39,6,1
2,00:11:45,2,True,10,7,3,27,3,1
2,00:11:12,1,True,10,7,3,18,10,1
2,00:09:41,2,True,10,7,3,3,3,1
2,00:08:54,2,True,10,14,-4,32,12,1
2,00:08:17,1,False,14,10,4,38,10,1
2,00:04:13,2,True,11,14,-3,37,0,1
2,00:01:39,1,False,15,11,4,42,10,1
3,00:14:51,1,False,15,11,4,20,10,1
3,00:11:31,2,True,11,15,-4,46,10,1
3,00:09:15,1,False,15,11,4,24,10,1
3,00:07:42,2,False,15,11,4,11,10,1
3,00:06:53,2,False,15,17,-2,20,8,1
3,00:03:45,1,False,15,17,-2,17,10,1
3,00:00:33,2,False,15,17,-2,6,10,1
4,00:12:48,1,True,19,15,4,34,10,1
4,00:07:15,1,True,20,15,5,6,10,1
4,00:07:06,2,True,20,15,5,11,5,1
4,00:02:47,2,True,20,15,5,37,7,1
4,00:02:40,1,True,20,23,-3,43,10,1
1,00:11:59,1,True,0,0,0,50,10,1
1,00:11:20,2,True,0,0,0,44,4,1
1,00:08:40,1,False,3,0,3,38,10,1
1,00:05:38,1,False,3,0,3,39,10,1
1,00:04:15,2,False,3,0,3,23,8,1
1,00:02:51,2,False,3,0,3,10,5,1
1,00:01:01,1,False,3,7,-4,47,15,1
1,00:00:36,2,True,7,3,4,54,6,1
2,00:10:59,1,False,4,7,-3,50,10,1
2,00:08:29,1,False,4,10,-6,35,10,1
2,00:04:25,2,True,10,4,6,46,6,1
2,00:03:40,1,False,4,10,-6,37,10,1
2,00:02:38,1,False,4,17,-13,45,10,1
2,00:01:51,2,True,17,4,13,24,7,1
3,00:13:10,2,False,4,17,-13,40,10,1
3,00:10:15,1,False,4,17,-13,41,10,1
3,00:05:23,1,True,17,4,13,51,10,1
3,00:05:04,1,True,17,4,13,35,10,1
3,00:02:36,2,True,17,7,10,45,5,1
3,00:01:32,2,True,17,7,10,52,10,1
3,00:00:01,1,False,7,17,-10,30,15,1
4,00:14:07,2,True,17,7,10,44,10,1
4,00:10:39,1,False,7,20,-13,25,20,1
4,00:09:22,1,True,20,7,13,41,10,1
4,00:06:19,1,False,7,23,-16,35,10,1
1,00:13:40,1,False,0,0,0,38,10,1
1,00:13:05,1,False,0,0,0,51,10,1
1,00:11:54,1,True,0,0,0,53,10,1
1,00:10:14,2,False,0,0,0,8,10,1
1,00:09:34,1,False,0,0,0,34,10,1
1,00:07:26,2,True,3,0,3,37,10,1
1,00:04:13,2,False,0,3,-3,36,17,1
1,00:02:51,1,True,3,0,3,30,10,1
1,00:02:13,2,True,3,0,3,24,4,1
1,00:00:35,2,True,3,3,0,38,9,1
2,00:13:50,2,False,3,3,0,33,10,1
2,00:12:47,2,False,3,3,0,20,16,1
2,00:11:53,1,False,3,6,-3,37,10,1
2,00:09:50,1,True,6,3,3,44,10,1
2,00:07:12,1,True,6,3,3,7,7,1
2,00:06:08,2,True,6,3,3,8,8,1
2,00:05:52,1,True,6,10,-4,25,10,1
2,00:02:58,2,True,6,10,-4,1,10,1
2,00:02:05,1,True,6,10,-4,53,10,1
2,00:01:22,1,True,6,10,-4,14,10,1
2,00:00:23,2,True,6,17,-11,40,10,1
3,00:14:24,1,True,6,17,-11,33,10,1
3,00:13:20,2,True,6,17,-11,17,12,1
3,00:11:01,1,False,20,6,14,28,10,1
3,00:09:18,1,True,6,27,-21,24,10,1
3,00:06:44,1,False,27,6,21,26,10,1
3,00:05:28,1,True,6,27,-21,45,10,1
3,00:04:31,1,False,27,6,21,53,10,1
3,00:03:50,2,False,27,6,21,50,7,1
3,00:01:57,2,False,27,6,21,48,9,1
3,00:00:31,2,True,6,27,-21,45,10,1
3,00:00:01,1,True,6,27,-21,32,10,1
4,00:15:00,1,True,6,27,-21,18,10,1
4,00:13:31,1,True,6,30,-24,35,10,1
4,00:13:03,2,True,6,30,-24,41,4,1
4,00:10:13,1,True,7,30,-23,35,10,1
4,00:09:47,2,True,7,30,-23,41,4,1
4,00:09:05,1,False,30,7,23,45,10,1
4,00:08:39,2,False,30,7,23,42,7,1
4,00:08:08,1,False,30,7,23,24,10,1
4,00:06:47,1,False,30,7,23,7,10,1
4,00:05:14,1,False,30,7,23,53,10,1
1,00:10:54,2,True,0,0,0,14,10,1
1,00:05:45,2,True,0,10,-10,32,5,1
1,00:05:17,1,True,0,10,-10,49,10,1
1,00:04:38,2,True,0,10,-10,48,11,1
1,00:03:46,2,False,10,0,10,44,3,1
1,00:02:06,2,False,10,0,10,19,13,1
2,00:14:32,2,True,3,10,-7,23,8,1
2,00:12:39,1,False,10,3,7,22,10,1
2,00:09:33,2,False,10,3,7,54,6,1
2,00:08:12,1,True,3,10,-7,15,10,1
2,00:06:19,1,False,10,3,7,33,10,1
2,00:05:43,1,False,10,3,7,19,10,1
2,00:04:05,1,False,10,3,7,5,5,1
2,00:02:16,2,True,10,13,-3,35,10,1
2,00:01:52,2,False,13,10,3,19,8,1
2,00:00:55,1,True,10,13,-3,44,20,1
2,00:00:47,2,True,10,13,-3,50,14,1
3,00:13:45,1,True,10,13,-3,45,10,1
3,00:08:00,1,False,13,13,0,35,10,1
3,00:07:38,2,False,13,13,0,40,5,1
3,00:02:25,1,False,16,13,3,28,10,1
3,00:00:29,1,True,20,16,4,33,10,1
3,00:00:00,1,True,20,16,4,12,10,1
4,00:13:54,2,True,20,23,-3,53,8,1
4,00:13:10,1,False,23,20,3,49,10,1
4,00:12:37,1,False,23,20,3,32,10,1
4,00:11:59,1,False,23,20,3,20,10,1
4,00:10:18,1,False,23,23,0,29,10,1
4,00:08:12,1,True,23,23,0,52,10,1
4,00:03:24,1,False,23,26,-3,35,10,1
4,00:02:16,2,True,26,23,3,19,4,1
4,00:01:06,1,True,26,30,-4,27,10,1
4,00:00:56,1,True,26,30,-4,38,10,1
4,00:00:44,1,True,26,30,-4,49,10,1
4,00:00:35,1,False,30,26,4,50,10,1
4,00:00:22,2,False,30,26,4,45,5,1
4,00:00:07,2,False,30,26,4,43,17,1
1,00:12:40,2,False,0,0,0,55,15,1
1,00:12:09,1,True,0,0,0,7,10,1
1,00:09:27,1,True,0,0,0,34,10,1
1,00:07:52,2,True,0,1,-1,33,12,1
1,00:05:18,1,True,0,2,-2,35,10,1
1,00:04:00,1,True,0,2,-2,45,10,1
1,00:02:43,2,True,0,2,-2,27,6,1
1,00:00:50,1,True,0,2,-2,18,10,1
2,00:15:00,2,True,0,2,-2,29,10,1
2,00:13:47,2,True,0,2,-2,19,6,1
2,00:11:55,1,True,0,2,-2,35,10,1
2,00:11:36,2,True,0,2,-2,33,12,1
2,00:08:40,2,False,2,0,2,23,6,1
2,00:06:05,1,False,2,0,2,6,10,1
2,00:04:53,2,False,2,0,2,32,10,1
2,00:04:31,1,False,2,0,2,47,10,1
2,00:03:55,2,False,2,0,2,53,4,1
2,00:02:29,1,True,0,2,-2,21,10,1
2,00:02:14,1,True,0,2,-2,41,10,1
3,00:14:54,1,True,0,2,-2,49,10,1
3,00:06:57,1,False,2,6,-4,35,10,1
3,00:04:33,1,True,6,2,4,29,10,1
3,00:04:05,1,True,6,9,-3,49,10,1
3,00:03:42,2,True,6,9,-3,55,4,1
3,00:02:23,1,False,9,6,3,48,10,1
4,00:14:11,2,True,6,9,-3,45,8,1
4,00:05:32,1,True,6,10,-4,13,10,1
4,00:04:36,1,True,6,10,-4,26,10,1
4,00:03:54,1,True,6,10,-4,36,10,1
4,00:02:54,2,True,6,10,-4,54,10,1
4,00:02:33,2,False,10,6,4,46,10,1
4,00:02:27,1,False,10,6,4,34,10,1
4,00:01:50,1,False,10,6,4,22,10,1
4,00:01:04,2,False,10,6,4,17,5,1
5,00:00:00,1,True,13,13,0,35,10,1
5,00:00:00,2,True,13,13,0,30,5,1
5,00:00:00,1,False,16,13,3,35,10,1
5,00:00:00,1,False,16,13,3,24,10,1
1,00:14:26,2,True,0,0,0,38,4,1
1,00:13:50,1,True,0,0,0,44,10,1
1,00:10:25,1,False,0,0,0,38,10,1
1,00:08:20,2,False,0,0,0,24,11,1
1,00:07:06,1,False,0,0,0,50,10,1
1,00:06:38,2,False,0,0,0,52,8,1
1,00:05:20,2,True,0,0,0,37,5,1
1,00:04:34,1,False,0,0,0,20,10,1
1,00:02:50,1,False,0,3,-3,35,10,1
1,00:00:54,1,True,3,0,3,36,10,1
1,00:00:01,1,True,3,0,3,25,10,1
2,00:13:00,1,False,7,6,1,29,10,1
2,00:10:51,1,True,6,7,-1,48,10,1
2,00:10:04,2,True,6,7,-1,46,8,1
2,00:08:33,2,True,6,7,-1,33,8,1
2,00:04:19,1,True,6,14,-8,44,10,1
2,00:03:19,1,True,6,14,-8,45,20,1
2,00:02:41,1,False,14,6,8,4,4,1
2,00:01:51,1,True,13,14,-1,46,10,1
2,00:01:45,1,True,13,14,-1,28,10,1
2,00:01:37,2,True,13,14,-1,23,5,1
2,00:01:13,1,True,13,17,-4,35,10,1
2,00:01:05,2,True,13,17,-4,36,9,1
2,00:00:17,1,False,17,13,4,48,10,1
3,00:12:34,1,True,16,17,-1,34,10,1
3,00:09:32,2,True,16,24,-8,33,8,1
3,00:08:57,1,False,24,16,8,40,10,1
3,00:07:53,1,False,24,16,8,51,10,1
3,00:04:23,2,True,16,24,-8,23,16,1
3,00:03:35,2,True,16,24,-8,42,10,1
3,00:01:03,1,True,16,25,-9,35,10,1
4,00:13:15,2,False,25,16,9,10,10,1
4,00:11:38,1,False,25,23,2,50,10,1
4,00:10:01,1,True,23,25,-2,23,10,1
4,00:06:58,2,False,25,23,2,47,5,1
4,00:00:56,2,False,25,26,-1,24,8,1
4,00:00:28,1,False,25,29,-4,35,10,1
4,00:00:19,2,False,25,29,-4,43,2,1
4,00:00:01,0,True,29,25,4,45,0,1
1,00:11:42,1,True,0,0,0,43,10,1
1,00:09:57,2,False,0,0,0,28,9,1
1,00:06:15,1,False,0,3,-3,45,10,1
1,00:05:27,1,True,3,0,3,41,10,1
1,00:04:36,1,True,3,0,3,21,10,1
1,00:02:57,2,True,3,0,3,3,3,1
1,00:02:33,1,True,3,7,-4,35,10,1
1,00:01:06,2,False,7,3,4,33,15,1
2,00:15:00,2,False,7,6,1,40,5,1
2,00:11:37,2,True,6,7,-1,35,10,1
2,00:08:48,2,True,6,7,-1,7,7,1
2,00:07:20,2,False,14,6,8,18,8,1
2,00:03:50,1,True,6,15,-9,42,10,1
2,00:02:43,2,True,6,15,-9,37,5,1
2,00:02:31,2,True,6,22,-16,35,7,1
2,00:00:55,1,False,22,6,16,48,10,1
2,00:00:44,1,True,6,22,-16,47,10,1
2,00:00:30,1,True,6,22,-16,34,10,1
3,00:12:29,2,False,22,6,16,30,10,1
3,00:10:35,1,False,22,6,16,51,10,1
3,00:09:44,2,False,22,6,16,46,5,1
3,00:09:16,1,False,22,13,9,34,10,1
3,00:08:11,1,True,13,22,-9,40,10,1
3,00:03:51,1,False,22,13,9,29,10,1
3,00:03:01,2,False,22,13,9,32,7,1
3,00:01:27,2,True,13,22,-9,34,15,1
3,00:00:34,1,False,22,13,9,28,10,1
4,00:15:00,1,False,22,13,9,40,10,1
4,00:09:48,2,True,13,22,-9,17,2,1
4,00:08:28,2,True,13,22,-9,10,7,1
4,00:02:48,2,True,13,28,-15,40,5,1
4,00:01:10,1,True,13,35,-22,30,10,1
1,00:14:24,2,True,0,0,0,35,10,1
1,00:13:46,1,True,0,0,0,24,10,1
1,00:11:20,1,True,0,3,-3,46,10,1
1,00:10:55,1,False,3,0,3,41,10,1
1,00:10:25,1,False,3,0,3,30,10,1
1,00:09:53,2,False,3,0,3,31,11,1
1,00:09:23,1,False,3,0,3,15,10,1
1,00:08:02,2,False,3,0,3,8,3,1
1,00:06:18,1,True,7,3,4,41,10,1
1,00:04:34,2,False,3,7,-4,21,9,1
1,00:03:32,1,False,3,7,-4,30,10,1
1,00:00:49,1,True,7,3,4,7,10,1
1,00:00:21,1,True,7,10,-3,28,10,1
2,00:15:00,1,False,10,7,3,42,10,1
2,00:11:51,1,True,14,10,4,28,10,1
2,00:08:02,1,True,14,10,4,43,10,1
2,00:07:31,2,True,14,10,4,50,3,1
2,00:05:39,1,True,21,10,11,41,10,1
2,00:05:18,1,False,10,21,-11,53,10,1
2,00:04:27,1,False,10,21,-11,42,10,1
2,00:03:44,1,False,10,21,-11,26,10,1
2,00:02:33,2,False,10,24,-14,35,10,1
2,00:02:25,1,False,10,24,-14,53,10,1
2,00:02:11,1,True,24,10,14,38,10,1
2,00:01:25,1,True,24,10,14,24,10,1
2,00:00:24,2,True,24,10,14,4,4,1
3,00:14:07,2,False,17,24,-7,55,10,1
3,00:13:42,1,True,24,17,7,41,10,1
3,00:13:03,2,True,24,17,7,37,6,1
3,00:12:31,1,True,24,17,7,23,10,1
3,00:10:53,2,True,24,17,7,14,11,1
3,00:10:28,1,True,24,24,0,48,10,1
3,00:09:03,1,False,24,24,0,1,11,1
3,00:08:39,1,False,24,24,0,15,10,1
3,00:07:00,1,False,24,24,0,27,10,1
3,00:05:29,1,True,24,24,0,39,10,1
3,00:04:13,1,False,24,24,0,15,10,1
3,00:03:40,1,False,24,24,0,27,10,1
3,00:03:01,2,False,24,24,0,35,2,1
3,00:02:29,1,False,24,24,0,42,10,1
4,00:15:00,1,True,24,27,-3,35,10,1
4,00:11:51,1,False,27,24,3,19,15,1
4,00:10:33,1,False,27,24,3,38,10,1
4,00:09:46,1,False,27,24,3,53,10,1
4,00:08:23,1,True,24,27,-3,32,10,1
4,00:05:33,2,False,27,24,3,43,19,1
4,00:04:26,1,True,24,27,-3,46,15,1
4,00:02:54,2,True,24,27,-3,37,9,1
1,00:14:52,1,False,0,0,0,40,10,1
1,00:14:31,2,False,0,0,0,47,3,1
1,00:12:12,1,False,0,0,0,55,10,1
1,00:11:05,1,True,0,0,0,44,10,1
1,00:06:59,2,False,3,0,3,15,9,1
1,00:06:33,1,False,3,7,-4,25,10,1
1,00:06:01,1,False,3,7,-4,38,10,1
1,00:02:18,2,True,7,3,4,25,17,1
2,00:15:00,1,False,3,7,-4,49,10,1
2,00:14:30,2,False,3,7,-4,52,13,1
2,00:14:02,1,False,3,7,-4,14,10,1
2,00:12:18,2,False,3,10,-7,28,17,1
2,00:11:17,2,False,3,10,-7,50,10,1
2,00:10:57,1,False,3,10,-7,39,10,1
2,00:09:57,2,False,3,10,-7,29,10,1
2,00:07:01,1,False,3,17,-14,8,10,1
2,00:06:01,1,False,3,17,-14,30,10,1
2,00:04:20,2,True,24,3,21,40,10,1
2,00:01:56,1,False,6,24,-18,42,10,1
2,00:01:01,2,True,31,6,25,54,5,1
2,00:00:54,1,False,6,31,-25,51,10,1
3,00:14:17,2,False,6,31,-25,24,17,1
3,00:12:29,2,True,31,6,25,52,10,1
3,00:11:24,2,False,6,31,-25,22,10,1
3,00:09:04,2,True,31,6,25,34,12,1
3,00:07:31,2,False,6,31,-25,37,10,1
3,00:04:21,1,True,31,6,25,40,10,1
3,00:03:52,2,True,31,6,25,29,10,1
3,00:01:10,1,True,31,13,18,51,10,1
4,00:14:26,2,True,31,16,15,35,10,1
4,00:12:38,1,False,16,31,-15,39,10,1
4,00:06:52,2,False,16,31,-15,34,10,1
4,00:04:09,1,False,16,38,-22,26,10,1
4,00:03:39,1,False,16,45,-29,46,10,1
4,00:02:31,2,True,45,16,29,32,10,1
4,00:02:19,2,True,45,16,29,16,10,1
1,00:14:14,2,True,0,0,0,29,10,1
1,00:12:16,1,False,0,0,0,55,10,1
1,00:10:44,1,True,0,0,0,22,10,1
1,00:08:12,2,False,0,3,-3,32,3,1
1,00:07:05,2,False,0,3,-3,54,4,1
1,00:06:24,1,True,3,0,3,49,10,1
1,00:04:50,2,True,3,0,3,18,4,1
2,00:14:26,2,False,7,3,4,27,17,1
2,00:13:50,1,False,7,3,4,54,10,1
2,00:12:37,1,True,3,7,-4,21,10,1
2,00:10:58,2,True,3,14,-11,36,8,1
2,00:10:01,2,True,3,14,-11,49,10,1
2,00:08:17,1,False,14,3,11,18,10,1
2,00:06:42,1,False,14,3,11,6,6,1
2,00:06:02,2,False,14,10,4,24,10,1
2,00:05:24,1,False,14,10,4,38,10,1
2,00:03:23,2,False,14,10,4,50,11,1
2,00:02:04,1,True,13,14,-1,44,10,1
2,00:01:50,1,True,13,14,-1,55,10,1
2,00:01:00,2,False,14,13,1,33,10,1
3,00:14:53,1,False,14,13,1,37,10,1
3,00:14:30,1,False,14,13,1,52,10,1
3,00:12:06,1,False,14,13,1,29,10,1
3,00:07:26,1,False,14,13,1,48,10,1
3,00:06:23,2,True,13,14,-1,35,10,1
3,00:04:24,1,True,13,14,-1,52,10,1
4,00:11:59,2,True,13,17,-4,41,10,1
4,00:07:00,2,True,16,17,-1,15,5,1
4,00:06:18,1,True,16,24,-8,32,15,1
4,00:04:29,1,True,16,24,-8,25,10,1
4,00:03:30,2,False,24,16,8,37,10,1
4,00:02:22,1,False,24,16,8,7,7,1
4,00:01:54,2,False,24,22,2,30,7,1
1,00:14:32,2,False,0,0,0,35,10,1
1,00:13:15,2,False,0,0,0,47,15,1
1,00:11:43,1,True,0,0,0,9,10,1
1,00:11:17,2,True,0,0,0,15,4,1
1,00:10:21,2,True,0,0,0,19,10,1
1,00:09:38,1,False,0,0,0,41,10,1
1,00:08:33,1,True,0,0,0,28,10,1
1,00:07:26,2,True,0,0,0,46,9,1
1,00:06:43,1,False,0,0,0,49,10,1
1,00:05:45,1,False,0,0,0,33,10,1
1,00:04:27,1,False,0,7,-7,48,10,1
1,00:03:12,2,True,7,0,7,35,10,1
1,00:02:26,1,True,7,3,4,35,10,1
1,00:02:14,2,True,7,3,4,39,6,1
1,00:00:45,1,True,7,3,4,46,10,1
1,00:00:01,2,True,7,3,4,51,5,1
2,00:12:42,1,True,7,3,4,46,10,1
2,00:12:25,1,False,3,7,-4,54,10,1
2,00:09:18,1,False,3,7,-4,26,10,1
2,00:06:14,2,False,3,7,-4,54,10,1
2,00:03:51,2,True,7,4,3,35,10,1
2,00:02:48,2,False,4,7,-3,44,6,1
2,00:02:32,1,True,7,4,3,28,10,1
2,00:00:57,1,False,4,7,-3,25,10,1
3,00:14:54,1,True,10,4,6,34,10,1
3,00:14:10,2,True,10,4,6,40,4,1
3,00:12:22,1,False,4,10,-6,50,10,1
3,00:08:01,2,True,10,4,6,51,6,1
3,00:06:27,2,False,4,10,-6,30,10,1
3,00:05:42,1,False,4,11,-7,35,10,1
3,00:03:39,2,True,11,4,7,38,10,1
3,00:02:39,2,True,11,4,7,44,20,1
3,00:01:05,2,False,4,11,-7,35,20,1
4,00:11:18,1,False,4,11,-7,34,10,1
4,00:10:44,2,False,4,11,-7,40,4,1
4,00:08:33,2,True,11,4,7,31,4,1
4,00:04:54,1,False,4,11,-7,44,10,1
4,00:03:45,1,True,11,4,7,45,10,1
4,00:02:43,2,True,11,4,7,23,10,1
4,00:02:01,2,False,11,11,0,52,13,1
4,00:01:20,1,True,11,11,0,18,15,1
1,00:14:32,2,False,0,0,0,33,10,1
1,00:13:20,2,True,0,0,0,35,10,1
1,00:12:18,2,False,0,0,0,30,9,1
1,00:09:30,1,True,0,0,0,25,10,1
1,00:09:08,1,True,0,0,0,35,10,1
1,00:08:25,1,True,0,0,0,52,10,1
1,00:04:21,2,True,0,7,-7,21,21,1
2,00:10:55,1,True,7,7,0,25,10,1
2,00:09:13,1,False,7,7,0,32,10,1
2,00:08:35,1,False,7,7,0,44,10,1
2,00:06:45,2,True,7,7,0,53,9,1
2,00:06:10,1,True,7,7,0,43,10,1
2,00:02:24,1,False,10,7,3,51,10,1
2,00:02:17,1,True,7,10,-3,49,10,1
2,00:01:22,1,True,7,10,-3,9,9,1
2,00:01:10,1,False,17,7,10,43,5,1
2,00:01:06,1,False,17,7,10,37,10,1
3,00:14:52,1,True,7,17,-10,25,10,1
3,00:13:10,2,True,7,17,-10,34,10,1
3,00:10:52,1,False,20,7,13,23,10,1
3,00:08:28,2,False,20,7,13,6,6,1
3,00:07:42,1,False,20,14,6,33,5,1
3,00:05:34,1,True,14,20,-6,5,10,1
3,00:05:00,1,True,14,20,-6,44,10,1
3,00:02:28,1,False,20,14,6,20,10,1
3,00:01:34,2,False,20,21,-1,32,5,1
3,00:01:10,1,False,20,21,-1,45,10,1
3,00:00:12,1,False,20,21,-1,55,10,1
4,00:10:43,1,True,21,23,-2,47,10,1
4,00:06:34,1,False,23,21,2,36,10,1
4,00:05:34,1,False,23,21,2,16,10,1
4,00:05:09,1,False,23,28,-5,29,10,1
4,00:03:20,1,True,28,23,5,26,10,1
1,00:11:13,2,True,7,0,7,39,4,1
1,00:09:15,1,False,0,7,-7,27,10,1
1,00:07:35,1,True,7,0,7,30,10,1
1,00:06:39,1,True,7,0,7,53,10,1
1,00:06:11,2,False,0,7,-7,54,7,1
1,00:04:45,2,False,0,7,-7,39,6,1
1,00:02:58,2,False,0,10,-10,34,9,1
1,00:00:01,1,False,7,10,-3,41,10,1
2,00:13:15,2,False,7,10,-3,16,6,1
2,00:11:10,2,False,7,10,-3,55,4,1
2,00:10:43,1,True,10,7,3,49,10,1
2,00:09:13,1,True,10,7,3,18,10,1
2,00:07:26,1,False,14,10,4,55,10,1
2,00:05:53,1,True,10,14,-4,33,10,1
2,00:04:12,2,True,10,14,-4,52,6,1
2,00:02:25,1,True,10,14,-4,24,10,1
2,00:00:21,1,True,10,14,-4,36,10,1
2,00:00:01,2,True,10,14,-4,49,10,1
3,00:10:19,2,True,10,14,-4,4,4,1
3,00:09:48,2,True,10,21,-11,22,11,1
3,00:07:23,1,True,10,21,-11,46,10,1
3,00:06:06,1,True,10,21,-11,2,10,1
3,00:02:08,2,True,10,21,-11,50,10,1
3,00:01:15,2,False,21,17,4,40,6,1
4,00:12:35,2,True,17,21,-4,41,7,1
4,00:08:15,1,False,21,17,4,51,10,1
4,00:06:14,1,True,17,21,-4,5,10,1
4,00:05:25,1,True,17,21,-4,17,10,1
4,00:01:12,3,True,17,21,-4,20,18,1
4,00:01:06,1,True,17,21,-4,43,10,1
4,00:00:57,2,True,17,21,-4,47,6,1
1,00:14:10,2,False,0,0,0,48,6,1
1,00:12:17,1,False,0,7,-7,20,10,1
1,00:11:01,2,False,0,7,-7,36,10,1
1,00:06:17,1,False,0,7,-7,15,10,1
1,00:03:29,2,True,7,0,7,51,10,1
1,00:02:45,1,False,0,7,-7,48,10,1
1,00:02:04,2,False,0,7,-7,44,6,1
1,00:01:14,1,False,0,7,-7,29,10,1
2,00:14:53,2,False,0,14,-14,25,15,1
2,00:11:05,1,True,14,3,11,32,15,1
2,00:10:33,1,True,14,3,11,52,10,1
2,00:06:27,1,False,3,17,-14,33,10,1
2,00:05:59,2,False,3,17,-14,37,6,1
2,00:04:21,1,True,17,4,13,35,10,1
2,00:02:22,1,False,4,17,-13,45,10,1
2,00:01:59,1,True,17,4,13,53,10,1
2,00:01:38,2,True,17,4,13,45,2,1
2,00:01:17,1,True,17,4,13,40,10,1
2,00:00:18,1,False,7,17,-10,52,10,1
2,00:00:08,2,False,7,17,-10,43,1,1
3,00:14:18,2,False,7,17,-10,33,4,1
3,00:13:46,1,False,7,17,-10,40,10,1
3,00:12:28,2,True,17,7,10,30,10,1
3,00:11:43,2,True,17,7,10,12,4,1
3,00:06:25,1,False,10,17,-7,54,10,1
3,00:05:00,2,True,17,10,7,42,10,1
3,00:03:20,2,True,17,10,7,29,13,1
3,00:02:42,2,True,17,17,0,26,10,1
4,00:15:00,1,False,17,17,0,38,10,1
4,00:13:34,1,False,17,17,0,18,10,1
4,00:10:50,1,True,17,17,0,44,10,1
4,00:09:28,1,True,17,17,0,33,10,1
4,00:06:42,1,True,17,20,-3,25,10,1
4,00:03:03,2,False,20,17,3,35,7,1
4,00:02:05,1,True,17,20,-3,50,10,1
4,00:01:34,1,False,20,20,0,35,10,1
4,00:00:50,1,True,20,20,0,36,10,1
1,00:14:56,1,True,0,0,0,22,10,1
1,00:14:38,2,True,0,0,0,27,5,1
1,00:14:11,2,True,0,0,0,33,10,1
1,00:12:21,2,False,0,0,0,32,10,1
1,00:10:07,1,True,0,0,0,39,10,1
1,00:09:20,2,True,0,0,0,35,6,1
1,00:08:31,1,True,0,3,-3,35,10,1
1,00:08:08,2,False,3,0,3,51,10,1
1,00:07:21,1,False,3,0,3,39,10,1
1,00:06:21,1,False,3,0,3,27,10,1
1,00:04:41,1,True,7,3,4,55,10,1
1,00:04:16,2,False,3,7,-4,53,8,1
1,00:02:40,1,False,3,14,-11,34,15,1
1,00:02:00,1,True,14,3,11,39,10,1
1,00:01:28,1,True,14,3,11,23,10,1
2,00:14:07,2,True,14,6,8,40,5,1
2,00:12:39,2,False,6,14,-8,52,10,1
2,00:11:16,2,False,6,14,-8,13,9,1
2,00:10:16,1,False,6,14,-8,2,2,1
2,00:07:42,1,False,6,21,-15,16,10,1
2,00:07:20,2,False,6,21,-15,19,7,1
2,00:05:00,2,True,21,6,15,42,10,1
2,00:02:57,2,False,6,21,-15,39,17,1
2,00:02:19,2,True,21,6,15,21,10,1
2,00:01:34,1,False,6,21,-15,25,10,1
2,00:01:28,1,False,6,21,-15,47,10,1
2,00:01:16,1,True,21,6,15,51,10,1
2,00:00:54,1,True,21,6,15,3,3,1
3,00:14:18,2,False,13,21,-8,40,7,1
3,00:11:25,2,False,13,21,-8,27,7,1
3,00:09:15,2,False,13,21,-8,11,9,1
3,00:07:58,2,False,13,28,-15,50,5,1
3,00:06:14,1,True,28,13,15,12,10,1
3,00:05:48,2,True,28,13,15,18,4,1
3,00:05:14,1,True,28,13,15,23,10,1
3,00:04:39,2,True,28,13,15,23,10,1
3,00:03:17,2,False,13,28,-15,47,4,1
3,00:01:15,2,False,13,35,-22,23,16,1
3,00:00:08,1,True,35,13,22,22,10,1
4,00:10:28,1,True,35,16,19,35,10,1
4,00:07:57,2,False,16,35,-19,50,5,1
4,00:04:17,2,True,35,23,12,43,6,1
4,00:03:10,2,True,35,23,12,53,10,1
4,00:02:45,1,False,23,35,-12,15,10,1
1,00:12:20,2,False,0,0,0,54,5,1
1,00:10:18,2,False,0,0,0,17,7,1
1,00:08:59,1,True,0,0,0,48,10,1
1,00:04:22,1,False,0,1,-1,45,10,1
1,00:03:52,1,True,1,0,1,37,10,1
1,00:02:16,1,False,7,1,6,47,10,1
1,00:00:01,2,False,7,4,3,51,4,1
2,00:14:49,1,True,4,7,-3,37,5,1
2,00:13:55,1,True,4,14,-10,45,10,1
2,00:13:30,2,True,4,14,-10,47,8,1
2,00:11:49,1,False,14,4,10,32,10,1
2,00:11:25,2,True,4,14,-10,39,3,1
2,00:10:33,2,False,14,4,10,47,10,1
2,00:09:55,1,True,4,14,-10,53,10,1
2,00:08:54,1,True,4,14,-10,39,10,1
2,00:07:33,1,True,4,15,-11,35,10,1
2,00:02:54,2,False,15,4,11,18,10,1
2,00:02:19,1,True,4,15,-11,46,10,1
2,00:02:10,1,False,15,4,11,45,10,1
2,00:01:15,1,False,15,7,8,25,10,1
2,00:00:54,2,False,15,7,8,36,10,1
2,00:00:49,1,True,7,15,-8,46,10,1
2,00:00:39,1,True,7,15,-8,33,10,1
2,00:00:25,2,True,7,15,-8,29,6,1
2,00:00:07,2,True,7,15,-8,5,5,1
3,00:11:04,1,True,7,23,-16,46,10,1
3,00:10:46,1,False,23,7,16,50,10,1
3,00:08:00,2,False,23,7,16,35,10,1
3,00:03:55,2,True,10,23,-13,24,15,1
3,00:00:40,2,True,10,23,-13,18,7,1
4,00:12:45,1,True,10,26,-16,45,10,1
4,00:11:34,2,True,10,26,-16,53,14,1
4,00:05:21,2,True,10,26,-16,33,10,1
4,00:04:29,2,False,26,10,16,50,10,1
4,00:02:19,2,True,10,26,-16,51,10,1
4,00:02:13,1,False,26,10,16,49,10,1
4,00:00:19,2,True,10,26,-16,33,10,1
4,00:00:13,3,True,10,26,-16,34,9,1
1,00:14:19,1,True,0,0,0,33,10,1
1,00:11:29,2,False,0,0,0,16,25,1
1,00:10:53,1,True,0,0,0,55,10,1
1,00:08:54,1,False,0,0,0,25,10,1
1,00:04:45,2,True,0,0,0,22,7,1
1,00:00:46,1,False,0,0,0,37,10,1
2,00:14:46,2,False,0,0,0,25,8,1
2,00:10:25,1,False,0,7,-7,45,10,1
2,00:07:51,2,False,0,7,-7,39,14,1
2,00:06:23,2,False,0,14,-14,45,22,1
2,00:04:44,2,True,14,1,13,37,8,1
2,00:04:01,1,False,1,14,-13,14,10,1
2,00:03:37,2,False,1,14,-13,20,4,1
2,00:01:40,2,False,1,14,-13,50,5,1
2,00:01:00,2,True,14,1,13,50,7,1
3,00:14:40,1,False,2,14,-12,28,10,1
3,00:12:42,2,True,14,2,12,20,9,1
3,00:10:35,2,False,9,14,-5,19,7,1
3,00:10:01,2,False,9,14,-5,41,7,1
3,00:07:50,2,True,14,16,-2,37,7,1
3,00:05:40,2,True,14,16,-2,54,3,1
3,00:00:01,1,False,16,14,2,43,10,1
4,00:11:20,1,False,16,14,2,28,10,1
4,00:11:00,2,False,16,14,2,29,9,1
4,00:08:32,1,False,16,14,2,30,10,1
4,00:05:03,1,False,16,14,2,29,10,1
4,00:00:59,2,True,14,16,-2,26,11,1
4,00:00:13,1,True,14,19,-5,35,10,1
1,00:12:03,2,True,0,0,0,33,14,1
1,00:10:19,1,False,0,0,0,23,10,1
1,00:09:50,1,False,0,7,-7,45,10,1
1,00:04:06,2,False,0,14,-14,52,5,1
1,00:02:57,2,False,0,14,-14,26,5,1
1,00:00:31,2,True,17,0,17,55,14,1
2,00:13:56,1,False,0,18,-18,46,10,1
2,00:12:11,2,True,18,0,18,50,9,1
2,00:11:33,1,True,18,0,18,35,10,1
2,00:10:32,2,True,18,0,18,23,10,1
2,00:09:48,1,True,18,3,15,25,10,1
2,00:08:25,2,True,18,3,15,29,16,1
2,00:07:43,1,False,3,18,-15,37,10,1
2,00:06:10,2,True,18,3,15,13,10,1
2,00:05:48,1,True,18,10,8,37,10,1
2,00:04:37,1,True,18,10,8,55,10,1
2,00:02:13,2,True,21,10,11,47,9,1
2,00:01:49,1,False,10,21,-11,34,10,1
2,00:00:27,1,False,10,21,-11,34,10,1
2,00:00:18,2,False,10,21,-11,39,4,1
2,00:00:07,1,True,21,10,11,47,10,1
3,00:14:52,1,True,21,13,8,33,10,1
3,00:14:22,2,True,21,13,8,37,6,1
3,00:13:49,1,False,13,21,-8,52,10,1
3,00:13:09,2,False,13,21,-8,50,8,1
3,00:11:35,1,False,13,21,-8,40,10,1
3,00:10:57,2,False,13,21,-8,37,7,1
3,00:10:03,1,False,13,24,-11,38,10,1
3,00:08:39,1,False,13,24,-11,4,10,1
3,00:06:58,2,False,13,24,-11,7,17,1
3,00:05:33,2,True,24,13,11,46,6,1
3,00:04:31,2,False,13,24,-11,51,10,1
3,00:02:43,1,False,13,31,-18,36,10,1
4,00:14:13,1,False,13,34,-21,30,15,1
4,00:14:06,2,False,13,34,-21,39,6,1
4,00:12:28,2,False,13,34,-21,39,10,1
4,00:10:25,2,False,13,37,-24,35,10,1
4,00:09:29,1,True,37,13,24,41,10,1
4,00:09:07,2,True,37,13,24,45,6,1
4,00:07:57,2,False,13,37,-24,54,5,1
4,00:03:33,1,False,13,37,-24,38,10,1
4,00:03:09,2,False,13,37,-24,32,4,1
1,00:14:18,2,True,0,0,0,35,9,1
1,00:13:55,1,True,0,0,0,53,10,1
1,00:12:58,1,False,0,0,0,47,10,1
1,00:11:26,2,False,0,0,0,27,7,1
1,00:11:09,1,False,0,7,-7,41,10,1
1,00:10:18,2,True,7,0,7,53,4,1
1,00:08:48,2,True,7,0,7,15,10,1
1,00:07:33,1,True,7,0,7,55,10,1
1,00:06:09,2,False,0,7,-7,34,9,1
1,00:04:07,2,False,0,7,-7,9,9,1
1,00:02:15,1,False,0,14,-14,48,10,1
2,00:14:36,2,False,0,17,-17,35,10,1
2,00:13:23,2,False,0,17,-17,45,10,1
2,00:07:25,1,False,0,17,-17,15,10,1
2,00:05:00,2,True,17,0,17,17,9,1
2,00:02:54,2,False,0,17,-17,25,3,1
2,00:02:43,1,True,24,0,24,26,10,1
2,00:02:06,1,True,24,0,24,14,10,1
2,00:01:25,1,False,7,24,-17,25,10,1
2,00:01:10,1,False,7,24,-17,40,10,1
2,00:00:15,1,True,24,7,17,42,10,1
3,00:14:45,2,False,7,24,-17,27,10,1
3,00:13:48,1,True,24,7,17,48,10,1
3,00:12:46,1,False,7,24,-17,34,10,1
3,00:10:35,1,False,7,31,-24,33,10,1
3,00:08:31,1,True,31,7,24,54,10,1
3,00:07:16,2,True,31,7,24,39,10,1
3,00:06:39,1,True,31,7,24,25,10,1
3,00:05:52,1,True,31,7,24,5,5,1
3,00:04:16,1,False,14,38,-24,15,10,1
3,00:03:50,2,False,14,38,-24,23,2,1
3,00:03:34,1,False,14,38,-24,33,10,1
3,00:02:40,1,True,38,14,24,29,10,1
3,00:01:39,1,True,38,14,24,19,10,1
3,00:00:01,2,True,38,14,24,11,7,1
4,00:12:58,2,True,38,14,24,53,5,1
4,00:12:14,3,False,14,38,-24,54,2,1
4,00:10:32,2,False,14,38,-24,25,12,1
4,00:08:10,2,False,14,38,-24,7,6,1
4,00:07:47,1,False,14,45,-31,13,10,1
4,00:07:20,1,False,14,45,-31,25,10,1
4,00:04:44,2,True,45,14,31,25,10,1
4,00:02:58,2,False,21,45,-24,37,5,1
1,00:12:29,2,False,0,1,-1,35,10,1
1,00:08:35,2,True,1,0,1,31,18,1
1,00:07:41,1,True,1,0,1,1,10,1
1,00:07:07,2,True,1,0,1,6,5,1
1,00:04:51,2,True,1,0,1,35,9,1
1,00:03:42,2,False,0,1,-1,39,10,1
1,00:01:20,2,False,0,4,-4,51,10,1
1,00:00:00,1,True,4,0,4,8,10,1
2,00:12:12,1,False,0,11,-11,28,10,1
2,00:11:19,2,False,0,11,-11,28,22,1
2,00:10:16,1,True,11,0,11,50,10,1
2,00:09:41,2,True,11,0,11,52,8,1
2,00:05:35,1,False,0,11,-11,23,10,1
2,00:02:55,1,False,0,11,-11,55,10,1
2,00:02:44,1,True,11,0,11,43,10,1
3,00:14:53,1,True,11,0,11,53,10,1
3,00:13:29,2,False,0,11,-11,45,8,1
3,00:10:19,2,False,0,14,-14,35,10,1
3,00:08:39,1,True,14,0,14,40,10,1
3,00:07:32,1,False,0,14,-14,37,10,1
3,00:06:15,1,True,14,0,14,24,10,1
3,00:03:55,2,False,0,15,-15,37,8,1
3,00:02:54,2,False,0,15,-15,45,10,1
3,00:00:14,1,True,15,1,14,45,10,1
4,00:12:38,2,False,1,22,-21,27,10,1
4,00:10:59,1,True,22,1,21,14,10,1
4,00:10:02,1,False,1,22,-21,32,10,1
4,00:07:48,2,False,1,22,-21,16,5,1
4,00:01:09,1,False,1,29,-28,15,10,1
4,00:01:04,2,False,1,29,-28,20,5,1
4,00:00:19,2,True,29,1,28,24,10,1
1,00:14:53,1,True,0,0,0,38,10,1
1,00:14:20,1,True,0,0,0,51,10,1
1,00:13:11,2,True,0,0,0,55,6,1
1,00:12:36,1,False,0,7,-7,32,10,1
1,00:11:44,1,False,0,7,-7,45,10,1
1,00:11:01,1,True,7,0,7,47,10,1
1,00:07:25,2,True,7,0,7,24,10,1
1,00:06:17,1,True,7,0,7,9,9,1
1,00:03:14,2,False,7,7,0,43,16,1
1,00:01:00,2,False,7,7,0,3,3,1
1,00:00:37,1,False,7,14,-7,33,10,1
1,00:00:01,1,False,7,14,-7,47,10,1
2,00:14:04,1,True,14,7,7,27,10,1
2,00:09:44,2,True,14,10,4,53,5,1
2,00:08:28,2,True,14,10,4,34,16,1
2,00:07:23,1,True,14,13,1,28,10,1
2,00:06:04,1,False,13,14,-1,33,10,1
2,00:05:26,2,False,13,14,-1,33,10,1
2,00:02:43,2,False,13,14,-1,40,10,1
2,00:02:19,1,False,13,14,-1,22,10,1
2,00:01:05,2,False,13,14,-1,16,16,1
3,00:12:08,1,True,17,13,4,47,10,1
3,00:10:24,2,False,13,17,-4,33,6,1
3,00:09:53,1,False,13,17,-4,40,10,1
3,00:08:06,2,False,13,17,-4,33,8,1
3,00:07:32,1,False,13,17,-4,24,10,1
3,00:03:52,1,True,17,13,4,40,10,1
3,00:02:25,3,True,17,13,4,32,2,1
3,00:01:03,2,True,17,13,4,24,5,1
3,00:00:00,2,True,17,13,4,17,10,1
4,00:12:18,1,False,20,17,3,36,10,1
4,00:11:33,1,False,20,17,3,47,10,1
4,00:10:43,1,True,17,20,-3,52,15,1
4,00:09:28,1,True,17,20,-3,35,10,1
4,00:05:40,1,True,17,27,-10,36,10,1
4,00:05:08,2,True,17,27,-10,43,3,1
4,00:04:12,2,False,27,17,10,44,8,1
4,00:03:21,1,False,27,20,7,35,10,1
4,00:02:17,1,True,20,27,-7,38,10,1
1,00:14:23,1,True,0,0,0,53,10,1
1,00:13:01,2,False,0,0,0,44,10,1
1,00:12:03,2,False,0,0,0,33,11,1
1,00:11:12,1,False,0,3,-3,35,10,1
1,00:09:53,1,True,3,0,3,39,10,1
1,00:06:54,2,False,0,3,-3,9,1,1
1,00:06:18,1,False,0,3,-3,2,2,1
1,00:00:01,2,False,0,12,-12,41,4,1
2,00:15:00,1,False,0,12,-12,33,10,1
2,00:13:39,1,False,0,19,-19,33,10,1
2,00:11:29,2,False,0,19,-19,3,10,1
2,00:07:35,2,False,0,21,-21,47,10,1
2,00:05:09,1,False,1,21,-20,53,20,1
2,00:01:40,1,False,1,21,-20,19,10,1
2,00:00:48,2,False,1,24,-23,40,5,1
2,00:00:32,2,False,1,24,-23,51,10,1
3,00:14:52,1,False,1,24,-23,31,10,1
3,00:08:36,1,False,1,24,-23,10,10,1
3,00:04:04,2,False,3,31,-28,35,10,1
3,00:02:06,2,False,3,31,-28,43,12,1
4,00:14:10,2,True,31,3,28,28,10,1
4,00:10:51,1,False,3,31,-28,45,10,1
4,00:10:13,1,True,31,3,28,49,10,1
4,00:09:46,1,True,31,3,28,34,10,1
4,00:06:58,1,True,31,10,21,5,10,1
4,00:02:09,2,False,10,31,-21,44,17,1
4,00:00:45,1,False,10,31,-21,35,10,1
4,00:00:37,1,False,10,31,-21,48,10,1
4,00:00:26,1,True,31,10,21,52,10,1
1,00:13:16,2,False,0,0,0,48,10,1
1,00:08:17,1,True,0,7,-7,26,10,1
1,00:07:54,1,True,0,14,-14,33,10,1
1,00:07:20,1,True,0,14,-14,48,10,1
1,00:03:46,1,False,14,7,7,15,10,1
1,00:03:25,2,False,14,7,7,22,3,1
1,00:02:01,2,True,7,14,-7,44,5,1
1,00:01:35,1,True,7,14,-7,29,10,1
1,00:00:00,2,True,7,14,-7,8,8,1
2,00:14:49,1,True,7,21,-14,45,10,1
2,00:14:09,1,False,21,7,14,53,10,1
2,00:12:51,1,False,21,7,14,27,10,1
2,00:11:05,1,True,7,21,-14,22,10,1
2,00:09:36,1,True,7,21,-14,48,5,1
2,00:09:00,1,False,21,7,14,48,10,1
2,00:08:19,1,False,21,7,14,33,10,1
2,00:07:30,2,False,21,7,14,25,2,1
2,00:05:20,2,False,21,14,7,42,7,1
2,00:05:00,1,False,21,14,7,53,10,1
2,00:04:18,2,False,21,14,7,54,9,1
2,00:02:40,2,True,14,21,-7,38,10,1
2,00:02:23,1,True,14,21,-7,52,10,1
2,00:00:41,1,True,14,21,-7,39,10,1
2,00:00:37,1,True,14,21,-7,53,10,1
2,00:00:28,2,False,21,14,7,51,4,1
3,00:14:15,2,False,21,17,4,36,9,1
3,00:12:59,2,True,17,21,-4,50,10,1
3,00:00:01,2,True,20,25,-5,38,7,1
4,00:14:18,1,True,20,25,-5,42,10,1
4,00:13:07,2,True,20,25,-5,27,6,1
4,00:09:46,2,False,28,26,2,44,9,1
4,00:05:24,1,True,26,28,-2,50,10,1
4,00:04:50,2,False,28,26,2,53,3,1
4,00:04:30,1,False,28,26,2,47,10,1
4,00:01:50,2,True,33,28,5,33,7,1
1,00:14:17,2,True,0,0,0,31,8,1
1,00:11:59,1,True,0,0,0,16,10,1
1,00:09:06,1,True,0,0,0,38,10,1
1,00:05:28,2,True,7,0,7,42,7,1
1,00:05:04,1,False,0,7,-7,54,10,1
1,00:02:53,2,False,0,7,-7,43,10,1
2,00:13:55,1,False,0,14,-14,8,15,1
2,00:09:48,2,True,14,0,14,8,10,1
2,00:07:33,1,False,0,14,-14,9,10,1
2,00:06:17,2,False,0,14,-14,23,10,1
2,00:02:45,1,False,0,17,-17,46,10,1
2,00:00:50,1,True,17,0,17,30,10,1
2,00:00:43,1,True,17,0,17,43,10,1
3,00:11:03,2,True,20,0,20,45,15,1
3,00:07:43,2,False,3,20,-17,52,10,1
3,00:06:22,2,True,20,3,17,54,10,1
3,00:03:41,1,False,3,20,-17,35,10,1
3,00:02:22,2,True,20,3,17,24,10,1
3,00:01:26,1,False,3,20,-17,45,10,1
3,00:00:01,1,True,20,3,17,38,15,1
4,00:15:00,2,True,20,3,17,28,5,1
4,00:11:55,2,False,3,20,-17,48,9,1
4,00:11:20,1,False,3,20,-17,28,10,1
4,00:10:36,2,False,3,20,-17,30,12,1
4,00:08:10,1,False,3,21,-18,40,20,1
4,00:04:48,2,True,21,3,18,49,5,1
4,00:02:35,1,False,3,24,-21,35,10,1
4,00:01:20,3,True,24,3,21,7,7,1
1,00:12:28,2,True,0,0,0,45,5,1
1,00:11:49,1,True,0,0,0,51,10,1
1,00:09:34,2,False,0,0,0,9,5,1
1,00:07:49,2,False,0,0,0,3,3,1
1,00:06:24,1,False,0,7,-7,48,10,1
1,00:04:53,1,True,7,0,7,40,10,1
1,00:04:25,1,True,7,0,7,16,10,1
1,00:02:44,1,True,7,0,7,10,10,1
1,00:01:12,1,True,7,7,0,32,10,1
2,00:13:59,2,False,7,7,0,16,10,1
2,00:13:30,1,False,7,7,0,52,10,1
2,00:10:52,1,True,7,7,0,48,10,1
2,00:10:35,1,False,7,7,0,20,10,1
2,00:08:07,1,False,7,10,-3,35,10,1
2,00:06:28,1,True,10,7,3,30,10,1
2,00:05:29,2,True,10,7,3,13,27,1
2,00:02:30,1,True,10,10,0,35,10,1
2,00:01:16,1,True,10,10,0,40,10,1
2,00:01:11,2,True,10,10,0,47,3,1
3,00:14:54,1,True,10,10,0,17,10,1
3,00:14:02,1,False,10,10,0,42,10,1
3,00:12:51,2,True,10,10,0,22,10,1
3,00:09:01,2,False,17,10,7,50,9,1
3,00:08:20,1,False,17,10,7,29,10,1
3,00:07:54,2,False,17,10,7,27,8,1
3,00:05:27,1,True,13,17,-4,37,10,1
4,00:12:58,1,True,13,17,-4,49,20,1
4,00:11:53,2,True,13,17,-4,10,10,1
4,00:11:22,1,False,24,13,11,42,10,1
4,00:10:44,1,False,24,13,11,31,10,1
4,00:10:25,2,False,24,13,11,25,4,1
4,00:09:46,1,False,24,14,10,35,10,1
4,00:08:12,1,False,24,21,3,33,10,1
4,00:06:56,1,False,24,22,2,35,10,1
4,00:03:33,1,True,22,24,-2,38,10,1
4,00:03:00,1,True,22,24,-2,48,10,1
4,00:02:46,1,False,24,22,2,52,10,1
4,00:02:13,2,False,24,22,2,39,11,1
4,00:01:19,1,False,24,25,-1,17,10,1
4,00:00:48,1,False,24,28,-4,35,10,1
4,00:00:32,1,True,28,24,4,51,10,1
4,00:00:24,1,True,28,24,4,18,10,1
4,00:00:14,3,True,28,24,4,12,4,1
1,00:14:54,1,True,0,0,0,28,10,1
1,00:12:33,1,True,0,0,0,34,10,1
1,00:11:15,1,False,0,0,0,45,10,1
1,00:10:22,1,False,0,0,0,9,9,1
1,00:08:12,2,False,0,7,-7,55,5,1
1,00:06:20,1,True,7,0,7,1,10,1
1,00:06:04,2,True,7,0,7,6,5,1
1,00:03:09,1,True,7,0,7,49,15,1
1,00:02:10,1,True,7,0,7,10,10,1
1,00:00:58,2,True,7,0,7,49,5,1
2,00:13:15,2,False,0,10,-10,45,6,1
2,00:12:40,1,False,0,10,-10,35,10,1
2,00:11:34,1,False,0,10,-10,14,10,1
2,00:11:13,1,False,0,17,-17,27,10,1
2,00:09:30,2,False,0,17,-17,32,19,1
2,00:06:54,2,False,0,17,-17,45,3,1
2,00:06:31,1,False,0,17,-17,55,10,1
2,00:02:52,2,True,17,1,16,43,17,1
2,00:01:48,1,False,1,17,-16,29,10,1
2,00:00:55,2,True,17,1,16,27,3,1
2,00:00:37,1,True,17,1,16,46,10,1
2,00:00:17,2,True,17,1,16,50,6,1
3,00:14:15,2,False,1,17,-16,41,5,1
3,00:13:30,1,True,17,1,16,15,10,1
3,00:13:00,2,True,17,1,16,21,4,1
3,00:11:24,1,False,1,17,-16,31,10,1
3,00:10:51,1,False,1,17,-16,19,10,1
3,00:09:36,2,False,1,17,-16,14,5,1
3,00:08:18,2,False,1,24,-23,20,20,1
3,00:07:25,1,True,24,1,23,42,10,1
3,00:04:38,1,False,1,25,-24,51,10,1
3,00:03:51,2,True,25,8,17,33,10,1
3,00:03:04,1,False,8,25,-17,33,10,1
3,00:02:46,1,True,25,8,17,38,10,1
3,00:01:44,1,True,25,8,17,9,9,1
3,00:01:35,1,True,25,15,10,45,10,1
3,00:01:14,1,True,25,15,10,55,10,1
4,00:14:10,2,False,15,28,-13,37,8,1
4,00:13:22,2,False,15,28,-13,51,10,1
4,00:10:09,1,False,15,28,-13,19,10,1
4,00:08:26,1,False,15,28,-13,5,5,1
4,00:07:10,2,False,15,34,-19,17,19,1
4,00:05:40,1,False,15,34,-19,23,10,1
4,00:03:42,1,False,15,41,-26,30,10,1
4,00:01:46,2,False,15,48,-33,42,4,1
4,00:00:52,2,False,15,48,-33,51,17,1
4,00:00:32,3,True,48,15,33,48,6,1
1,00:12:35,2,True,0,0,0,13,10,1
1,00:11:06,1,True,0,3,-3,45,10,1
1,00:09:37,2,False,3,0,3,46,6,1
1,00:08:47,1,False,3,7,-4,55,10,1
1,00:07:33,1,True,7,3,4,41,15,1
1,00:02:36,2,True,7,10,-3,30,10,1
1,00:01:25,2,True,7,10,-3,44,8,1
2,00:14:03,2,False,10,10,0,36,9,1
2,00:12:21,1,False,10,10,0,35,10,1
2,00:10:52,2,False,10,10,0,42,24,1
2,00:10:05,1,True,10,10,0,16,10,1
2,00:07:15,2,False,10,10,0,11,9,1
2,00:06:31,1,False,10,10,0,22,10,1
2,00:05:48,2,False,10,10,0,20,12,1
2,00:03:38,1,False,16,10,6,54,10,1
2,00:01:53,1,False,16,13,3,35,10,1
2,00:01:46,1,False,16,13,3,48,10,1
2,00:01:26,2,False,16,13,3,52,6,1
2,00:01:00,1,True,13,16,-3,49,10,1
2,00:00:40,1,True,13,16,-3,29,10,1
3,00:14:53,1,True,13,19,-6,29,10,1
3,00:14:10,2,True,13,19,-6,35,4,1
3,00:12:09,1,False,19,13,6,51,10,1
3,00:11:07,2,False,19,13,6,49,8,1
3,00:07:52,1,False,19,20,-1,36,10,1
3,00:03:23,2,False,22,20,2,34,21,1
3,00:00:10,1,True,23,22,1,43,20,1
4,00:15:00,2,True,23,22,1,50,13,1
4,00:12:47,2,False,22,23,-1,25,10,1
4,00:11:03,2,False,22,23,-1,5,5,1
4,00:10:40,1,False,22,30,-8,42,10,1
4,00:06:28,2,False,28,30,-2,38,10,1
4,00:05:10,2,True,30,28,2,29,7,1
4,00:02:07,1,False,28,33,-5,50,10,1
4,00:01:40,1,True,33,28,5,47,10,1
4,00:01:34,2,True,33,28,5,48,11,1
4,00:01:07,1,True,33,28,5,39,15,1
4,00:00:49,3,True,33,28,5,29,5,1
4,00:00:29,3,True,33,28,5,18,10,1
4,00:00:13,3,True,33,34,-1,22,10,1
4,00:00:06,1,True,33,34,-1,49,10,1
1,00:10:40,2,True,0,0,0,30,9,1
1,00:09:10,1,True,0,0,0,52,10,1
1,00:08:30,2,True,0,0,0,50,8,1
1,00:07:21,1,True,0,0,0,5,15,1
1,00:05:27,2,True,0,0,0,23,8,1
1,00:04:11,2,True,0,0,0,47,3,1
1,00:02:25,1,False,0,0,0,50,10,1
1,00:01:07,1,False,0,1,-1,35,10,1
2,00:08:16,1,False,0,1,-1,30,10,1
2,00:05:57,1,True,1,7,-6,44,10,1
2,00:05:35,1,False,7,1,6,43,10,1
2,00:03:00,2,False,7,1,6,30,12,1
2,00:02:08,1,True,1,7,-6,22,10,1
2,00:01:34,1,True,1,7,-6,34,10,1
2,00:00:59,1,False,7,1,6,32,10,1
2,00:00:28,2,False,7,1,6,20,10,1
3,00:14:54,1,True,2,7,-5,33,10,1
3,00:14:10,1,False,7,2,5,46,10,1
3,00:12:41,1,False,7,10,-3,25,10,1
3,00:09:25,2,True,10,7,3,55,3,1
3,00:07:34,2,False,7,11,-4,40,5,1
3,00:06:10,2,False,7,11,-4,51,4,1
3,00:04:44,2,True,11,7,4,7,6,1
3,00:03:37,1,True,11,7,4,37,10,1
3,00:00:58,1,False,8,11,-3,49,10,1
4,00:14:08,2,False,8,11,-3,30,6,1
4,00:13:50,1,False,8,18,-10,15,10,1
4,00:10:24,1,False,8,18,-10,7,7,1
4,00:09:15,2,False,8,18,-10,1,1,1
4,00:08:54,1,False,8,25,-17,29,10,1
4,00:07:57,2,False,8,25,-17,40,10,1
4,00:07:19,2,True,25,8,17,38,10,1
4,00:02:41,2,True,25,11,14,49,5,1
4,00:02:02,2,True,27,11,16,37,8,1
4,00:01:11,1,False,11,27,-16,37,10,1
4,00:00:58,1,True,27,11,16,50,10,1
4,00:00:30,1,True,27,11,16,33,10,1
1,00:14:45,1,True,0,0,0,21,10,1
1,00:13:44,2,False,0,0,0,47,12,1
1,00:12:17,2,False,0,3,-3,35,10,1
1,00:11:33,1,True,3,0,3,50,10,1
1,00:10:32,2,True,3,0,3,37,10,1
1,00:09:58,1,True,3,3,0,35,10,1
1,00:09:44,2,True,3,3,0,40,5,1
1,00:09:09,1,True,3,3,0,47,10,1
1,00:08:27,1,False,3,3,0,41,10,1
1,00:04:15,2,False,3,6,-3,30,15,1
1,00:01:21,2,False,3,6,-3,16,8,1
1,00:00:00,2,False,3,6,-3,52,4,1
2,00:13:30,1,True,6,10,-4,47,10,1
2,00:12:35,1,False,10,6,4,50,10,1
2,00:11:25,1,False,10,6,4,30,10,1
2,00:09:49,1,True,6,10,-4,8,8,1
2,00:09:20,1,True,6,17,-11,35,10,1
2,00:06:05,2,False,17,6,11,20,6,1
2,00:02:25,1,True,6,17,-11,21,10,1
2,00:02:13,2,True,6,17,-11,28,3,1
2,00:01:52,2,True,6,17,-11,46,10,1
2,00:01:16,2,False,17,6,11,11,10,1
2,00:00:17,2,True,9,17,-8,54,5,1
3,00:13:41,2,False,17,9,8,40,10,1
3,00:11:12,1,True,9,17,-8,15,10,1
3,00:10:32,1,False,24,9,15,53,10,1
3,00:09:30,1,False,24,9,15,41,10,1
3,00:09:06,1,False,24,9,15,18,10,1
3,00:08:02,1,False,24,12,12,35,10,1
3,00:05:10,1,True,12,24,-12,13,10,1
3,00:04:28,1,True,12,31,-19,26,10,1
3,00:03:41,2,False,31,12,19,51,15,1
3,00:02:22,2,False,31,15,16,34,11,1
3,00:00:53,1,True,15,31,-16,27,15,1
4,00:12:00,2,True,15,31,-16,32,8,1
4,00:09:53,1,True,15,34,-19,35,10,1
4,00:09:35,2,True,15,34,-19,44,1,1
4,00:09:08,1,True,15,34,-19,53,10,1
4,00:07:25,1,True,15,34,-19,53,10,1
4,00:05:15,1,True,15,34,-19,28,20,1
4,00:04:40,2,True,15,34,-19,28,20,1
4,00:04:19,3,True,15,34,-19,43,5,1
4,00:03:49,1,True,15,34,-19,50,10,1
4,00:01:30,1,True,15,34,-19,24,10,1
4,00:01:19,1,True,15,34,-19,40,10,1
4,00:00:38,3,True,15,34,-19,47,3,1
4,00:00:25,1,True,15,34,-19,54,10,1
4,00:00:20,2,False,34,15,19,53,7,1
4,00:00:02,1,False,34,15,19,40,10,1
1,00:14:48,1,False,0,0,0,38,10,1
1,00:12:42,2,True,0,1,-1,39,6,1
1,00:09:38,1,False,1,0,1,10,10,1
1,00:08:25,1,False,1,0,1,24,10,1
1,00:05:49,1,True,0,1,-1,53,10,1
1,00:04:53,1,True,0,1,-1,19,10,1
2,00:15:00,2,True,0,11,-11,30,7,1
2,00:14:26,1,True,0,11,-11,41,10,1
2,00:12:41,1,False,11,0,11,47,10,1
2,00:12:19,1,False,11,0,11,33,10,1
2,00:11:42,1,False,11,0,11,18,10,1
2,00:08:27,2,False,11,3,8,40,7,1
2,00:06:42,1,False,11,6,5,28,10,1
2,00:06:16,2,False,11,6,5,34,4,1
2,00:04:08,1,False,11,6,5,47,10,1
2,00:02:31,2,False,11,6,5,5,5,1
2,00:02:19,2,False,11,13,-2,35,5,1
2,00:01:53,1,False,11,13,-2,43,10,1
2,00:01:32,1,True,13,11,2,51,10,1
3,00:10:08,2,False,14,13,1,44,6,1
3,00:04:35,2,True,13,14,-1,47,15,1
4,00:14:11,2,True,13,16,-3,44,4,1
4,00:12:19,1,True,13,16,-3,26,10,1
4,00:09:34,2,False,19,13,6,49,7,1
4,00:05:46,2,True,13,19,-6,20,12,1
4,00:05:14,1,True,13,26,-13,32,10,1
4,00:04:54,2,True,13,26,-13,38,4,1
4,00:04:11,2,True,13,26,-13,51,10,1
4,00:00:22,2,True,13,26,-13,19,10,1
4,00:00:15,1,True,13,26,-13,29,10,1
4,00:00:01,2,True,13,26,-13,36,4,1
1,00:09:20,2,False,0,0,0,53,24,1
1,00:05:38,2,True,0,7,-7,40,10,1
1,00:00:54,2,True,0,7,-7,48,4,1
2,00:14:35,2,False,7,0,7,25,6,1
2,00:13:25,2,False,7,0,7,41,9,1
2,00:12:50,1,True,0,7,-7,47,10,1
2,00:11:25,1,True,0,7,-7,35,10,1
2,00:11:00,2,True,0,7,-7,27,2,1
2,00:09:29,1,True,0,7,-7,7,7,1
2,00:05:15,1,True,0,10,-10,35,10,1
2,00:04:50,1,True,0,10,-10,23,10,1
2,00:03:15,2,True,0,10,-10,19,19,1
2,00:02:00,2,True,0,13,-13,50,10,1
2,00:00:36,1,True,3,13,-10,40,10,1
2,00:00:27,2,True,3,13,-10,49,1,1
2,00:00:01,2,True,3,13,-10,52,10,1
3,00:14:22,2,False,13,3,10,27,6,1
3,00:11:14,1,False,13,3,10,34,10,1
3,00:10:49,1,False,13,3,10,45,10,1
3,00:09:38,1,True,3,13,-10,53,10,1
3,00:08:07,1,True,3,13,-10,10,5,1
3,00:06:54,1,True,3,13,-10,16,10,1
3,00:04:06,2,False,13,3,10,54,9,1
3,00:01:56,2,False,13,3,10,14,14,1
4,00:10:08,1,True,3,13,-10,13,10,1
4,00:04:54,2,False,23,3,20,44,6,1
4,00:03:28,2,True,3,23,-20,22,5,1
4,00:02:38,1,True,3,26,-23,35,10,1
4,00:00:01,2,True,3,26,-23,30,11,1
1,00:14:45,1,False,0,0,0,35,10,1
1,00:14:11,2,False,0,0,0,42,3,1
1,00:13:35,1,False,0,0,0,50,10,1
1,00:13:15,2,False,0,0,0,54,6,1
1,00:08:46,2,True,0,3,-3,30,13,1
1,00:06:40,2,False,3,0,3,46,5,1
1,00:01:56,1,False,3,3,0,15,10,1
1,00:00:50,2,False,3,3,0,41,4,1
1,00:00:01,1,False,3,3,0,45,20,1
2,00:12:18,1,True,3,4,-1,50,10,1
2,00:10:31,2,False,4,3,1,40,9,1
2,00:09:28,2,False,4,3,1,22,10,1
2,00:08:36,1,False,4,6,-2,35,10,1
2,00:04:22,1,False,7,6,1,20,10,1
2,00:02:27,1,True,6,7,-1,33,10,1
2,00:00:57,1,False,7,6,1,15,10,1
3,00:13:03,1,False,7,9,-2,30,10,1
3,00:10:56,1,False,7,9,-2,26,10,1
3,00:07:21,1,False,7,9,-2,38,10,1
3,00:06:46,2,False,7,9,-2,46,6,1
3,00:05:39,2,True,9,7,2,51,10,1
3,00:05:16,1,False,7,9,-2,44,10,1
3,00:03:19,2,False,7,9,-2,28,10,1
3,00:01:56,2,False,7,12,-5,27,18,1
3,00:00:09,2,False,7,12,-5,51,10,1
4,00:15:00,1,True,12,7,5,38,10,1
4,00:14:17,1,True,12,7,5,20,10,1
4,00:12:26,2,True,12,14,-2,51,15,1
4,00:10:56,2,False,14,12,2,40,11,1
4,00:08:45,2,True,12,14,-2,15,10,1
4,00:07:53,2,True,12,14,-2,25,10,1
4,00:07:14,1,True,12,14,-2,40,10,1
4,00:06:03,2,False,14,12,2,42,5,1
4,00:03:51,1,False,14,15,-1,45,10,1
4,00:02:41,2,True,15,14,1,51,10,1
4,00:01:33,1,True,15,17,-2,35,10,1
4,00:01:07,2,True,15,17,-2,46,10,1
4,00:00:28,1,False,17,18,-1,35,10,1
1,00:14:44,2,True,0,1,-1,39,6,1
1,00:11:43,2,True,0,1,-1,16,10,1
1,00:04:52,1,False,1,0,1,50,10,1
1,00:04:10,2,True,0,1,-1,48,10,1
1,00:01:29,2,True,0,4,-4,30,15,1
2,00:14:45,1,False,4,0,4,19,10,1
2,00:14:04,1,False,4,0,4,50,10,1
2,00:12:25,1,True,0,4,-4,40,10,1
2,00:11:40,1,False,4,0,4,54,10,1
2,00:10:55,1,False,4,0,4,49,15,1
2,00:10:27,2,False,4,0,4,42,8,1
2,00:09:45,1,False,4,0,4,24,10,1
2,00:07:14,2,False,4,7,-3,33,5,1
2,00:04:16,1,True,7,4,3,25,10,1
2,00:01:17,1,False,4,7,-3,44,10,1
3,00:14:53,1,False,4,7,-3,28,10,1
3,00:14:21,1,False,4,7,-3,40,10,1
3,00:13:47,2,False,4,7,-3,48,2,1
3,00:10:40,2,True,7,4,3,41,10,1
3,00:10:16,1,True,7,4,3,52,10,1
3,00:01:23,2,False,7,7,0,55,9,1
3,00:00:01,2,True,7,7,0,42,8,1
4,00:14:34,1,True,7,7,0,22,10,1
4,00:13:01,1,False,7,7,0,32,10,1
4,00:12:04,1,False,7,7,0,51,10,1
4,00:09:45,1,True,7,7,0,31,10,1
4,00:08:47,2,True,7,7,0,54,10,1
4,00:07:50,2,False,7,7,0,40,10,1
4,00:06:24,1,True,10,7,3,45,10,1
4,00:05:04,1,True,10,7,3,34,10,1
4,00:03:45,1,True,10,7,3,23,10,1
4,00:02:03,1,True,10,7,3,30,10,1
4,00:00:25,1,False,7,10,-3,17,10,1
1,00:14:40,2,True,0,0,0,37,10,1
1,00:13:28,2,True,0,0,0,54,9,1
1,00:09:58,2,True,3,0,3,54,4,1
1,00:09:45,1,False,0,3,-3,46,10,1
1,00:09:06,2,False,0,3,-3,42,6,1
1,00:08:04,1,False,0,3,-3,35,10,1
1,00:05:35,1,True,10,0,10,35,10,1
1,00:04:07,1,True,10,3,7,35,10,1
1,00:00:06,1,True,10,3,7,37,10,1
2,00:12:00,1,True,10,3,7,39,10,1
2,00:08:49,1,True,10,3,7,33,10,1
2,00:08:18,2,True,10,3,7,39,4,1
2,00:07:00,2,False,3,10,-7,50,14,1
2,00:06:17,2,False,3,10,-7,35,10,1
2,00:05:34,1,False,3,10,-7,20,10,1
2,00:03:48,1,False,3,13,-10,35,10,1
2,00:02:09,1,False,3,13,-10,29,10,1
2,00:01:48,1,False,3,13,-10,7,7,1
2,00:00:47,1,True,20,3,17,44,10,1
3,00:14:57,1,False,3,20,-17,24,10,1
3,00:13:09,2,False,3,20,-17,39,24,1
3,00:11:37,2,False,3,20,-17,33,9,1
3,00:10:20,2,True,20,3,17,32,18,1
3,00:10:00,1,False,3,20,-17,43,10,1
3,00:09:10,2,False,3,20,-17,33,10,1
3,00:07:00,2,False,3,20,-17,10,5,1
3,00:03:23,1,False,3,27,-24,36,10,1
3,00:00:10,2,True,27,3,24,50,10,1
4,00:13:50,1,False,3,27,-24,27,10,1
4,00:11:50,1,False,3,34,-31,13,10,1
4,00:10:20,2,False,3,41,-38,48,10,1
4,00:04:16,1,False,5,41,-36,55,10,1
4,00:01:40,1,True,41,5,36,35,10,1
1,00:13:26,2,True,0,0,0,32,15,1
1,00:12:43,1,True,0,3,-3,35,10,1
1,00:12:19,2,True,0,3,-3,40,5,1
1,00:10:52,2,False,3,0,3,33,11,1
1,00:08:00,2,True,3,3,0,23,10,1
1,00:06:54,2,True,3,3,0,35,10,1
1,00:03:04,1,True,3,10,-7,18,10,1
1,00:02:28,2,True,3,10,-7,17,11,1
1,00:00:14,1,False,10,3,7,47,10,1
2,00:12:35,1,True,10,10,0,51,10,1
2,00:12:12,2,False,10,10,0,52,3,1
2,00:11:08,2,False,10,10,0,46,10,1
2,00:09:50,1,False,10,10,0,43,10,1
2,00:07:47,1,False,10,10,0,38,30,1
2,00:07:02,2,False,10,10,0,35,33,1
2,00:03:28,2,True,10,10,0,34,10,1
2,00:02:46,1,True,10,13,-3,21,10,1
2,00:02:40,2,True,10,13,-3,30,1,1
2,00:02:34,2,True,10,13,-3,37,1,1
2,00:02:00,2,False,13,10,3,43,6,1
2,00:00:10,1,True,13,13,0,16,10,1
3,00:10:23,1,False,20,13,7,23,10,1
3,00:08:31,1,False,20,13,7,32,10,1
3,00:05:47,1,False,20,20,0,46,10,1
3,00:05:22,2,False,20,20,0,49,7,1
3,00:04:29,2,True,20,20,0,41,7,1
3,00:03:48,1,True,20,20,0,27,10,1
3,00:00:44,2,True,20,23,-3,39,6,1
4,00:11:31,1,False,23,20,3,51,20,1
4,00:10:59,2,True,20,23,-3,49,10,1
4,00:08:55,1,True,20,26,-6,35,10,1
4,00:04:44,2,False,26,20,6,21,20,1
4,00:02:00,1,True,20,26,-6,43,10,1
1,00:12:52,2,True,0,0,0,28,4,1
1,00:10:54,1,False,0,0,0,43,10,1
1,00:10:10,1,True,0,0,0,29,10,1
1,00:09:16,2,True,0,0,0,20,14,1
1,00:04:20,1,True,0,3,-3,49,10,1
1,00:00:43,2,False,6,0,6,39,10,1
2,00:12:33,1,True,0,6,-6,45,10,1
2,00:10:05,1,True,0,9,-9,27,10,1
2,00:06:40,1,False,9,0,9,29,10,1
2,00:05:25,2,False,9,0,9,13,5,1
2,00:02:48,1,False,9,3,6,54,10,1
2,00:02:31,1,True,3,9,-6,33,10,1
2,00:01:38,1,True,3,9,-6,23,10,1
2,00:01:32,2,True,3,9,-6,25,8,1
2,00:00:26,2,False,9,3,6,42,10,1
2,00:00:08,2,False,9,3,6,26,10,1
3,00:14:49,1,True,6,9,-3,24,10,1
3,00:13:36,2,True,6,9,-3,52,5,1
3,00:11:21,1,False,9,6,3,30,10,1
3,00:07:53,1,True,6,12,-6,50,10,1
3,00:07:22,2,True,6,12,-6,46,6,1
3,00:03:05,1,False,20,6,14,54,10,1
3,00:01:56,1,True,6,20,-14,44,10,1
4,00:14:01,2,False,23,6,17,38,6,1
4,00:11:23,2,True,6,23,-17,18,10,1
4,00:09:31,1,False,23,6,17,52,10,1
4,00:07:38,2,True,6,23,-17,28,10,1
4,00:06:23,2,True,6,23,-17,46,9,1
4,00:05:14,2,True,6,23,-17,48,19,1
4,00:02:20,2,False,23,6,17,40,4,1
4,00:01:28,1,True,6,23,-17,34,10,1
4,00:01:22,2,True,6,23,-17,40,4,1
4,00:01:15,1,False,23,6,17,54,10,1
1,00:14:54,1,True,0,0,0,33,10,1
1,00:14:02,1,True,0,0,0,53,10,1
1,00:12:37,1,False,0,7,-7,49,10,1
1,00:10:41,2,True,7,0,7,45,5,1
1,00:09:08,2,True,7,0,7,37,9,1
1,00:08:42,1,True,7,0,7,26,10,1
1,00:07:25,2,True,7,0,7,10,10,1
1,00:02:44,1,False,7,14,-7,53,10,1
1,00:00:11,1,True,14,7,7,35,10,1
2,00:13:17,2,True,14,7,7,19,5,1
2,00:09:18,3,True,14,14,0,48,10,1
2,00:08:25,2,True,14,14,0,21,8,1
2,00:06:13,2,True,14,17,-3,36,9,1
2,00:04:47,2,True,14,17,-3,50,7,1
2,00:03:08,1,False,17,14,3,34,10,1
2,00:01:56,1,False,17,17,0,35,10,1
2,00:01:12,1,True,17,17,0,45,10,1
2,00:01:03,2,True,17,17,0,50,5,1
2,00:00:43,1,False,17,17,0,53,10,1
2,00:00:35,2,False,17,17,0,48,5,1
2,00:00:21,1,False,17,17,0,42,15,1
2,00:00:15,2,False,17,17,0,38,11,1
3,00:14:54,1,False,17,20,-3,35,10,1
3,00:14:31,2,False,17,20,-3,39,6,1
3,00:12:22,2,True,20,17,3,17,10,1
3,00:10:19,1,True,20,17,3,47,20,1
3,00:09:10,1,True,20,20,0,35,10,1
3,00:08:56,2,True,20,20,0,39,6,1
3,00:08:13,1,True,20,20,0,51,10,1
3,00:05:52,2,False,20,23,-3,36,9,1
3,00:04:00,1,True,23,20,3,50,10,1
3,00:03:32,1,False,20,23,-3,47,10,1
3,00:01:35,1,False,20,23,-3,7,17,1
3,00:00:37,2,True,23,20,3,55,10,1
4,00:15:00,1,False,20,23,-3,15,10,1
4,00:14:44,2,False,20,23,-3,20,5,1
4,00:14:02,1,False,20,23,-3,44,10,1
4,00:13:16,1,True,23,20,3,49,10,1
4,00:12:01,2,True,23,20,3,18,10,1
4,00:08:18,2,False,23,23,0,42,6,1
4,00:07:10,1,True,23,23,0,14,10,1
4,00:04:59,1,False,23,30,-7,35,10,1
4,00:04:33,2,False,23,30,-7,35,10,1
4,00:03:18,2,False,23,30,-7,52,5,1
4,00:02:31,1,True,30,23,7,55,10,1
4,00:00:55,1,False,23,33,-10,35,10,1
1,00:10:10,1,False,0,14,-14,28,10,1
1,00:09:10,2,False,0,14,-14,34,4,1
1,00:07:10,2,True,14,0,14,37,7,1
1,00:03:27,1,False,3,14,-11,48,10,1
1,00:02:27,2,True,14,3,11,16,10,1
2,00:15:00,2,False,6,14,-8,40,10,1
2,00:13:37,2,True,14,6,8,37,5,1
2,00:12:22,2,False,6,14,-8,15,10,1
2,00:11:52,1,False,6,14,-8,29,10,1
2,00:11:17,2,False,6,14,-8,35,4,1
2,00:10:11,2,True,14,6,8,30,10,1
2,00:08:17,2,False,6,14,-8,8,19,1
2,00:07:27,1,True,14,6,8,47,10,1
2,00:07:08,1,False,6,14,-8,45,10,1
2,00:04:42,2,False,6,14,-8,38,14,1
2,00:02:36,1,False,6,21,-15,45,10,1
2,00:01:56,1,True,21,6,15,52,10,1
2,00:01:33,1,False,6,28,-22,32,10,1
2,00:01:26,1,False,6,28,-22,43,10,1
3,00:10:57,2,False,6,28,-22,38,3,1
3,00:09:54,1,False,6,28,-22,40,10,1
3,00:07:54,1,False,6,31,-25,52,10,1
3,00:06:33,1,True,31,6,25,48,10,1
3,00:05:39,2,True,31,6,25,51,13,1
3,00:01:30,2,True,31,9,22,41,4,1
3,00:00:44,2,True,31,9,22,51,10,1
3,00:00:01,1,False,9,31,-22,10,10,1
4,00:15:00,2,False,9,31,-22,8,12,1
4,00:11:33,2,False,9,34,-25,40,7,1
4,00:10:59,1,False,9,34,-25,53,10,1
4,00:07:54,2,False,9,37,-28,35,10,1
4,00:04:57,2,False,9,37,-28,40,9,1
4,00:03:00,3,True,37,9,28,32,7,1
4,00:02:13,2,True,37,9,28,24,10,1
4,00:01:10,1,False,9,37,-28,26,10,1
4,00:01:01,1,False,9,37,-28,44,10,1
4,00:00:36,2,False,9,37,-28,52,2,1
4,00:00:18,1,True,37,9,28,51,10,1
1,00:14:56,1,False,0,0,0,20,10,1
1,00:13:52,2,False,0,0,0,33,10,1
1,00:13:26,1,True,0,0,0,37,10,1
1,00:12:27,2,True,0,0,0,23,7,1
1,00:11:58,1,True,0,0,0,16,10,1
1,00:09:23,1,False,3,0,3,28,10,1
1,00:08:40,1,False,3,0,3,40,10,1
1,00:07:35,2,False,3,0,3,49,12,1
1,00:05:23,1,True,0,3,-3,50,10,1
1,00:03:08,1,True,0,6,-6,25,20,1
2,00:14:47,2,False,6,0,6,30,10,1
2,00:13:26,2,False,6,6,0,34,10,1
2,00:08:23,2,False,6,6,0,13,13,1
2,00:06:03,1,False,6,6,0,36,10,1
2,00:05:38,2,False,6,6,0,42,4,1
2,00:04:21,1,False,6,6,0,48,20,1
2,00:03:17,1,True,6,6,0,33,10,1
2,00:02:38,1,True,6,6,0,22,10,1
2,00:01:40,1,True,6,13,-7,17,10,1
2,00:00:32,1,True,6,13,-7,51,10,1
3,00:13:36,2,True,6,13,-7,31,7,1
3,00:11:55,1,True,6,20,-14,35,10,1
3,00:11:34,2,True,6,20,-14,41,4,1
3,00:11:04,1,True,6,20,-14,47,10,1
3,00:09:19,2,True,6,20,-14,55,3,1
3,00:08:25,1,False,20,6,14,48,10,1
3,00:03:17,2,True,13,20,-7,24,10,1
3,00:02:49,1,True,13,20,-7,54,10,1
3,00:00:32,1,False,20,13,7,14,10,1
4,00:14:06,2,False,20,20,0,20,19,1
4,00:10:58,1,False,20,29,-9,47,10,1
4,00:10:34,1,False,20,29,-9,35,10,1
4,00:08:19,1,False,20,29,-9,35,10,1
4,00:07:37,1,False,20,29,-9,50,10,1
4,00:06:10,1,True,29,20,9,31,10,1
4,00:05:54,2,True,29,20,9,34,7,1
4,00:04:09,2,True,29,20,9,40,13,1
4,00:03:07,1,False,20,29,-9,10,10,1
4,00:02:15,2,True,29,20,9,46,9,1
4,00:01:40,1,False,20,29,-9,16,10,1
4,00:01:13,2,False,20,29,-9,45,10,1
4,00:01:06,1,True,29,20,9,48,10,1
4,00:00:58,2,True,29,20,9,42,4,1
4,00:00:45,3,True,29,20,9,40,2,1
4,00:00:21,2,True,29,20,9,24,10,1
4,00:00:00,2,True,29,20,9,2,2,1
1,00:11:19,1,True,1,0,1,37,10,1
1,00:10:52,1,True,1,0,1,51,10,1
1,00:09:38,1,False,0,1,-1,49,10,1
1,00:06:26,1,True,4,0,4,46,10,1
1,00:04:00,1,True,4,0,4,21,15,1
1,00:02:06,1,True,4,0,4,37,10,1
2,00:14:09,2,True,4,3,1,54,7,1
2,00:13:25,1,False,3,4,-1,43,10,1
2,00:11:19,2,False,3,5,-2,45,10,1
2,00:09:57,2,True,5,3,2,50,5,1
2,00:07:28,2,True,5,3,2,30,10,1
2,00:05:39,1,False,3,5,-2,23,10,1
2,00:02:08,1,False,3,5,-2,38,10,1
2,00:01:57,2,False,3,5,-2,42,6,1
2,00:01:13,2,False,3,5,-2,50,10,1
2,00:00:44,1,True,5,3,2,10,10,1
3,00:14:51,1,False,10,5,5,55,10,1
3,00:14:29,1,True,5,10,-5,42,10,1
3,00:12:03,1,True,5,10,-5,5,5,1
3,00:11:35,1,True,5,17,-12,28,10,1
3,00:03:50,1,True,5,17,-12,45,10,1
3,00:01:03,2,True,5,17,-12,16,19,1
4,00:15:00,2,False,17,5,12,41,16,1
4,00:13:56,1,True,5,17,-12,3,10,1
4,00:12:35,1,False,19,5,14,41,10,1
4,00:09:20,2,False,21,5,16,40,10,1
4,00:08:16,2,True,5,21,-16,46,5,1
4,00:07:03,1,True,5,21,-16,36,10,1
4,00:01:25,1,True,5,31,-26,36,10,1
4,00:01:01,3,True,5,31,-26,41,5,1
1,00:11:48,2,False,0,0,0,43,7,1
1,00:10:49,2,True,0,0,0,26,10,1
1,00:08:23,2,False,0,0,0,20,8,1
1,00:04:17,2,False,7,0,7,47,6,1
1,00:03:39,1,False,7,0,7,36,10,1
1,00:02:47,1,False,7,0,7,18,10,1
1,00:01:57,2,False,7,7,0,25,10,1
2,00:15:00,1,False,7,7,0,19,10,1
2,00:14:32,2,False,7,7,0,25,4,1
2,00:12:16,1,True,7,7,0,27,10,1
2,00:10:17,2,False,7,7,0,48,7,1
2,00:09:18,2,True,7,7,0,44,9,1
2,00:08:24,1,True,7,10,-3,35,10,1
2,00:05:39,1,False,10,14,-4,42,10,1
2,00:03:22,2,False,10,14,-4,25,10,1
2,00:01:55,1,False,10,21,-11,43,10,1
2,00:01:25,1,True,21,10,11,6,10,1
3,00:14:15,2,False,10,21,-11,32,8,1
3,00:13:27,2,False,10,21,-11,50,10,1
3,00:10:54,1,False,10,21,-11,29,10,1
3,00:10:19,1,False,10,21,-11,41,10,1
3,00:09:42,1,False,10,21,-11,55,10,1
3,00:08:19,2,True,21,10,11,14,10,1
3,00:02:29,2,True,21,13,8,20,7,1
3,00:01:14,2,True,21,13,8,30,8,1
3,00:00:14,2,True,21,13,8,44,5,1
4,00:14:39,1,False,13,21,-8,19,10,1
4,00:13:54,1,False,13,21,-8,44,10,1
4,00:11:37,2,True,21,13,8,32,8,1
4,00:09:59,2,True,21,13,8,4,4,1
4,00:09:36,1,True,21,19,2,29,10,1
4,00:08:55,1,True,21,19,2,44,10,1
4,00:08:17,2,True,21,19,2,50,4,1
4,00:07:29,1,False,19,21,-2,35,10,1
4,00:05:37,1,False,19,24,-5,40,10,1
4,00:03:35,2,True,24,19,5,29,10,1
4,00:02:36,1,False,19,24,-5,29,10,1
4,00:02:21,2,False,19,24,-5,38,1,1
4,00:01:32,1,False,19,24,-5,45,10,1
4,00:01:27,1,True,24,25,-1,32,10,1
4,00:01:10,1,True,24,25,-1,43,10,1
1,00:13:39,1,False,0,0,0,32,10,1
1,00:12:29,2,False,0,0,0,48,7,1
1,00:11:55,1,True,0,0,0,54,10,1
1,00:11:10,1,True,0,0,0,38,10,1
1,00:10:36,1,True,0,0,0,25,10,1
1,00:08:56,2,True,0,7,-7,15,10,1
1,00:06:53,2,True,0,10,-10,37,2,1
1,00:06:28,1,True,0,10,-10,23,10,1
1,00:05:50,1,True,0,10,-10,9,9,1
1,00:04:29,1,True,0,17,-17,30,10,1
1,00:03:29,2,True,0,17,-17,45,8,1
1,00:02:33,1,True,0,17,-17,27,10,1
1,00:00:32,2,True,0,24,-24,38,10,1
2,00:14:22,1,False,24,0,24,25,10,1
2,00:13:21,1,False,24,0,24,36,10,1
2,00:10:53,3,True,0,24,-24,24,13,1
2,00:07:49,1,True,0,32,-32,35,10,1
2,00:04:47,1,False,32,7,25,29,10,1
2,00:03:56,2,False,32,7,25,44,12,1
2,00:02:45,1,False,32,7,25,54,10,1
2,00:02:29,1,False,32,7,25,43,10,1
2,00:01:34,1,False,32,7,25,30,10,1
2,00:01:03,1,True,7,32,-25,7,10,1
2,00:00:43,2,True,7,32,-25,19,10,1
2,00:00:05,1,False,32,7,25,48,10,1
3,00:14:54,1,True,7,32,-25,30,10,1
3,00:13:27,2,False,32,7,25,18,7,1
3,00:11:35,1,True,7,32,-25,26,10,1
3,00:06:36,1,True,7,35,-28,35,10,1
3,00:04:28,1,False,35,7,28,24,10,1
3,00:03:56,2,False,35,7,28,26,8,1
3,00:03:15,1,True,7,35,-28,35,10,1
3,00:02:42,2,True,7,35,-28,40,5,1
4,00:11:51,2,True,7,35,-28,23,25,1
4,00:11:20,1,False,35,7,28,34,10,1
4,00:09:14,1,False,35,7,28,40,10,1
4,00:07:49,1,True,7,38,-31,35,10,1
4,00:07:33,1,True,7,38,-31,50,10,1
4,00:06:58,1,False,38,7,31,45,10,1
4,00:06:06,1,False,38,7,31,5,5,1
4,00:03:43,1,True,14,38,-24,37,10,1
1,00:14:18,2,True,0,0,0,44,6,1
1,00:10:45,1,True,0,0,0,46,10,1
1,00:10:11,2,True,0,0,0,40,4,1
1,00:08:38,2,True,0,0,0,47,25,1
1,00:07:40,1,True,0,3,-3,30,10,1
1,00:05:32,2,False,3,0,3,17,14,1
1,00:04:50,1,False,3,0,3,50,10,1
1,00:04:27,2,False,3,0,3,42,2,1
1,00:03:05,2,False,3,0,3,38,9,1
1,00:00:01,1,True,3,3,0,32,10,1
2,00:14:46,2,True,3,3,0,47,10,1
2,00:11:30,1,True,3,3,0,6,15,1
2,00:11:24,1,True,3,3,0,22,10,1
2,00:09:20,2,True,3,3,0,49,15,1
2,00:07:21,2,False,3,3,0,29,9,1
2,00:04:35,2,False,3,10,-7,49,6,1
2,00:01:02,1,True,10,3,7,35,10,1
2,00:00:56,1,True,10,3,7,48,10,1
3,00:14:12,2,False,3,10,-7,34,7,1
3,00:12:55,1,True,10,3,7,24,15,1
3,00:12:30,2,True,10,3,7,34,5,1
3,00:10:49,2,True,10,3,7,46,6,1
3,00:08:30,1,False,3,10,-7,19,10,1
3,00:08:02,2,False,3,10,-7,26,3,1
3,00:06:48,2,False,3,10,-7,23,20,1
3,00:06:23,1,True,10,3,7,38,10,1
3,00:03:17,2,False,3,10,-7,37,21,1
3,00:00:01,2,True,10,10,0,5,5,1
4,00:14:40,1,True,10,13,-3,34,10,1
4,00:14:00,1,False,13,10,3,45,10,1
4,00:11:35,1,False,13,11,2,33,10,1
4,00:06:13,2,True,11,16,-5,40,5,1
4,00:05:25,1,False,16,11,5,12,10,1
4,00:00:16,2,True,17,23,-6,17,28,1
1,00:14:56,1,True,0,0,0,29,10,1
1,00:12:12,1,True,0,0,0,35,10,1
1,00:11:18,2,True,0,7,-7,38,7,1
1,00:10:33,1,True,0,7,-7,52,10,1
1,00:09:07,1,False,7,1,6,35,10,1
1,00:08:02,1,True,1,7,-6,39,10,1
1,00:06:09,1,True,1,10,-9,32,10,1
1,00:05:27,2,True,1,10,-9,30,12,1
1,00:00:01,2,False,10,5,5,27,12,1
2,00:08:39,2,True,8,17,-9,33,9,1
2,00:04:32,2,False,20,8,12,42,2,1
2,00:03:56,1,False,20,8,12,54,10,1
2,00:02:37,1,True,8,20,-12,25,10,1
2,00:01:41,2,False,27,8,19,44,14,1
2,00:00:58,1,True,8,27,-19,52,20,1
2,00:00:50,2,True,8,27,-19,37,5,1
2,00:00:21,1,True,8,30,-22,35,10,1
2,00:00:14,1,True,8,30,-22,45,10,1
3,00:12:01,1,True,8,30,-22,37,10,1
3,00:11:32,2,True,8,30,-22,43,4,1
3,00:09:35,1,False,30,8,22,46,10,1
3,00:07:17,2,False,30,8,22,36,10,1
3,00:03:39,1,True,11,30,-19,17,10,1
3,00:02:07,2,True,11,30,-19,27,13,1
3,00:00:41,1,True,11,30,-19,41,10,1
3,00:00:01,2,True,11,30,-19,47,4,1
4,00:09:15,1,False,30,14,16,6,10,1
4,00:08:32,1,False,30,14,16,22,10,1
4,00:05:19,1,True,14,30,-16,34,10,1
4,00:03:41,1,False,30,17,13,35,10,1
4,00:02:21,1,True,17,30,-13,30,10,1
4,00:02:09,2,True,17,30,-13,46,10,1
4,00:00:30,2,False,33,17,16,43,18,1
1,00:14:40,1,True,0,0,0,39,15,1
1,00:13:23,2,False,0,0,0,40,3,1
1,00:10:38,2,False,0,3,-3,30,15,1
1,00:08:31,1,False,0,3,-3,33,10,1
1,00:07:24,1,False,0,3,-3,10,10,1
1,00:06:26,1,True,10,0,10,12,10,1
1,00:03:47,1,True,10,3,7,31,10,1
1,00:03:07,2,True,10,3,7,37,4,1
1,00:00:38,1,False,3,10,-7,33,10,1
2,00:14:51,1,False,3,17,-14,43,10,1
2,00:14:32,1,True,17,3,14,54,10,1
2,00:14:04,2,True,17,3,14,51,7,1
2,00:10:44,1,False,6,17,-11,30,10,1
2,00:08:49,1,True,17,6,11,21,10,1
2,00:04:50,1,False,13,17,-4,27,10,1
2,00:04:12,2,False,13,17,-4,23,10,1
2,00:03:44,1,True,17,13,4,30,10,1
2,00:02:30,1,True,17,16,1,35,10,1
2,00:02:01,1,True,17,16,1,37,10,1
2,00:01:56,2,True,17,16,1,33,6,1
3,00:14:56,1,False,19,17,2,34,10,1
3,00:13:40,1,True,17,19,-2,37,10,1
3,00:12:41,1,False,19,17,2,48,10,1
3,00:11:34,1,True,17,19,-2,27,10,1
3,00:10:06,1,False,19,20,-1,35,10,1
3,00:09:43,1,True,20,19,1,46,10,1
3,00:08:58,1,True,20,19,1,35,15,1
3,00:07:31,1,True,20,19,1,13,10,1
3,00:06:26,1,False,19,20,-1,46,10,1
3,00:04:10,1,True,27,19,8,41,10,1
3,00:03:35,1,True,27,19,8,30,10,1
3,00:00:16,1,False,26,27,-1,30,10,1
4,00:13:10,2,True,27,26,1,15,15,1
4,00:12:14,2,True,27,26,1,32,10,1
4,00:11:33,1,True,27,26,1,47,10,1
4,00:10:30,2,False,26,27,-1,50,10,1
4,00:08:37,1,False,26,30,-4,35,10,1
4,00:08:09,2,False,26,30,-4,40,5,1
4,00:04:22,2,False,29,30,-1,47,3,1
4,00:02:32,1,False,29,33,-4,35,10,1
4,00:01:25,2,True,33,29,4,44,14,1
1,00:12:13,1,False,0,0,0,20,10,1
1,00:11:47,1,False,0,0,0,32,10,1
1,00:10:27,1,False,0,0,0,41,10,1
1,00:09:57,1,False,0,0,0,28,10,1
1,00:08:20,2,False,0,0,0,16,10,1
1,00:05:55,2,False,0,7,-7,22,7,1
1,00:03:27,1,False,0,7,-7,9,20,1
1,00:02:43,2,False,0,7,-7,11,18,1
1,00:00:50,1,True,7,0,7,47,10,1
1,00:00:34,2,True,7,0,7,45,12,1
2,00:13:47,2,False,0,7,-7,44,10,1
2,00:12:08,1,False,0,7,-7,17,10,1
2,00:11:54,1,False,0,14,-14,24,10,1
2,00:08:35,2,False,0,14,-14,51,4,1
2,00:06:58,1,True,14,0,14,50,10,1
2,00:06:12,2,True,14,0,14,51,9,1
2,00:05:14,1,False,0,14,-14,42,10,1
2,00:04:31,2,False,0,14,-14,33,11,1
2,00:02:30,2,False,0,14,-14,22,15,1
2,00:02:22,1,False,0,21,-21,27,10,1
2,00:01:28,1,False,7,21,-14,51,10,1
2,00:01:23,2,False,7,21,-14,46,5,1
2,00:01:18,1,False,7,21,-14,40,10,1
2,00:00:48,2,False,7,21,-14,17,10,1
3,00:14:03,2,True,28,7,21,33,14,1
3,00:12:39,2,False,7,28,-21,49,10,1
3,00:11:43,1,False,7,28,-21,8,10,1
3,00:11:10,1,False,7,28,-21,27,10,1
3,00:10:21,1,False,7,28,-21,17,10,1
3,00:08:49,1,False,7,31,-24,35,10,1
3,00:07:52,2,False,7,31,-24,52,9,1
3,00:07:12,1,True,31,7,24,45,10,1
3,00:04:42,1,True,31,7,24,32,10,1
3,00:03:52,1,False,14,31,-17,54,10,1
3,00:01:12,1,False,14,32,-18,35,10,1
3,00:00:52,1,False,14,32,-18,47,10,1
4,00:15:00,2,True,32,14,18,34,13,1
4,00:13:30,2,True,32,17,15,40,5,1
4,00:12:40,1,True,32,17,15,48,10,1
4,00:12:10,2,True,32,17,15,50,8,1
4,00:10:52,2,False,17,32,-15,39,7,1
4,00:07:55,1,False,17,35,-18,41,10,1
4,00:07:18,1,False,17,35,-18,29,10,1
4,00:06:06,1,False,17,38,-21,35,10,1
4,00:04:39,2,False,17,38,-21,47,10,1
4,00:03:08,2,True,38,17,21,18,18,1
4,00:02:22,1,True,38,17,21,16,10,1
4,00:01:46,2,True,38,17,21,30,9,1
1,00:13:50,2,True,0,0,0,20,15,1
1,00:11:40,1,False,0,0,0,47,10,1
1,00:10:54,2,False,0,0,0,51,6,1
1,00:09:57,1,True,0,0,0,12,10,1
1,00:08:54,2,True,0,0,0,9,7,1
1,00:08:13,1,True,0,7,-7,23,10,1
1,00:07:24,2,True,0,7,-7,40,10,1
1,00:04:49,2,False,7,0,7,52,12,1
1,00:02:09,1,False,7,0,7,30,10,1
1,00:00:33,1,True,0,7,-7,13,10,1
1,00:00:08,1,True,0,7,-7,26,10,1
2,00:14:04,1,False,7,0,7,43,10,1
2,00:12:55,1,False,7,0,7,31,10,1
2,00:10:36,2,False,7,7,0,37,3,1
2,00:10:10,1,False,7,7,0,42,10,1
2,00:08:37,2,False,7,7,0,35,17,1
2,00:04:15,2,True,7,7,0,21,4,1
2,00:03:40,1,True,7,14,-7,49,10,1
2,00:02:36,2,False,14,7,7,43,7,1
2,00:02:15,1,False,14,7,7,28,10,1
2,00:01:53,2,False,14,7,7,26,8,1
2,00:01:21,1,False,14,7,7,15,10,1
2,00:00:35,1,False,14,14,0,21,10,1
2,00:00:28,2,False,14,14,0,18,7,1
2,00:00:03,1,False,14,14,0,6,6,1
3,00:14:19,2,False,14,21,-7,17,9,1
3,00:12:02,1,False,14,21,-7,50,10,1
3,00:07:34,1,True,21,21,0,35,10,1
3,00:06:08,1,False,21,21,0,38,10,1
3,00:04:37,2,True,21,21,0,40,10,1
3,00:01:34,1,False,21,21,0,49,10,1
3,00:00:33,2,False,21,21,0,39,10,1
4,00:14:02,1,False,21,21,0,15,10,1
4,00:13:04,1,False,21,28,-7,24,20,1
4,00:07:10,1,True,31,21,10,24,20,1
4,00:06:37,2,True,31,21,10,27,17,1
4,00:03:25,2,False,21,31,-10,33,10,1
4,00:02:54,1,False,21,38,-17,48,10,1
4,00:02:31,3,False,21,38,-17,45,13,1
4,00:02:16,1,True,38,21,17,51,10,1
4,00:02:06,3,True,38,21,17,43,2,1
4,00:00:41,1,False,21,38,-17,32,10,1
4,00:00:34,2,False,21,38,-17,37,5,1
4,00:00:12,2,False,21,38,-17,47,10,1
1,00:14:31,2,True,0,0,0,46,4,1
1,00:13:13,2,False,0,0,0,52,5,1
1,00:10:44,2,False,0,1,-1,41,4,1
1,00:08:59,2,True,1,0,1,18,4,1
1,00:05:42,1,False,0,1,-1,10,10,1
1,00:05:14,1,False,0,1,-1,23,10,1
1,00:03:25,2,False,0,1,-1,16,4,1
2,00:13:20,2,False,1,4,-3,20,10,1
2,00:12:29,1,False,1,7,-6,35,10,1
2,00:11:56,2,False,1,7,-6,40,5,1
2,00:10:53,2,True,7,1,6,44,9,1
2,00:09:00,1,True,7,4,3,35,10,1
2,00:06:10,2,False,4,8,-4,49,9,1
2,00:04:38,2,True,8,4,4,22,9,1
2,00:03:08,2,True,8,4,4,41,6,1
2,00:01:58,1,True,8,4,4,52,10,1
2,00:01:21,1,False,4,8,-4,17,10,1
2,00:01:14,2,False,4,8,-4,23,4,1
3,00:14:52,1,False,4,8,-4,39,10,1
3,00:11:59,2,True,8,4,4,29,8,1
3,00:11:15,1,True,8,4,4,19,10,1
3,00:08:39,1,True,8,4,4,39,10,1
3,00:06:59,2,True,8,4,4,41,23,1
3,00:06:06,1,True,8,4,4,40,10,1
3,00:04:34,2,True,8,4,4,26,10,1
3,00:01:56,2,False,7,8,-1,36,6,1
3,00:00:41,2,False,7,8,-1,52,3,1
4,00:13:30,1,False,7,8,-1,19,10,1
4,00:13:05,2,False,7,8,-1,22,7,1
4,00:12:39,1,False,7,8,-1,43,10,1
4,00:12:01,1,True,8,7,1,53,10,1
4,00:07:51,1,True,8,7,1,11,10,1
4,00:05:35,1,True,8,7,1,38,10,1
4,00:04:53,2,True,8,7,1,38,10,1
4,00:04:30,1,True,8,7,1,50,10,1
4,00:03:22,1,False,7,8,-1,9,10,1
4,00:03:00,1,False,7,8,-1,32,10,1
4,00:01:59,2,True,8,7,1,54,9,1
4,00:01:33,1,True,8,7,1,41,10,1
4,00:00:20,1,True,8,10,-2,35,10,1
1,00:14:14,2,True,0,0,0,28,11,1
1,00:13:45,1,True,0,0,0,44,10,1
1,00:10:26,1,False,0,0,0,45,10,1
1,00:08:42,1,True,0,0,0,40,10,1
1,00:06:06,1,True,0,7,-7,44,10,1
1,00:05:03,1,True,0,7,-7,55,10,1
1,00:04:44,1,False,7,7,0,26,10,1
1,00:03:32,2,True,7,7,0,43,7,1
1,00:03:00,1,True,7,7,0,34,10,1
1,00:02:40,1,True,7,7,0,18,10,1
2,00:13:29,1,True,7,10,-3,23,10,1
2,00:12:52,1,True,7,10,-3,35,10,1
2,00:11:20,1,False,10,7,3,40,10,1
2,00:09:25,1,True,7,10,-3,12,10,1
2,00:09:10,1,True,7,10,-3,31,10,1
2,00:07:45,1,True,7,10,-3,54,10,1
2,00:07:20,2,False,10,7,3,54,8,1
2,00:05:37,1,False,10,7,3,46,10,1
2,00:04:20,1,False,10,7,3,30,10,1
2,00:03:10,1,True,7,10,-3,6,6,1
2,00:02:42,1,True,7,17,-10,40,10,1
2,00:02:22,2,True,7,17,-10,44,20,1
2,00:02:04,1,False,17,7,10,30,10,1
2,00:01:59,2,False,17,7,10,30,10,1
2,00:01:24,1,False,17,7,10,41,10,1
2,00:01:15,2,False,17,7,10,45,6,1
2,00:01:01,2,False,17,7,10,51,10,1
2,00:00:36,1,True,7,17,-10,40,10,1
3,00:13:48,2,False,17,7,10,33,14,1
3,00:12:48,2,False,17,7,10,40,25,1
3,00:11:58,1,True,7,17,-10,24,10,1
3,00:09:50,2,True,7,17,-10,40,7,1
3,00:08:13,1,True,7,17,-10,39,10,1
3,00:06:09,1,True,7,20,-13,35,10,1
3,00:01:47,2,True,10,20,-10,53,6,1
3,00:00:46,2,False,20,10,10,45,10,1
3,00:00:02,2,False,20,10,10,31,8,1
4,00:14:44,1,False,20,10,10,21,10,1
4,00:09:49,1,True,17,23,-6,35,10,1
4,00:08:42,2,False,23,17,6,38,8,1
4,00:06:40,2,False,23,17,6,29,10,1
4,00:04:26,2,False,23,20,3,40,20,1
4,00:02:29,1,True,20,23,-3,10,10,1
4,00:01:16,2,True,20,23,-3,11,9,1
4,00:00:28,1,True,20,30,-10,41,10,1
4,00:00:16,1,True,20,30,-10,53,10,1
4,00:00:09,2,False,30,20,10,50,3,1
1,00:14:52,1,True,0,0,0,32,10,1
1,00:12:52,2,False,0,0,0,47,9,1
1,00:12:06,1,True,0,0,0,47,10,1
1,00:10:00,2,True,0,0,0,46,21,1
1,00:06:48,1,True,0,0,0,53,5,1
1,00:05:49,2,True,0,0,0,37,7,1
1,00:04:49,2,True,0,0,0,22,10,1
1,00:03:36,1,True,0,0,0,52,10,1
1,00:01:36,2,False,0,1,-1,40,5,1
2,00:13:42,2,True,1,1,0,40,5,1
2,00:13:08,1,True,1,1,0,50,10,1
2,00:12:01,1,False,1,1,0,49,10,1
2,00:11:24,1,False,1,1,0,35,10,1
2,00:05:43,1,True,4,4,0,35,10,1
2,00:03:29,1,False,4,4,0,18,10,1
2,00:02:43,2,False,4,4,0,28,20,1
2,00:02:22,1,True,4,4,0,18,10,1
2,00:02:05,2,True,4,4,0,23,5,1
2,00:01:47,1,True,4,4,0,30,10,1
2,00:00:55,1,False,4,4,0,34,10,1
2,00:00:50,2,False,4,4,0,35,9,1
2,00:00:14,1,False,4,4,0,45,10,1
3,00:13:38,1,True,4,4,0,36,10,1
3,00:11:31,2,False,4,5,-1,41,4,1
3,00:09:02,2,True,5,4,1,29,5,1
3,00:07:53,2,True,5,4,1,42,9,1
3,00:04:52,1,False,4,5,-1,41,10,1
3,00:00:24,2,True,5,4,1,52,6,1
3,00:00:01,1,False,4,5,-1,52,10,1
4,00:14:46,1,False,4,5,-1,30,10,1
4,00:11:25,2,True,12,4,8,36,5,1
4,00:10:42,1,True,12,4,8,41,10,1
4,00:07:44,2,False,4,12,-8,12,15,1
4,00:06:40,2,False,4,12,-8,34,10,1
4,00:02:07,1,False,11,13,-2,40,10,1
1,00:14:30,2,False,0,0,0,43,10,1
1,00:13:17,2,True,0,0,0,19,5,1
1,00:11:36,2,True,0,0,0,36,4,1
1,00:05:43,2,True,0,7,-7,35,7,1
1,00:01:20,2,True,0,10,-10,19,10,1
2,00:13:15,2,False,10,0,10,31,5,1
2,00:09:59,1,True,3,10,-7,28,10,1
2,00:09:50,1,True,3,10,-7,38,10,1
2,00:09:26,2,True,3,10,-7,43,5,1
2,00:07:07,1,False,10,6,4,30,10,1
2,00:06:43,2,False,10,6,4,33,7,1
2,00:05:10,2,False,10,6,4,31,19,1
2,00:04:33,1,True,6,10,-4,28,10,1
2,00:02:58,2,False,10,6,4,36,6,1
2,00:00:07,1,True,6,13,-7,50,10,1
3,00:14:30,2,True,9,13,-4,51,12,1
3,00:12:28,1,False,13,9,4,30,15,1
3,00:11:56,2,False,13,9,4,37,8,1
3,00:11:18,2,True,9,13,-4,52,7,1
3,00:09:52,2,True,9,13,-4,18,7,1
3,00:09:04,1,True,9,13,-4,28,10,1
3,00:05:49,1,True,9,13,-4,40,10,1
3,00:04:45,2,False,13,9,4,53,4,1
3,00:03:40,2,False,13,10,3,20,25,1
3,00:02:23,2,True,10,13,-3,43,10,1
3,00:01:45,1,True,10,13,-3,53,10,1
3,00:01:10,2,True,10,13,-3,49,14,1
4,00:14:44,2,False,13,10,3,18,10,1
4,00:14:02,2,False,13,17,-4,46,6,1
4,00:09:03,2,True,17,19,-2,25,10,1
4,00:06:27,2,True,17,19,-2,53,6,1
4,00:05:59,1,True,17,26,-9,26,10,1
4,00:03:43,2,False,26,17,9,37,8,1
4,00:01:28,1,True,17,33,-16,24,10,1
1,00:13:37,1,False,0,0,0,34,10,1
1,00:12:59,2,False,0,0,0,35,9,1
1,00:12:09,1,True,0,0,0,24,10,1
1,00:09:39,1,True,0,0,0,34,10,1
1,00:07:15,2,False,0,1,-1,40,5,1
1,00:05:33,1,False,0,1,-1,45,10,1
1,00:04:53,2,False,0,1,-1,42,13,1
1,00:03:28,2,True,1,0,1,2,14,1
1,00:01:12,1,True,1,0,1,44,10,1
1,00:00:01,2,True,1,0,1,39,15,1
2,00:12:36,1,False,0,1,-1,52,10,1
2,00:08:55,2,True,1,0,1,46,8,1
2,00:08:16,1,True,1,0,1,29,10,1
2,00:02:49,1,True,1,3,-2,25,10,1
2,00:01:35,1,False,3,1,2,20,10,1
2,00:01:29,2,False,3,1,2,27,3,1
2,00:00:47,1,False,3,1,2,25,15,1
2,00:00:40,1,True,1,3,-2,45,10,1
3,00:11:05,1,False,6,8,-2,25,10,1
3,00:10:31,2,False,6,8,-2,31,4,1
3,00:09:50,1,False,6,8,-2,36,10,1
3,00:09:11,2,False,6,8,-2,39,7,1
3,00:05:04,1,False,6,8,-2,10,10,1
3,00:04:18,1,True,8,6,2,29,10,1
3,00:03:05,1,True,8,6,2,16,10,1
3,00:01:15,1,True,8,13,-5,34,10,1
3,00:00:01,1,True,8,13,-5,44,10,1
4,00:14:50,1,False,13,8,5,27,10,1
4,00:13:40,2,False,13,8,5,15,10,1
4,00:11:34,1,False,13,11,2,53,10,1
4,00:09:12,1,False,13,14,-1,35,10,1
4,00:08:05,2,True,14,13,1,48,7,1
4,00:07:22,1,True,14,13,1,30,10,1
4,00:03:52,2,True,14,16,-2,36,10,1
4,00:03:12,1,False,16,14,2,53,10,1
4,00:00:49,2,False,16,24,-8,35,10,1
1,00:14:35,2,False,0,0,0,24,10,1
1,00:12:11,1,True,0,0,0,48,10,1
1,00:11:52,1,False,0,0,0,50,10,1
1,00:09:52,1,True,0,0,0,10,10,1
1,00:09:24,2,True,0,0,0,14,6,1
1,00:08:11,2,True,0,0,0,33,3,1
1,00:06:00,2,True,0,0,0,35,4,1
1,00:04:53,2,True,0,0,0,26,6,1
1,00:03:14,2,True,0,0,0,17,8,1
1,00:02:52,1,True,0,7,-7,30,10,1
2,00:11:48,1,False,7,7,0,48,10,1
2,00:02:12,2,False,7,24,-17,54,10,1
2,00:01:27,2,False,7,24,-17,20,10,1
2,00:00:55,1,False,7,31,-24,36,10,1
2,00:00:48,1,False,7,31,-24,50,10,1
3,00:13:08,1,True,31,10,21,46,10,1
3,00:12:05,2,True,31,10,21,24,17,1
3,00:11:14,1,True,31,13,18,35,10,1
3,00:09:56,2,False,13,31,-18,28,10,1
3,00:09:02,2,False,13,31,-18,55,7,1
3,00:08:18,2,True,31,13,18,45,10,1
3,00:04:55,1,True,31,16,15,47,10,1
3,00:04:41,2,True,31,16,15,41,4,1
3,00:03:16,2,True,31,16,15,11,6,1
3,00:02:20,2,True,31,23,8,31,5,1
3,00:01:40,1,True,31,23,8,43,10,1
4,00:15:00,1,False,23,31,-8,16,10,1
4,00:14:39,1,False,23,31,-8,31,10,1
4,00:12:08,1,True,31,24,7,35,10,1
4,00:08:40,2,False,24,34,-10,30,15,1
4,00:06:32,2,False,24,34,-10,39,10,1
4,00:05:03,2,True,34,24,10,39,9,1
4,00:04:07,1,False,24,34,-10,10,10,1
4,00:03:34,2,False,24,34,-10,16,4,1
4,00:02:36,1,False,24,34,-10,35,10,1
4,00:02:27,1,False,24,34,-10,45,10,1
4,00:02:20,2,False,24,34,-10,54,1,1
4,00:02:12,1,True,34,24,10,44,10,1
4,00:01:29,1,True,34,27,7,47,10,1
1,00:14:26,2,False,0,0,0,30,7,1
1,00:12:35,2,False,0,7,-7,33,6,1
1,00:11:21,2,False,0,7,-7,43,12,1
1,00:10:10,1,True,7,0,7,23,10,1
1,00:07:47,2,True,7,0,7,50,8,1
1,00:04:08,2,True,7,0,7,14,9,1
1,00:02:23,2,True,7,7,0,7,10,1
1,00:00:56,2,True,7,7,0,50,10,1
2,00:15:00,2,True,7,7,0,37,7,1
2,00:11:40,2,False,8,7,1,13,6,1
2,00:10:05,2,False,8,7,1,36,5,1
2,00:07:59,2,True,7,8,-1,44,10,1
2,00:02:25,1,True,7,8,-1,38,10,1
2,00:01:30,1,False,8,7,1,14,10,1
2,00:01:22,1,False,8,7,1,25,10,1
2,00:01:16,1,False,8,7,1,36,10,1
3,00:13:55,2,True,7,8,-1,51,5,1
3,00:10:52,1,False,8,7,1,33,10,1
3,00:09:18,2,True,7,8,-1,13,4,1
3,00:08:20,1,True,7,8,-1,9,10,1
3,00:08:02,1,True,7,8,-1,31,10,1
3,00:07:20,2,True,7,8,-1,36,5,1
3,00:03:33,1,True,7,11,-4,35,10,1
3,00:03:16,2,True,7,11,-4,38,7,1
3,00:00:18,2,True,7,11,-4,40,7,1
4,00:13:52,1,False,11,7,4,14,10,1
4,00:10:34,1,True,7,11,-4,4,10,1
4,00:09:15,1,False,11,7,4,45,10,1
4,00:04:04,1,True,7,25,-18,42,10,1
4,00:03:01,1,True,7,25,-18,46,10,1
4,00:01:57,2,True,7,32,-25,35,10,1
4,00:01:47,1,True,7,32,-25,46,10,1
1,00:14:50,1,False,0,0,0,50,10,1
1,00:13:31,2,False,0,0,0,35,6,1
1,00:10:24,1,False,0,10,-10,37,10,1
1,00:09:08,1,False,0,10,-10,50,10,1
1,00:07:55,1,True,10,0,10,54,15,1
1,00:06:35,1,True,10,0,10,18,10,1
1,00:06:00,2,True,10,0,10,23,5,1
1,00:04:43,2,True,10,0,10,53,9,1
1,00:02:17,1,False,0,10,-10,43,10,1
2,00:14:33,1,True,10,3,7,31,10,1
2,00:09:49,2,True,10,3,7,24,10,1
2,00:09:01,1,True,10,3,7,34,10,1
2,00:08:01,1,False,3,10,-7,37,10,1
2,00:06:27,2,False,3,10,-7,18,17,1
2,00:04:53,2,True,13,3,10,38,10,1
2,00:00:44,1,False,6,13,-7,44,10,1
2,00:00:27,1,True,13,6,7,54,15,1
3,00:13:32,2,False,9,13,-4,17,10,1
3,00:11:15,1,False,9,16,-7,47,10,1
3,00:07:29,2,False,12,16,-4,31,15,1
3,00:06:11,2,True,16,12,4,26,18,1
3,00:04:30,2,False,12,16,-4,22,8,1
3,00:03:16,2,False,12,16,-4,42,4,1
3,00:00:00,1,True,16,12,4,1,1,1
4,00:14:34,2,True,16,19,-3,39,10,1
4,00:13:02,1,False,19,16,3,47,10,1
4,00:07:10,2,False,19,16,3,18,22,1
4,00:05:38,2,False,19,16,3,45,7,1
4,00:03:59,2,False,19,16,3,20,6,1
4,00:00:29,1,True,16,20,-4,32,10,1
4,00:00:22,1,True,16,20,-4,43,10,1
4,00:00:11,3,True,16,20,-4,48,5,1
1,00:13:48,1,False,0,0,0,51,10,1
1,00:13:20,1,True,0,0,0,50,15,1
1,00:11:00,2,True,0,3,-3,38,5,1
1,00:06:00,1,False,3,0,3,36,10,1
1,00:04:04,2,False,3,0,3,6,6,1
1,00:01:48,2,False,3,0,3,1,1,1
1,00:01:01,2,False,3,7,-4,35,5,1
2,00:14:23,1,False,3,7,-4,54,10,1
2,00:12:45,2,False,3,8,-5,35,10,1
2,00:11:30,2,True,8,3,5,32,10,1
2,00:10:03,2,True,8,3,5,55,5,1
2,00:06:44,2,False,3,8,-5,8,10,1
2,00:05:36,2,False,3,8,-5,23,6,1
2,00:01:10,1,False,3,8,-5,20,15,1
2,00:00:49,2,False,3,8,-5,25,10,1
2,00:00:30,2,False,3,8,-5,45,2,1
3,00:14:11,2,True,8,3,5,20,10,1
3,00:10:22,2,True,9,3,6,34,6,1
3,00:09:38,1,True,9,3,6,42,10,1
3,00:08:00,2,False,3,9,-6,35,7,1
3,00:05:04,2,True,9,3,6,45,8,1
3,00:03:14,1,False,3,12,-9,35,10,1
3,00:01:55,2,False,3,12,-9,46,7,1
4,00:13:18,1,False,3,13,-10,21,10,1
4,00:11:24,1,True,13,3,10,32,15,1
4,00:09:56,2,True,13,3,10,55,7,1
4,00:08:54,1,False,3,13,-10,30,10,1
4,00:08:38,2,False,3,13,-10,33,7,1
4,00:08:00,1,False,3,13,-10,53,10,1
4,00:07:06,2,True,13,3,10,38,4,1
4,00:06:14,1,True,13,3,10,28,10,1
4,00:04:30,1,False,10,20,-10,48,10,1
4,00:02:09,1,False,10,20,-10,36,10,1
4,00:01:56,1,False,10,20,-10,47,10,1
4,00:00:17,1,False,10,20,-10,44,10,1
4,00:00:10,2,False,10,20,-10,51,3,1
1,00:14:52,1,False,0,0,0,40,10,1
1,00:14:22,2,False,0,0,0,45,5,1
1,00:13:43,1,False,0,0,0,54,10,1
1,00:12:19,2,True,0,0,0,41,5,1
1,00:09:03,0,False,0,0,0,27,0,1
1,00:07:30,1,True,0,7,-7,25,10,1
1,00:03:36,2,True,0,7,-7,20,8,1
1,00:03:04,1,True,0,7,-7,30,10,1
1,00:01:48,1,True,0,7,-7,43,10,1
1,00:01:09,1,True,0,7,-7,55,10,1
2,00:13:22,1,False,7,0,7,10,25,1
2,00:11:14,2,True,2,7,-5,34,10,1
2,00:07:36,1,False,7,4,3,28,10,1
2,00:05:26,2,False,7,11,-4,15,10,1
2,00:03:13,1,False,7,11,-4,53,10,1
2,00:01:50,1,False,7,11,-4,27,10,1
3,00:14:54,1,False,7,14,-7,34,10,1
3,00:13:16,1,False,7,14,-7,43,10,1
3,00:11:25,2,False,7,14,-7,11,6,1
3,00:07:56,2,False,7,21,-14,52,9,1
3,00:07:12,1,True,21,7,14,45,10,1
3,00:05:32,1,True,21,7,14,13,10,1
4,00:13:57,1,True,21,21,0,47,10,1
4,00:06:45,1,True,21,27,-6,51,10,1
4,00:05:33,2,True,21,27,-6,51,10,1
4,00:02:32,1,True,28,30,-2,46,10,1
4,00:00:20,1,False,30,35,-5,31,10,1
4,00:00:15,1,False,30,35,-5,50,10,1
1,00:11:36,1,True,3,1,2,35,10,1
1,00:10:01,2,True,3,1,2,50,6,1
1,00:09:23,1,False,1,3,-2,49,10,1
1,00:07:54,2,False,1,3,-2,9,8,1
1,00:05:22,1,True,10,1,9,13,10,1
1,00:04:21,2,True,10,1,9,15,8,1
1,00:03:38,1,True,10,1,9,41,10,1
1,00:02:01,1,False,3,10,-7,45,10,1
2,00:14:43,2,True,10,3,7,15,6,1
2,00:12:04,2,False,3,10,-7,52,6,1
2,00:11:05,1,True,10,3,7,9,10,1
2,00:10:50,1,True,10,3,7,38,10,1
2,00:09:43,1,True,10,3,7,48,10,1
2,00:08:23,2,True,10,3,7,38,20,1
2,00:06:19,1,True,10,3,7,39,20,1
2,00:05:50,2,True,10,3,7,44,15,1
2,00:05:14,1,False,3,10,-7,27,10,1
2,00:01:40,1,False,3,13,-10,12,10,1
2,00:01:35,2,False,3,13,-10,15,7,1
2,00:00:22,1,True,13,3,10,20,10,1
3,00:11:53,2,False,12,13,-1,51,10,1
3,00:09:46,1,False,12,13,-1,17,10,1
3,00:08:48,2,False,12,13,-1,18,19,1
3,00:07:46,1,True,13,12,1,40,10,1
3,00:07:32,2,True,13,12,1,48,2,1
3,00:04:51,1,True,13,12,1,34,10,1
3,00:04:26,1,True,13,12,1,48,10,1
3,00:02:35,1,False,12,13,-1,40,10,1
4,00:14:50,1,False,12,13,-1,39,10,1
4,00:13:16,1,True,13,12,1,54,10,1
4,00:12:21,1,False,12,13,-1,43,10,1
4,00:10:57,2,False,12,13,-1,27,10,1
4,00:09:26,1,False,12,13,-1,20,10,1
4,00:09:04,1,True,13,12,1,52,10,1
4,00:07:23,1,True,13,12,1,17,10,1
4,00:06:56,1,True,13,12,1,27,10,1
4,00:06:14,2,True,13,12,1,31,6,1
4,00:04:56,2,True,13,12,1,38,10,1
4,00:04:28,1,False,12,13,-1,54,10,1
4,00:02:44,1,False,12,13,-1,12,10,1
4,00:00:27,1,False,12,13,-1,28,10,1
4,00:00:07,1,False,12,13,-1,41,10,1
1,00:14:59,1,True,0,0,0,45,10,1
1,00:14:07,2,True,0,0,0,55,10,1
1,00:11:34,2,False,0,0,0,21,4,1
1,00:10:10,1,False,0,8,-8,35,10,1
1,00:06:18,2,True,8,7,1,27,10,1
1,00:04:45,2,False,7,8,-1,13,5,1
1,00:04:12,1,False,7,8,-1,28,10,1
1,00:02:22,1,True,8,7,1,51,10,1
1,00:00:01,1,False,7,8,-1,8,10,1
2,00:15:00,2,False,7,8,-1,14,4,1
2,00:10:20,2,True,8,7,1,46,11,1
2,00:09:43,1,False,7,8,-1,47,10,1
2,00:08:40,1,False,7,8,-1,27,10,1
2,00:06:16,1,False,7,15,-8,41,10,1
2,00:04:23,2,True,15,7,8,25,4,1
2,00:01:54,1,False,10,15,-5,47,10,1
3,00:14:54,1,True,15,10,5,31,10,1
3,00:14:16,1,True,15,10,5,44,10,1
3,00:13:15,1,False,10,15,-5,52,10,1
3,00:11:47,1,False,10,15,-5,41,10,1
3,00:09:03,1,True,18,10,8,34,10,1
3,00:03:39,2,True,18,10,8,35,7,1
3,00:01:35,1,False,10,18,-8,16,10,1
3,00:00:23,2,True,18,10,8,53,6,1
4,00:15:00,1,True,18,10,8,8,10,1
4,00:14:18,1,True,18,10,8,28,10,1
4,00:14:00,1,True,18,10,8,44,10,1
4,00:11:04,2,False,10,18,-8,33,10,1
4,00:08:31,2,False,10,25,-15,33,10,1
4,00:07:50,1,False,10,25,-15,45,10,1
4,00:07:16,2,True,25,10,15,43,10,1
4,00:02:21,1,False,13,28,-15,35,10,1
4,00:02:13,1,False,13,28,-15,46,10,1
4,00:01:43,1,True,28,13,15,39,10,1
1,00:14:17,2,True,0,0,0,50,10,1
1,00:13:33,2,False,0,0,0,34,10,1
1,00:12:22,1,False,0,3,-3,40,5,1
1,00:07:37,2,False,0,3,-3,38,6,1
1,00:06:08,1,True,3,0,3,40,10,1
1,00:04:12,1,False,0,3,-3,22,10,1
1,00:02:19,1,True,3,0,3,33,10,1
1,00:01:46,2,True,3,0,3,35,8,1
1,00:01:08,1,True,3,0,3,48,10,1
2,00:13:59,2,False,0,3,-3,9,19,1
2,00:11:06,1,True,3,0,3,39,10,1
2,00:09:22,1,True,3,3,0,35,10,1
2,00:09:00,1,True,3,3,0,50,10,1
2,00:07:13,2,False,3,3,0,51,14,1
2,00:06:33,3,False,3,3,0,42,5,1
2,00:05:03,1,False,3,3,0,21,5,1
2,00:03:00,2,True,5,3,2,42,10,1
2,00:02:33,1,True,5,3,2,53,10,1
2,00:01:39,1,False,3,5,-2,25,10,1
2,00:01:31,1,False,3,5,-2,45,10,1
2,00:00:41,1,True,5,3,2,41,10,1
2,00:00:17,2,True,5,3,2,38,7,1
3,00:14:05,2,False,6,5,1,37,11,1
3,00:12:43,2,True,5,6,-1,18,23,1
3,00:11:46,1,False,6,5,1,45,10,1
3,00:10:15,2,True,5,6,-1,25,9,1
3,00:08:57,2,True,5,6,-1,39,8,1
3,00:07:36,1,False,6,5,1,44,15,1
3,00:06:28,1,True,5,6,-1,51,10,1
3,00:04:41,1,True,5,7,-2,35,10,1
3,00:01:31,2,True,5,7,-2,33,18,1
4,00:09:46,2,False,7,5,2,25,19,1
4,00:08:40,1,False,7,5,2,51,10,1
4,00:08:08,2,False,7,5,2,45,4,1
4,00:07:05,2,False,7,5,2,37,6,1
4,00:04:20,2,False,7,5,2,26,10,1
4,00:02:25,2,False,7,5,2,34,12,1
4,00:01:53,2,True,5,7,-2,51,14,1
1,00:13:43,1,False,0,0,0,35,10,1
1,00:11:38,2,True,0,0,0,14,10,1
1,00:10:23,1,True,0,0,0,48,10,1
1,00:09:39,2,False,0,0,0,49,8,1
1,00:05:38,2,True,0,3,-3,17,20,1
1,00:04:07,2,True,0,3,-3,51,10,1
1,00:02:58,1,True,0,3,-3,14,10,1
1,00:02:40,2,True,0,3,-3,18,6,1
1,00:01:58,1,True,0,3,-3,15,20,1
1,00:01:10,2,True,0,3,-3,19,16,1
2,00:14:23,1,True,0,3,-3,20,10,1
2,00:10:24,2,True,0,3,-3,28,20,1
2,00:09:44,1,True,0,3,-3,54,10,1
2,00:08:12,2,False,3,0,3,26,10,1
2,00:07:55,1,False,3,7,-4,50,10,1
2,00:05:37,1,True,7,3,4,30,10,1
2,00:03:00,1,True,7,10,-3,39,10,1
2,00:02:22,1,True,7,17,-10,25,10,1
2,00:02:15,1,True,7,17,-10,39,10,1
2,00:01:54,2,True,7,17,-10,41,8,1
2,00:01:20,2,False,17,7,10,27,10,1
2,00:00:52,1,False,17,7,10,48,10,1
2,00:00:45,2,False,17,7,10,39,1,1
2,00:00:35,1,False,17,7,10,31,10,1
2,00:00:19,2,False,17,7,10,19,10,1
3,00:13:54,2,False,17,10,7,42,6,1
3,00:10:44,1,True,10,17,-7,11,10,1
3,00:08:50,2,False,24,10,14,26,4,1
3,00:07:00,2,False,24,10,14,50,7,1
3,00:06:14,1,True,10,24,-14,52,10,1
3,00:01:20,2,False,31,10,21,13,11,1
3,00:00:05,1,False,31,10,21,50,10,1
4,00:10:48,1,True,13,31,-18,48,10,1
4,00:06:41,2,True,13,34,-21,35,10,1
4,00:04:47,3,False,34,13,21,21,10,1
4,00:02:50,1,False,34,20,14,40,10,1
4,00:02:28,1,False,34,27,7,31,10,1
4,00:01:23,1,True,27,41,-14,50,10,1
4,00:00:55,3,False,41,27,14,51,1,1
4,00:00:38,1,False,41,27,14,46,10,1
4,00:00:21,1,False,41,27,14,24,10,1
1,00:12:31,1,False,0,7,-7,32,10,1
1,00:12:03,1,False,0,7,-7,55,10,1
1,00:09:39,2,False,0,7,-7,54,5,1
1,00:08:17,2,True,7,0,7,54,16,1
1,00:06:24,1,True,7,10,-3,27,10,1
1,00:04:42,2,True,7,10,-3,52,7,1
1,00:04:01,1,True,7,10,-3,38,10,1
1,00:03:15,1,True,7,10,-3,21,5,1
1,00:01:05,2,True,7,10,-3,17,12,1
1,00:00:00,2,True,7,10,-3,3,3,1
2,00:14:33,2,True,7,17,-10,25,10,1
2,00:13:21,2,True,7,17,-10,50,7,1
2,00:07:54,2,True,7,17,-10,26,9,1
2,00:06:28,2,True,7,17,-10,26,20,1
2,00:05:40,1,False,17,7,10,47,10,1
2,00:05:08,2,False,17,7,10,50,7,1
2,00:03:24,2,False,17,7,10,51,20,1
2,00:02:43,2,True,7,17,-10,12,1,1
2,00:02:03,1,True,7,20,-13,35,10,1
2,00:01:58,2,True,7,20,-13,41,4,1
2,00:01:28,1,False,20,7,13,34,10,1
2,00:01:20,1,False,20,7,13,50,10,1
2,00:00:40,2,True,7,20,-13,51,11,1
3,00:14:53,1,True,7,21,-14,37,10,1
3,00:13:51,1,False,21,7,14,34,10,1
3,00:12:57,1,False,21,10,11,35,10,1
3,00:12:25,2,False,21,10,11,40,5,1
3,00:10:34,1,True,10,21,-11,51,10,1
3,00:08:03,1,True,10,24,-14,36,10,1
3,00:06:53,1,False,24,10,14,34,10,1
3,00:03:23,2,False,24,17,7,40,11,1
3,00:02:49,1,True,17,24,-7,12,10,1
3,00:01:38,2,True,17,24,-7,49,5,1
3,00:01:02,1,False,24,17,7,53,10,1
3,00:00:00,1,False,24,17,7,10,10,1
4,00:12:13,1,True,31,24,7,17,10,1
4,00:08:55,1,True,31,24,7,36,10,1
4,00:06:34,2,False,24,31,-7,35,5,1
4,00:04:34,2,False,24,31,-7,43,13,1
4,00:03:28,1,False,24,31,-7,13,10,1
4,00:02:49,1,False,24,38,-14,37,10,1
4,00:02:43,2,False,24,38,-14,42,5,1
4,00:02:07,2,False,24,38,-14,43,15,1
4,00:02:01,3,False,24,38,-14,44,14,1
4,00:01:20,3,True,38,24,14,38,10,1
4,00:00:12,1,True,38,24,14,2,2,1
1,00:14:53,1,True,0,0,0,40,10,1
1,00:12:11,2,False,0,0,0,7,4,1
1,00:11:36,1,False,0,0,0,14,10,1
1,00:09:28,1,False,0,0,0,48,10,1
1,00:08:46,2,False,0,0,0,54,4,1
1,00:05:26,1,True,0,1,-1,30,10,1
1,00:04:43,2,True,0,1,-1,30,10,1
1,00:03:15,2,False,1,0,1,40,7,1
1,00:02:34,1,False,1,0,1,25,10,1
1,00:01:48,1,False,1,7,-6,25,10,1
1,00:01:14,2,False,1,7,-6,28,7,1
2,00:13:43,2,True,7,8,-1,20,7,1
2,00:13:05,1,True,7,8,-1,28,10,1
2,00:12:18,1,False,8,7,1,35,10,1
2,00:05:27,2,True,8,10,-2,29,6,1
2,00:01:19,2,True,8,20,-12,20,20,1
2,00:00:17,1,True,8,27,-19,21,10,1
2,00:00:01,2,True,8,27,-19,28,3,1
3,00:14:18,1,False,27,8,19,43,10,1
3,00:13:42,2,False,27,8,19,40,7,1
3,00:12:58,1,False,27,8,19,19,10,1
3,00:12:07,2,False,27,8,19,14,5,1
3,00:09:22,2,False,27,15,12,26,10,1
3,00:05:55,1,True,15,30,-15,33,10,1
4,00:14:03,2,True,16,30,-14,34,10,1
4,00:11:54,1,True,16,30,-14,37,10,1
4,00:08:11,1,True,17,30,-13,18,10,1
4,00:05:03,1,True,17,30,-13,25,10,1
4,00:04:23,1,True,17,30,-13,39,10,1
4,00:03:12,2,True,17,30,-13,51,11,1
4,00:03:00,1,False,30,17,13,44,10,1
4,00:02:50,2,False,30,17,13,38,4,1
4,00:02:27,2,False,30,17,13,29,8,1
4,00:00:49,1,True,24,30,-6,35,10,1
1,00:13:45,1,True,0,0,0,26,10,1
1,00:11:23,1,True,0,0,0,28,10,1
1,00:10:34,2,True,0,0,0,39,10,1
2,00:14:53,1,False,0,5,-5,43,10,1
2,00:12:14,2,True,5,0,5,47,17,1
2,00:10:17,1,True,5,3,2,48,10,1
2,00:08:22,1,False,3,5,-2,36,10,1
2,00:07:43,2,False,3,5,-2,31,5,1
2,00:06:21,2,False,3,5,-2,29,15,1
2,00:03:51,2,False,3,6,-3,44,10,1
2,00:02:49,1,False,3,6,-3,33,10,1
2,00:02:30,2,True,6,3,3,54,7,1
2,00:02:09,1,True,6,3,3,46,10,1
2,00:01:44,2,False,3,6,-3,52,22,1
2,00:00:41,1,True,6,3,3,34,10,1
3,00:14:56,1,True,6,6,0,39,10,1
3,00:14:24,2,True,6,6,0,45,4,1
3,00:13:46,1,False,6,6,0,11,10,1
3,00:08:32,1,False,6,9,-3,45,10,1
3,00:07:40,1,True,9,6,3,48,10,1
3,00:05:05,1,True,9,9,0,35,10,1
3,00:02:56,2,True,9,9,0,54,6,1
3,00:00:16,1,False,9,12,-3,35,10,1
4,00:14:45,1,False,9,12,-3,46,10,1
4,00:14:19,1,True,12,16,-4,39,10,1
4,00:13:03,2,False,16,12,4,7,7,1
4,00:10:59,1,False,16,19,-3,49,10,1
4,00:09:55,1,False,16,19,-3,26,10,1
4,00:06:51,1,False,16,26,-10,25,10,1
4,00:05:55,2,False,16,26,-10,36,10,1
4,00:04:59,1,True,26,16,10,35,10,1
4,00:04:01,2,True,26,16,10,55,7,1
4,00:02:41,1,False,16,26,-10,23,10,1
4,00:01:20,2,False,16,33,-17,45,6,1
4,00:01:12,1,False,16,33,-17,53,10,1
1,00:14:43,1,False,0,0,0,29,10,1
1,00:13:44,1,False,0,3,-3,35,10,1
1,00:12:29,1,False,0,3,-3,48,10,1
1,00:12:10,1,True,3,0,3,26,10,1
1,00:10:53,1,True,3,0,3,15,10,1
1,00:10:34,1,True,3,7,-4,25,10,1
1,00:09:07,1,False,7,3,4,21,10,1
1,00:08:44,1,True,3,7,-4,50,10,1
1,00:08:03,1,True,3,7,-4,35,10,1
1,00:07:06,1,True,3,7,-4,24,10,1
1,00:05:55,1,True,3,7,-4,11,10,1
1,00:04:58,2,True,3,15,-12,41,4,1
1,00:03:17,2,False,15,3,12,44,10,1
2,00:14:01,2,False,15,3,12,30,20,1
2,00:12:21,1,True,3,15,-12,38,10,1
2,00:11:41,2,True,3,15,-12,44,4,1
2,00:11:04,1,True,3,15,-12,19,10,1
2,00:09:13,2,True,3,15,-12,2,2,1
2,00:07:46,1,True,3,22,-19,40,10,1
2,00:06:25,1,True,3,22,-19,38,10,1
2,00:04:44,2,True,3,22,-19,27,10,1
2,00:03:55,1,True,3,29,-26,19,20,1
2,00:03:33,2,True,3,29,-26,26,13,1
2,00:02:29,2,False,29,3,26,26,11,1
2,00:01:34,1,False,29,3,26,51,10,1
2,00:00:47,2,False,29,3,26,20,5,1
2,00:00:38,1,False,29,3,26,12,10,1
3,00:14:20,2,True,10,29,-19,8,9,1
3,00:13:30,1,False,29,10,19,34,10,1
3,00:12:58,2,False,29,10,19,40,4,1
3,00:12:20,1,False,29,10,19,52,10,1
3,00:06:41,1,False,32,18,14,30,10,1
3,00:05:07,1,False,32,18,14,14,10,1
3,00:04:50,1,False,32,25,7,19,10,1
3,00:03:44,1,False,32,25,7,29,10,1
3,00:02:20,1,True,25,32,-7,34,10,1
3,00:00:01,1,False,32,25,7,40,10,1
4,00:15:00,2,False,32,25,7,44,6,1
4,00:14:30,1,False,32,25,7,51,10,1
4,00:13:20,1,True,25,32,-7,46,10,1
4,00:12:47,2,True,25,32,-7,46,10,1
4,00:11:53,1,True,25,33,-8,35,10,1
4,00:10:12,2,False,33,25,8,35,6,1
4,00:07:45,2,True,25,33,-8,55,8,1
4,00:05:55,2,False,33,25,8,21,6,1
4,00:05:03,1,False,33,25,8,15,10,1
4,00:04:09,2,False,33,33,0,16,27,1
4,00:03:20,1,False,33,33,0,52,10,1
4,00:03:00,1,False,33,33,0,37,10,1
4,00:01:48,1,False,33,33,0,25,20,1
4,00:01:38,1,False,33,40,-7,41,10,1
4,00:01:25,1,False,33,40,-7,54,10,1
4,00:00:56,2,False,33,40,-7,52,12,1
4,00:00:39,1,True,40,33,7,42,10,1
1,00:14:51,1,False,0,0,0,45,10,1
1,00:14:12,2,False,0,0,0,48,7,1
1,00:13:32,1,True,0,0,0,49,10,1
1,00:10:45,1,True,0,0,0,23,10,1
1,00:09:31,1,True,0,0,0,34,10,1
1,00:07:47,1,False,0,0,0,41,10,1
1,00:06:36,2,True,0,0,0,40,3,1
1,00:04:35,1,True,0,0,0,25,10,1
1,00:02:01,1,True,0,3,-3,34,10,1
2,00:14:32,1,True,3,3,0,44,10,1
2,00:13:15,2,False,3,3,0,40,3,1
2,00:13:00,1,False,3,3,0,33,10,1
2,00:11:56,2,False,3,3,0,29,19,1
2,00:09:35,1,False,3,6,-3,36,10,1
2,00:08:27,2,False,3,6,-3,29,17,1
2,00:06:52,2,True,6,3,3,37,5,1
2,00:05:30,2,True,6,3,3,51,11,1
2,00:02:35,1,True,8,3,5,39,10,1
2,00:02:29,1,False,3,8,-5,27,10,1
2,00:02:05,1,False,3,8,-5,16,10,1
2,00:01:22,2,False,3,8,-5,16,10,1
2,00:00:45,2,False,3,8,-5,4,4,1
2,00:00:37,1,False,3,15,-12,40,10,1
3,00:14:33,2,True,15,3,12,50,10,1
3,00:13:12,1,False,3,15,-12,21,10,1
3,00:12:31,2,False,3,15,-12,22,9,1
3,00:08:44,1,True,15,6,9,35,10,1
3,00:07:59,1,False,6,15,-9,52,10,1
3,00:07:20,2,False,6,15,-9,52,10,1
3,00:05:10,1,False,6,16,-10,38,10,1
3,00:03:40,2,True,16,6,10,53,5,1
4,00:11:38,2,True,16,9,7,39,6,1
4,00:07:27,2,False,9,19,-10,34,11,1
4,00:05:35,1,False,9,19,-10,16,10,1
4,00:03:10,2,False,9,19,-10,30,3,1
1,00:14:55,1,True,0,0,0,37,10,1
1,00:14:16,2,True,0,0,0,41,6,1
1,00:13:39,1,True,0,0,0,50,10,1
1,00:10:13,1,True,3,0,3,37,10,1
1,00:09:48,1,True,3,0,3,48,10,1
1,00:07:12,1,False,0,6,-6,48,10,1
1,00:05:29,1,True,6,0,6,51,10,1
1,00:04:08,1,True,6,0,6,14,10,1
1,00:03:49,2,True,6,0,6,22,2,1
1,00:02:45,2,True,6,0,6,19,18,1
1,00:00:03,1,False,0,6,-6,44,10,1
2,00:13:46,2,False,0,6,-6,14,8,1
2,00:12:50,2,False,0,13,-13,30,18,1
2,00:11:11,2,True,13,0,13,33,3,1
2,00:08:52,1,True,13,0,13,15,10,1
2,00:07:53,1,False,0,13,-13,52,10,1
2,00:02:59,1,True,13,3,10,35,10,1
2,00:01:36,1,False,3,13,-10,49,10,1
2,00:01:10,2,False,3,13,-10,40,1,1
2,00:00:52,1,False,3,13,-10,29,10,1
2,00:00:14,2,False,3,13,-10,21,17,1
3,00:13:28,1,False,3,13,-10,53,10,1
3,00:11:08,2,False,3,13,-10,54,22,1
3,00:10:06,1,False,3,13,-10,25,10,1
3,00:09:04,2,False,3,13,-10,17,18,1
3,00:04:57,1,True,20,3,17,46,10,1
3,00:03:26,1,False,3,20,-17,40,10,1
4,00:12:49,1,True,20,3,17,26,10,1
4,00:12:12,2,True,20,3,17,32,4,1
4,00:11:16,2,True,20,3,17,50,10,1
4,00:08:30,1,True,20,3,17,25,10,1
4,00:07:46,1,True,20,3,17,36,10,1
4,00:05:32,1,False,3,20,-17,49,10,1
4,00:04:45,1,False,3,20,-17,20,10,1
4,00:03:47,2,False,3,20,-17,14,4,1
4,00:03:22,1,False,3,27,-24,15,10,1
4,00:01:04,1,False,3,28,-25,33,10,1
4,00:00:42,2,False,3,28,-25,43,0,1
4,00:00:06,3,False,3,28,-25,50,10,1
1,00:12:46,1,False,0,0,0,6,10,1
1,00:12:08,1,False,0,0,0,36,10,1
1,00:10:04,1,True,0,1,-1,35,10,1
1,00:08:32,2,False,1,0,1,44,10,1
1,00:07:48,1,True,0,1,-1,54,10,1
1,00:07:11,2,True,0,1,-1,51,7,1
1,00:05:30,2,True,0,4,-4,37,8,1
2,00:15:00,2,True,0,4,-4,45,4,1
2,00:14:13,1,True,0,4,-4,30,10,1
2,00:13:01,2,True,0,11,-11,45,7,1
2,00:10:57,1,False,11,1,10,35,10,1
2,00:10:41,1,False,11,1,10,55,10,1
2,00:09:27,1,True,1,11,-10,38,10,1
2,00:08:58,1,True,1,18,-17,51,10,1
2,00:07:50,2,False,18,1,17,40,7,1
2,00:06:33,2,False,18,1,17,20,10,1
2,00:06:09,1,False,18,8,10,22,10,1
2,00:05:46,2,False,18,8,10,30,2,1
2,00:04:24,2,False,18,8,10,42,6,1
2,00:03:16,1,True,8,18,-10,22,10,1
2,00:02:40,2,True,8,18,-10,42,5,1
2,00:02:21,1,False,18,8,10,43,10,1
2,00:01:25,1,False,18,9,9,35,10,1
2,00:01:08,1,False,18,9,9,50,10,1
3,00:14:52,1,False,21,9,12,39,10,1
3,00:11:43,2,False,21,9,12,29,10,1
3,00:04:40,2,True,9,28,-19,35,13,1
3,00:03:28,1,False,28,9,19,34,10,1
3,00:02:52,2,False,28,9,19,37,7,1
3,00:00:32,1,True,9,28,-19,52,10,1
3,00:00:02,2,True,9,28,-19,48,6,1
4,00:14:31,1,True,9,28,-19,2,10,1
4,00:09:49,1,True,9,30,-21,50,10,1
4,00:09:23,2,False,30,9,21,35,10,1
4,00:08:53,2,False,30,9,21,18,10,1
4,00:07:57,3,False,30,9,21,13,5,1
4,00:07:00,2,False,30,16,14,36,8,1
4,00:05:33,2,True,16,30,-14,42,7,1
4,00:04:21,1,True,16,33,-17,35,10,1
4,00:03:54,2,True,16,33,-17,40,5,1
4,00:03:21,1,False,33,16,17,54,10,1
4,00:02:59,1,False,33,16,17,44,10,1
4,00:02:50,2,False,33,16,17,38,4,1
4,00:02:30,3,False,33,16,17,13,10,1
4,00:00:49,1,True,23,40,-17,27,10,1
4,00:00:41,1,True,23,40,-17,44,10,1
1,00:14:54,1,True,0,0,0,15,10,1
1,00:12:20,2,False,0,0,0,45,8,1
1,00:11:45,1,True,0,0,0,52,10,1
1,00:11:28,2,True,0,0,0,53,11,1
1,00:08:37,1,True,0,0,0,15,10,1
1,00:08:06,2,True,0,0,0,13,12,1
1,00:07:36,1,True,0,0,0,47,10,1
1,00:05:35,1,False,0,0,0,22,10,1
1,00:04:36,1,True,0,0,0,48,10,1
1,00:01:11,1,False,0,0,0,51,5,1
1,00:00:41,1,False,0,0,0,20,10,1
1,00:00:03,2,False,0,0,0,14,4,1
2,00:11:57,1,True,3,1,2,35,10,1
2,00:11:38,2,True,3,1,2,37,8,1
2,00:09:31,1,True,3,1,2,19,10,1
2,00:07:31,1,False,1,3,-2,41,10,1
2,00:06:39,1,True,3,1,2,53,10,1
2,00:04:58,1,False,1,3,-2,18,10,1
2,00:02:40,2,True,3,1,2,4,4,1
2,00:02:10,1,True,3,15,-12,40,10,1
2,00:01:06,2,False,15,3,12,28,10,1
3,00:14:54,1,False,15,3,12,50,10,1
3,00:12:40,1,False,15,3,12,19,10,1
3,00:11:10,1,False,15,6,9,35,10,1
3,00:10:55,2,False,15,6,9,40,5,1
3,00:09:52,2,False,15,6,9,50,11,1
3,00:06:36,1,True,6,15,-9,49,10,1
3,00:02:35,1,True,7,15,-8,40,15,1
3,00:02:22,1,False,15,7,8,54,10,1
3,00:01:31,2,False,15,7,8,41,10,1
3,00:00:33,1,False,15,10,5,35,10,1
3,00:00:17,2,False,15,10,5,37,8,1
4,00:14:19,1,False,15,10,5,40,10,1
4,00:13:54,1,False,15,10,5,26,10,1
4,00:12:39,1,False,15,10,5,19,15,1
4,00:11:25,1,False,15,17,-2,35,10,1
4,00:06:23,1,False,15,17,-2,41,10,1
4,00:06:11,2,False,15,17,-2,47,4,1
4,00:04:56,1,True,17,16,1,35,10,1
4,00:04:32,1,True,17,16,1,53,10,1
4,00:02:40,1,False,16,17,-1,44,10,1
4,00:01:34,1,False,16,25,-9,20,10,1
4,00:01:11,2,False,16,25,-9,30,10,1
4,00:00:58,2,False,16,25,-9,41,10,1
4,00:00:53,3,False,16,25,-9,49,2,1
4,00:00:29,2,True,25,16,9,53,10,1
4,00:00:06,1,True,25,16,9,29,10,1
1,00:14:32,1,False,0,0,0,34,15,1
1,00:14:25,1,False,0,0,0,54,10,1
1,00:10:29,1,True,0,0,0,19,10,1
1,00:08:23,2,False,0,0,0,53,10,1
1,00:07:15,2,True,0,0,0,22,7,1
1,00:03:15,1,True,0,0,0,32,10,1
1,00:01:45,2,True,0,0,0,48,6,1
1,00:00:26,2,False,0,0,0,52,9,1
2,00:15:00,2,False,0,0,0,25,10,1
2,00:11:29,2,True,7,0,7,46,1,1
2,00:10:27,2,True,7,0,7,55,15,1
2,00:09:26,2,False,0,8,-8,35,10,1
2,00:08:02,1,True,8,1,7,35,10,1
2,00:06:25,1,True,8,1,7,46,10,1
2,00:04:38,2,False,1,8,-7,17,6,1
2,00:02:41,2,True,15,1,14,33,8,1
2,00:01:40,1,True,15,1,14,13,10,1
3,00:12:30,2,True,15,8,7,45,6,1
3,00:10:10,2,True,15,15,0,50,5,1
3,00:07:21,2,False,15,15,0,33,10,1
3,00:06:19,2,True,15,15,0,45,10,1
3,00:04:25,1,False,15,15,0,43,10,1
3,00:03:50,1,False,15,15,0,30,10,1
3,00:01:43,2,False,15,15,0,17,8,1
4,00:14:05,2,False,15,18,-3,41,6,1
4,00:13:14,1,False,15,18,-3,21,10,1
4,00:11:39,1,False,15,18,-3,10,10,1
4,00:11:15,1,False,15,25,-10,32,10,1
4,00:08:40,1,False,15,25,-10,29,10,1
4,00:07:53,1,False,15,28,-13,35,10,1
4,00:05:02,1,False,15,28,-13,30,10,1
4,00:03:35,2,False,15,28,-13,39,6,1
4,00:02:31,2,False,15,31,-16,35,15,1
4,00:01:25,1,False,15,31,-16,22,10,1
4,00:01:02,2,False,15,31,-16,35,10,1
1,00:14:18,2,False,0,0,0,30,5,1
1,00:13:05,2,False,0,0,0,42,7,1
1,00:09:07,1,True,0,0,0,39,10,1
1,00:07:38,2,True,0,7,-7,27,7,1
1,00:06:32,2,True,0,7,-7,37,7,1
1,00:01:15,2,True,3,7,-4,29,9,1
1,00:00:01,2,False,7,3,4,50,10,1
2,00:12:18,1,False,8,3,5,30,10,1
2,00:12:03,1,True,3,8,-5,50,10,1
2,00:11:40,2,True,3,8,-5,45,5,1
2,00:10:56,1,True,3,8,-5,39,10,1
2,00:09:44,2,True,3,8,-5,29,10,1
2,00:08:35,1,True,3,8,-5,18,10,1
2,00:06:06,2,True,3,8,-5,12,12,1
2,00:02:41,1,False,15,10,5,30,10,1
2,00:02:16,2,False,15,10,5,45,10,1
2,00:01:44,1,True,10,15,-5,18,10,1
2,00:01:37,2,True,10,15,-5,18,10,1
2,00:00:36,2,True,10,15,-5,21,10,1
2,00:00:20,1,True,10,15,-5,8,8,1
3,00:14:13,2,True,10,22,-12,36,10,1
3,00:13:09,1,False,22,10,12,38,10,1
3,00:11:44,1,False,22,10,12,18,10,1
3,00:11:27,1,False,22,17,5,44,10,1
3,00:11:01,1,False,22,17,5,55,10,1
3,00:07:49,1,True,17,22,-5,14,10,1
3,00:05:54,2,False,29,17,12,1,10,1
3,00:04:47,2,False,29,17,12,25,10,1
3,00:03:43,1,False,29,17,12,50,10,1
3,00:02:45,1,False,29,17,12,50,20,1
4,00:14:03,2,True,17,29,-12,50,9,1
4,00:13:10,2,False,29,24,5,37,7,1
4,00:11:24,1,True,24,29,-5,13,10,1
4,00:09:51,2,True,24,29,-5,36,17,1
4,00:05:50,2,True,24,29,-5,19,10,1
4,00:05:12,1,True,24,29,-5,35,10,1
4,00:01:53,1,True,24,32,-8,35,10,1
4,00:01:45,1,True,24,32,-8,45,10,1
4,00:01:23,2,False,32,24,8,47,10,1
5,00:00:00,2,False,32,32,0,35,10,1
5,00:00:00,2,False,32,35,-3,43,18,1
1,00:13:52,1,False,0,0,0,22,10,1
1,00:11:38,1,True,0,0,0,25,10,1
1,00:10:10,2,True,0,0,0,42,6,1
1,00:08:25,2,False,0,0,0,11,6,1
1,00:07:21,2,False,0,0,0,25,12,1
1,00:06:04,1,False,0,0,0,26,10,1
1,00:00:53,1,False,0,0,0,16,10,1
2,00:13:09,1,False,0,0,0,41,10,1
2,00:10:47,1,True,0,7,-7,34,10,1
2,00:10:00,2,True,0,7,-7,49,5,1
2,00:07:17,1,True,0,7,-7,44,10,1
2,00:04:56,1,True,0,10,-10,29,10,1
2,00:03:51,2,True,0,10,-10,42,8,1
2,00:03:00,1,True,0,10,-10,51,10,1
2,00:02:34,1,False,10,0,10,44,10,1
2,00:02:03,1,False,10,0,10,33,10,1
2,00:01:15,2,False,10,0,10,44,21,1
3,00:14:25,2,False,10,7,3,45,10,1
3,00:10:50,2,False,11,7,4,27,8,1
3,00:10:00,1,False,11,7,4,41,20,1
3,00:06:09,1,True,7,12,-5,50,10,1
3,00:05:49,2,True,7,12,-5,55,5,1
3,00:02:28,2,False,12,7,5,36,4,1
3,00:01:58,1,False,12,7,5,52,10,1
3,00:01:30,1,True,7,12,-5,45,10,1
4,00:13:37,2,True,7,12,-5,9,10,1
4,00:13:31,1,True,7,12,-5,27,10,1
4,00:12:53,1,True,7,12,-5,37,10,1
4,00:10:17,1,False,12,7,5,50,10,1
4,00:06:07,1,True,7,15,-8,35,10,1
4,00:04:37,2,False,15,7,8,35,8,1
4,00:02:49,2,False,15,7,8,50,5,1
4,00:01:23,1,True,7,15,-8,20,10,1
4,00:01:16,2,True,7,15,-8,23,7,1
4,00:00:44,2,True,7,15,-8,43,10,1
4,00:00:24,1,False,15,7,8,43,10,1
4,00:00:13,1,False,15,7,8,21,10,1
1,00:14:33,2,True,0,0,0,35,10,1
1,00:13:05,2,False,0,0,0,28,10,1
1,00:11:07,2,False,0,7,-7,39,10,1
1,00:09:53,1,True,7,0,7,13,20,1
1,00:08:15,2,True,7,0,7,34,10,1
1,00:07:27,1,True,7,0,7,48,15,1
1,00:05:47,2,False,0,7,-7,39,2,1
1,00:05:12,1,False,0,7,-7,35,10,1
2,00:10:33,1,False,0,13,-13,39,10,1
2,00:08:17,2,True,13,0,13,26,10,1
2,00:06:04,2,False,0,13,-13,53,7,1
2,00:03:46,2,False,0,13,-13,47,11,1
2,00:02:33,2,False,0,14,-14,33,10,1
2,00:01:05,2,False,0,14,-14,49,15,1
3,00:12:10,1,True,14,0,14,54,10,1
3,00:08:41,2,True,17,0,17,10,10,1
3,00:03:05,2,True,17,0,17,30,17,1
3,00:02:25,1,False,0,17,-17,42,10,1
4,00:14:37,1,False,0,17,-17,52,10,1
4,00:11:45,1,True,17,0,17,28,10,1
4,00:09:21,1,False,0,17,-17,39,10,1
4,00:07:59,1,False,0,17,-17,51,10,1
4,00:06:24,1,True,17,0,17,11,10,1
4,00:05:14,1,False,0,17,-17,50,10,1
4,00:01:22,1,False,0,17,-17,41,10,1
4,00:00:52,1,False,0,17,-17,10,10,1
1,00:14:56,1,False,0,0,0,33,10,1
1,00:14:04,2,False,0,0,0,40,3,1
1,00:09:00,1,True,0,3,-3,17,10,1
1,00:08:31,2,True,0,3,-3,22,5,1
1,00:07:52,1,True,0,3,-3,40,10,1
1,00:04:36,2,True,0,3,-3,40,7,1
1,00:02:40,1,False,3,0,3,43,10,1
1,00:01:02,2,True,0,3,-3,27,17,1
1,00:00:35,1,False,3,0,3,52,10,1
1,00:00:01,2,False,3,0,3,48,6,1
2,00:13:30,2,True,2,3,-1,41,10,1
2,00:12:31,1,True,2,3,-1,49,20,1
2,00:09:19,1,True,2,10,-8,32,10,1
2,00:03:50,1,False,10,5,5,50,10,1
2,00:03:13,2,False,10,5,5,47,13,1
2,00:02:34,1,True,5,10,-5,28,10,1
2,00:01:54,1,False,10,5,5,38,10,1
2,00:01:11,2,False,10,5,5,50,10,1
3,00:14:49,1,True,5,10,-5,45,10,1
3,00:13:37,0,False,10,5,5,42,0,1
3,00:11:08,1,False,13,5,8,54,10,1
3,00:09:31,1,True,5,13,-8,35,10,1
3,00:07:39,2,True,5,13,-8,36,24,1
3,00:04:40,1,True,5,13,-8,47,10,1
3,00:02:57,1,True,5,13,-8,14,10,1
3,00:01:49,1,True,5,13,-8,27,10,1
3,00:01:10,1,True,5,13,-8,40,10,1
4,00:15:00,1,False,13,5,8,32,10,1
4,00:14:34,2,False,13,5,8,34,8,1
4,00:13:56,1,False,13,5,8,43,10,1
4,00:13:18,2,False,13,5,8,50,3,1
4,00:12:02,2,True,5,13,-8,47,5,1
4,00:08:20,1,True,5,16,-11,44,10,1
4,00:07:41,2,True,5,16,-11,50,4,1
4,00:06:39,1,False,16,5,11,25,10,1
4,00:05:52,1,False,16,5,11,6,6,1
4,00:05:25,1,False,16,11,5,9,10,1
4,00:04:07,1,False,16,11,5,25,10,1
4,00:03:22,2,False,16,11,5,26,9,1
4,00:02:04,1,True,11,16,-5,23,10,1
4,00:01:48,1,True,11,16,-5,42,10,1
4,00:01:39,1,True,11,16,-5,55,10,1
4,00:01:31,1,False,16,11,5,41,10,1
4,00:01:11,1,False,16,11,5,30,10,1
4,00:00:54,1,False,16,11,5,15,10,1
4,00:00:34,3,False,16,11,5,11,6,1
1,00:14:54,1,False,0,0,0,33,10,1
1,00:14:19,2,False,0,0,0,39,4,1
1,00:13:27,2,False,0,0,0,51,4,1
1,00:11:40,1,True,0,0,0,30,10,1
1,00:11:21,2,True,0,0,0,25,5,1
1,00:05:52,2,False,7,0,7,37,5,1
1,00:04:00,2,True,0,7,-7,53,11,1
1,00:02:53,2,False,7,0,7,32,10,1
2,00:12:12,1,True,0,7,-7,44,10,1
2,00:09:29,2,False,7,0,7,49,7,1
2,00:05:58,2,False,7,3,4,35,10,1
2,00:02:24,2,False,7,3,4,23,4,1
3,00:14:54,1,True,3,7,-4,32,10,1
3,00:09:58,1,True,5,7,-2,41,10,1
3,00:09:36,1,False,7,5,2,53,10,1
3,00:08:37,2,False,7,5,2,28,11,1
3,00:07:31,2,False,7,8,-1,35,10,1
3,00:05:48,2,True,8,7,1,53,10,1
3,00:04:58,2,False,7,8,-1,46,10,1
4,00:15:00,2,True,11,7,4,48,13,1
4,00:11:09,1,False,7,14,-7,37,10,1
4,00:10:26,2,False,7,14,-7,37,10,1
4,00:05:06,2,False,7,14,-7,48,7,1
4,00:02:34,2,True,14,7,7,20,7,1
4,00:01:35,2,False,7,14,-7,50,10,1
1,00:12:36,1,True,7,0,7,41,10,1
1,00:11:44,2,True,7,0,7,52,10,1
1,00:10:30,2,False,0,7,-7,46,10,1
1,00:07:05,2,False,7,7,0,12,16,1
1,00:03:40,2,True,7,7,0,46,10,1
1,00:02:19,2,True,7,7,0,20,5,1
1,00:00:57,2,True,7,7,0,3,3,1
2,00:15:00,1,True,7,10,-3,46,10,1
2,00:13:08,2,False,10,7,3,6,7,1
2,00:12:27,1,False,10,7,3,25,10,1
2,00:11:04,1,True,7,10,-3,40,10,1
2,00:10:29,1,True,7,10,-3,51,10,1
2,00:07:37,1,True,14,10,4,29,10,1
2,00:05:19,2,True,14,17,-3,34,7,1
2,00:01:43,1,False,17,14,3,5,10,1
2,00:01:38,1,False,17,21,-4,42,10,1
2,00:01:31,1,False,17,21,-4,53,10,1
2,00:00:43,1,True,21,17,4,38,10,1
2,00:00:35,1,False,17,21,-4,52,10,1
2,00:00:28,1,False,17,21,-4,40,10,1
2,00:00:15,1,False,17,21,-4,5,5,1
3,00:13:22,1,True,28,17,11,54,10,1
3,00:13:15,2,False,17,28,-11,53,7,1
3,00:12:16,1,False,17,28,-11,26,10,1
3,00:10:30,1,False,17,31,-14,54,10,1
3,00:08:47,1,True,31,17,14,34,10,1
3,00:08:17,2,True,31,17,14,29,5,1
3,00:07:41,1,True,31,17,14,20,10,1
3,00:05:51,2,True,31,20,11,38,7,1
3,00:05:30,1,True,31,20,11,50,10,1
3,00:04:09,1,False,20,31,-11,39,20,1
3,00:03:20,2,False,20,31,-11,25,6,1
3,00:01:50,2,False,20,39,-19,37,8,1
3,00:01:01,1,True,39,20,19,50,10,1
3,00:00:35,1,False,20,39,-19,49,10,1
3,00:00:01,2,False,20,39,-19,43,4,1
4,00:15:00,1,False,20,39,-19,32,10,1
4,00:12:39,2,False,20,42,-22,30,15,1
4,00:11:31,1,False,20,42,-22,45,10,1
4,00:06:58,1,False,20,42,-22,39,10,1
4,00:05:12,1,True,42,20,22,42,10,1
4,00:02:40,2,False,20,42,-22,33,10,1
1,00:14:10,2,False,0,0,0,39,6,1
1,00:09:17,2,True,0,0,0,37,5,1
1,00:06:57,1,True,0,0,0,25,10,1
1,00:04:55,2,True,0,2,-2,52,8,1
1,00:02:36,2,True,0,2,-2,24,8,1
1,00:01:27,2,True,0,2,-2,33,10,1
2,00:10:16,1,False,2,0,2,44,10,1
2,00:06:09,2,True,0,2,-2,11,10,1
2,00:05:48,1,True,0,9,-9,30,10,1
2,00:04:09,2,True,0,9,-9,50,5,1
2,00:01:32,1,False,9,0,9,54,10,1
2,00:00:54,1,True,0,9,-9,40,10,1
2,00:00:27,2,True,0,9,-9,26,10,1
3,00:14:23,2,True,0,9,-9,35,11,1
3,00:07:44,2,True,0,10,-10,7,7,1
3,00:06:45,2,True,0,17,-17,17,8,1
3,00:05:15,2,True,0,17,-17,42,3,1
3,00:03:30,1,True,0,24,-24,38,10,1
3,00:02:33,2,True,0,24,-24,44,4,1
3,00:00:35,1,True,8,24,-16,40,10,1
4,00:12:30,2,True,16,24,-8,20,10,1
4,00:11:14,1,True,16,24,-8,51,10,1
4,00:08:00,2,False,24,24,0,49,10,1
4,00:06:23,2,True,24,24,0,16,11,1
4,00:05:53,1,True,24,24,0,33,10,1
4,00:03:38,1,False,24,24,0,25,10,1
4,00:03:09,1,False,24,24,0,43,10,1
4,00:02:43,1,False,24,24,0,54,10,1
4,00:02:31,1,True,24,24,0,37,10,1
4,00:00:26,1,True,24,31,-7,40,10,1
4,00:00:18,1,False,31,24,7,44,10,1
1,00:14:20,2,True,0,0,0,42,10,1
1,00:11:00,1,False,0,0,0,43,10,1
1,00:10:21,1,False,0,0,0,28,10,1
1,00:07:54,1,False,0,7,-7,10,10,1
1,00:06:48,2,False,0,7,-7,6,6,1
1,00:04:27,1,False,7,14,-7,44,10,1
1,00:03:50,2,False,7,14,-7,50,16,1
1,00:01:19,1,False,7,17,-10,24,10,1
1,00:00:45,2,False,7,17,-10,27,7,1
1,00:00:01,1,False,7,17,-10,40,10,1
2,00:15:00,2,False,7,17,-10,48,2,1
2,00:13:15,2,True,17,7,10,36,5,1
2,00:10:00,1,False,7,20,-13,45,10,1
2,00:09:28,2,False,7,20,-13,51,4,1
2,00:07:52,2,True,20,7,13,52,10,1
2,00:06:46,2,True,20,7,13,34,5,1
2,00:05:21,1,True,20,14,6,36,10,1
2,00:03:44,2,True,20,14,6,15,4,1
2,00:03:01,2,True,20,21,-1,45,10,1
2,00:02:48,1,False,21,20,1,51,10,1
2,00:02:32,2,False,21,20,1,45,4,1
2,00:02:07,1,False,21,20,1,39,10,1
2,00:00:57,2,False,21,20,1,29,6,1
2,00:00:42,2,False,21,20,1,36,15,1
3,00:14:32,2,False,21,20,1,30,10,1
3,00:13:14,2,False,21,20,1,44,6,1
3,00:12:35,1,True,20,21,-1,48,10,1
3,00:12:26,2,True,20,21,-1,41,3,1
3,00:11:36,2,True,20,21,-1,35,10,1
3,00:10:39,1,True,20,21,-1,37,10,1
3,00:08:52,2,False,21,20,1,36,4,1
3,00:06:15,2,False,21,23,-2,34,11,1
3,00:05:04,2,True,23,21,2,37,7,1
3,00:03:08,1,False,21,23,-2,53,10,1
4,00:11:09,1,False,21,29,-8,35,10,1
4,00:09:40,2,True,29,21,8,45,12,1
4,00:08:16,2,True,29,24,5,35,10,1
4,00:07:33,1,True,29,24,5,46,10,1
4,00:07:02,2,True,29,24,5,54,2,1
4,00:04:10,2,False,24,30,-6,35,10,1
4,00:03:12,1,True,30,24,6,49,10,1
4,00:00:49,1,False,24,33,-9,42,10,1
4,00:00:25,1,True,33,24,9,15,10,1
1,00:14:10,2,False,0,0,0,30,10,1
1,00:12:29,2,False,0,0,0,52,3,1
1,00:11:54,2,False,0,0,0,55,10,1
1,00:10:59,1,True,0,0,0,20,10,1
1,00:09:20,1,False,0,0,0,47,10,1
1,00:07:58,1,True,0,0,0,52,10,1
1,00:05:45,1,True,0,0,0,37,10,1
1,00:05:28,2,True,0,0,0,43,4,1
1,00:02:36,1,False,0,0,0,48,10,1
1,00:01:30,2,True,0,0,0,28,10,1
2,00:14:47,2,False,10,0,10,50,10,1
2,00:12:13,2,False,10,3,7,38,7,1
2,00:09:56,2,False,10,3,7,50,5,1
2,00:08:15,2,False,10,3,7,49,9,1
2,00:07:35,1,False,10,3,7,34,10,1
2,00:03:55,2,True,6,10,-4,26,10,1
2,00:03:16,1,True,6,10,-4,55,10,1
2,00:02:55,2,False,10,6,4,50,5,1
2,00:02:36,1,False,10,6,4,35,10,1
2,00:02:10,2,False,10,6,4,27,2,1
2,00:00:53,1,True,9,10,-1,41,10,1
3,00:14:59,1,False,10,9,1,45,10,1
3,00:13:00,2,True,9,10,-1,47,3,1
3,00:12:10,1,True,9,10,-1,7,10,1
3,00:11:37,1,True,9,10,-1,26,10,1
3,00:10:58,1,True,9,10,-1,39,10,1
3,00:10:19,1,False,10,9,1,51,10,1
3,00:04:15,2,False,10,12,-2,52,8,1
3,00:03:13,1,True,12,10,2,17,10,1
3,00:02:56,1,True,12,17,-5,15,10,1
3,00:02:12,1,True,12,17,-5,32,10,1
3,00:01:26,1,False,17,12,5,52,10,1
3,00:00:33,2,True,12,17,-5,55,13,1
4,00:14:33,2,False,17,12,5,25,11,1
4,00:11:58,1,False,17,12,5,30,10,1
4,00:10:25,2,False,17,12,5,42,10,1
4,00:09:37,1,False,17,12,5,48,10,1
4,00:09:04,2,False,17,12,5,23,10,1
4,00:06:30,2,True,14,17,-3,44,15,1
4,00:04:45,2,False,17,14,3,5,12,1
4,00:04:03,1,False,17,16,1,51,10,1
4,00:03:18,1,False,17,16,1,38,10,1
4,00:03:00,1,False,17,16,1,15,10,1
4,00:01:43,1,False,17,19,-2,35,10,1
4,00:01:37,1,False,17,19,-2,51,10,1
4,00:00:10,3,False,17,19,-2,28,10,1
1,00:14:56,1,True,0,0,0,13,10,1
1,00:13:49,2,True,0,0,0,20,13,1
1,00:12:55,1,False,0,0,0,37,10,1
1,00:12:00,1,False,0,0,0,40,20,1
1,00:11:30,2,True,0,0,0,52,2,1
1,00:10:46,1,True,0,0,0,45,10,1
1,00:09:11,2,True,0,0,0,3,3,1
1,00:08:09,2,True,0,7,-7,23,3,1
1,00:07:15,2,True,0,7,-7,37,18,1
1,00:06:05,2,False,7,0,7,45,6,1
1,00:04:59,1,True,0,7,-7,36,10,1
1,00:03:29,1,True,0,7,-7,47,10,1
1,00:01:34,1,True,0,7,-7,42,10,1
2,00:15:00,2,True,0,10,-10,36,9,1
2,00:14:22,1,False,10,0,10,37,10,1
2,00:12:32,2,False,10,0,10,39,21,1
2,00:10:33,1,True,0,10,-10,15,10,1
2,00:09:22,1,True,0,13,-13,35,10,1
2,00:08:19,1,True,0,13,-13,50,10,1
2,00:05:02,1,False,13,0,13,10,10,1
2,00:03:55,2,False,13,0,13,2,2,1
2,00:03:33,1,False,13,7,6,43,10,1
2,00:03:00,1,True,7,13,-6,45,10,1
2,00:02:25,1,True,7,13,-6,33,20,1
2,00:01:42,1,True,7,20,-13,26,10,1
2,00:01:35,2,True,7,20,-13,31,5,1
2,00:01:08,1,False,20,7,13,36,10,1
2,00:00:56,2,False,20,7,13,29,3,1
2,00:00:39,1,False,20,7,13,20,10,1
3,00:14:55,1,False,20,10,10,31,10,1
3,00:13:11,1,True,10,20,-10,16,15,1
3,00:11:55,1,True,10,20,-10,34,20,1
3,00:09:43,2,True,10,23,-13,25,20,1
3,00:08:23,2,True,10,23,-13,50,5,1
3,00:07:49,1,False,23,10,13,50,10,1
3,00:04:57,1,True,13,23,-10,37,10,1
3,00:03:26,2,True,13,23,-10,22,10,1
3,00:02:17,2,True,13,30,-17,17,21,1
4,00:15:00,2,False,30,13,17,18,10,1
4,00:14:06,1,False,30,13,17,6,6,1
4,00:13:02,1,False,30,20,10,25,15,1
4,00:11:58,2,False,30,20,10,40,10,1
4,00:10:52,1,True,20,30,-10,41,10,1
4,00:08:10,2,False,30,20,10,43,9,1
4,00:06:01,2,True,20,30,-10,33,10,1
4,00:04:59,1,True,20,33,-13,35,10,1
4,00:03:47,3,True,20,33,-13,45,10,1
4,00:03:11,2,False,33,20,13,50,10,1
4,00:02:45,1,False,33,20,13,24,10,1
4,00:02:33,2,False,33,20,13,17,3,1
4,00:01:37,1,True,27,33,-6,30,10,1
4,00:01:14,1,True,27,33,-6,41,10,1
1,00:14:12,2,False,0,0,0,24,6,1
1,00:12:11,1,True,0,0,0,26,10,1
1,00:11:42,1,False,0,0,0,44,10,1
1,00:11:04,2,False,0,0,0,34,0,1
1,00:09:59,2,False,0,0,0,33,10,1
1,00:08:38,1,False,0,3,-3,35,10,1
1,00:07:01,1,False,0,3,-3,42,15,1
1,00:06:37,2,False,0,3,-3,48,9,1
1,00:04:45,1,True,3,0,3,16,10,1
1,00:02:35,1,False,0,3,-3,50,10,1
2,00:15:00,1,True,3,0,3,20,10,1
2,00:10:00,2,True,3,0,3,41,7,1
2,00:08:08,2,False,0,3,-3,23,7,1
2,00:05:44,1,False,0,10,-10,50,10,1
2,00:03:22,1,True,10,3,7,25,20,1
2,00:02:30,2,True,10,3,7,50,10,1
2,00:01:46,1,True,17,3,14,33,10,1
2,00:01:21,2,True,17,3,14,52,5,1
3,00:14:53,1,True,17,3,14,25,10,1
3,00:14:24,1,True,17,3,14,35,10,1
3,00:13:56,1,True,17,3,14,47,10,1
3,00:13:23,2,True,17,3,14,53,4,1
3,00:12:46,1,False,3,17,-14,52,10,1
3,00:12:02,1,False,3,17,-14,19,10,1
3,00:09:48,1,False,3,17,-14,9,9,1
3,00:09:10,2,False,3,24,-21,44,10,1
3,00:08:16,1,True,24,3,21,39,10,1
3,00:07:15,1,True,24,3,21,49,10,1
3,00:05:02,1,False,3,27,-24,28,10,1
3,00:04:17,2,False,3,27,-24,33,5,1
3,00:02:52,1,False,3,27,-24,39,10,1
3,00:02:10,2,False,3,27,-24,44,5,1
3,00:01:21,2,True,27,3,24,52,10,1
3,00:00:01,2,True,27,3,24,21,3,1
4,00:12:22,2,False,3,27,-24,3,3,1
4,00:09:20,1,True,34,3,31,45,10,1
4,00:06:31,1,False,3,34,-31,31,10,1
4,00:05:20,1,False,3,34,-31,41,10,1
1,00:11:13,1,True,0,0,0,9,10,1
1,00:04:57,2,True,0,0,0,17,5,1
1,00:03:41,2,True,0,0,0,11,10,1
2,00:15:00,2,False,7,0,7,35,10,1
2,00:13:26,2,True,0,7,-7,11,7,1
2,00:11:01,1,False,7,0,7,25,10,1
2,00:04:23,2,True,7,7,0,49,10,1
2,00:01:44,2,False,7,14,-7,15,8,1
3,00:12:06,2,False,7,14,-7,25,19,1
3,00:11:45,1,False,7,21,-14,51,10,1
3,00:08:30,2,True,21,7,14,25,10,1
3,00:06:54,1,False,7,21,-14,51,10,1
3,00:06:29,1,False,7,21,-14,25,10,1
3,00:04:22,2,False,7,24,-17,30,10,1
3,00:03:30,2,False,7,31,-24,20,18,1
3,00:02:46,1,False,7,31,-24,51,10,1
3,00:00:36,1,False,7,34,-27,35,10,1
4,00:12:00,2,True,34,7,27,6,9,1
4,00:10:35,1,False,9,34,-25,53,10,1
4,00:01:08,2,False,9,40,-31,38,7,1
4,00:00:30,2,False,9,40,-31,54,4,1
1,00:13:07,1,True,0,0,0,28,10,1
1,00:11:51,1,False,0,0,0,26,10,1
1,00:10:30,1,True,0,0,0,53,10,1
1,00:07:51,2,False,0,0,0,31,9,1
1,00:04:40,2,False,0,7,-7,26,7,1
1,00:03:20,2,False,0,7,-7,23,15,1
1,00:02:26,1,False,0,10,-10,35,10,1
1,00:01:19,1,True,10,0,10,31,10,1
1,00:00:40,1,True,10,0,10,42,10,1
2,00:12:35,2,False,0,11,-11,25,20,1
2,00:11:20,2,True,11,0,11,35,8,1
2,00:10:45,1,True,11,0,11,46,10,1
2,00:06:57,1,True,14,0,14,22,10,1
2,00:02:22,1,True,30,0,30,32,10,1
2,00:02:16,2,True,30,0,30,34,8,1
2,00:01:52,1,True,30,0,30,46,10,1
2,00:01:20,1,False,0,30,-30,10,10,1
2,00:01:11,1,False,0,30,-30,25,10,1
2,00:00:40,1,True,30,0,30,42,10,1
2,00:00:30,1,True,30,0,30,55,10,1
3,00:14:54,1,True,37,0,37,34,10,1
3,00:13:20,2,True,37,0,37,51,5,1
3,00:10:25,2,False,0,40,-40,35,10,1
3,00:09:53,1,True,40,0,40,52,10,1
3,00:09:05,3,True,40,0,40,45,3,1
3,00:06:25,1,False,3,40,-37,42,15,1
3,00:03:05,2,False,3,40,-37,37,7,1
3,00:02:27,1,True,40,3,37,28,10,1
3,00:00:52,2,True,40,6,34,41,4,1
4,00:12:46,2,False,6,41,-35,55,10,1
4,00:12:04,1,True,41,6,35,30,10,1
4,00:11:47,2,True,41,6,35,25,5,1
4,00:09:49,1,True,41,9,32,25,20,1
4,00:07:15,2,True,41,9,32,45,6,1
4,00:05:06,1,True,41,9,32,25,10,1
4,00:02:27,2,False,9,41,-32,2,13,1
4,00:02:00,1,False,9,41,-32,31,10,1
4,00:01:43,1,False,9,41,-32,48,10,1
4,00:01:37,2,False,9,41,-32,54,4,1
4,00:01:12,3,True,41,9,32,49,10,1
4,00:00:13,1,False,9,41,-32,34,10,1
1,00:13:17,2,True,0,0,0,51,10,1
1,00:11:53,2,False,0,0,0,48,10,1
1,00:11:21,1,False,0,0,0,35,10,1
1,00:07:44,1,True,3,0,3,46,10,1
1,00:06:49,3,True,3,0,3,43,13,1
1,00:04:37,2,False,0,4,-4,35,10,1
1,00:01:20,2,True,4,0,4,19,5,1
2,00:14:46,2,True,4,0,4,51,5,1
2,00:12:48,1,False,0,4,-4,20,10,1
2,00:11:11,2,True,4,0,4,47,10,1
2,00:08:22,1,False,1,4,-3,24,10,1
2,00:06:29,1,True,4,1,3,39,10,1
2,00:04:54,2,True,4,1,3,48,10,1
2,00:01:46,1,True,4,1,3,29,10,1
2,00:01:21,1,True,4,1,3,40,10,1
2,00:01:07,1,True,4,1,3,50,10,1
2,00:00:34,2,False,1,4,-3,40,5,1
2,00:00:23,1,False,1,4,-3,31,10,1
3,00:14:56,1,False,1,7,-6,31,10,1
3,00:13:32,2,False,1,7,-6,51,10,1
3,00:12:40,1,True,7,1,6,48,10,1
3,00:09:21,2,False,3,7,-4,46,5,1
3,00:08:29,1,False,3,7,-4,41,20,1
3,00:07:22,2,True,7,3,4,44,6,1
3,00:05:48,2,True,7,3,4,43,15,1
3,00:00:17,2,True,7,6,1,38,7,1
4,00:14:00,2,False,6,7,-1,7,7,1
4,00:11:59,1,True,15,6,9,50,10,1
4,00:09:10,2,True,15,6,9,51,10,1
4,00:08:10,1,False,6,16,-10,35,10,1
4,00:06:42,1,True,16,6,10,48,10,1
4,00:04:10,1,False,6,16,-10,25,10,1
1,00:14:54,1,True,0,0,0,28,10,1
1,00:12:02,1,True,0,0,0,35,10,1
1,00:11:01,1,True,0,0,0,45,10,1
1,00:10:29,1,False,0,0,0,54,10,1
1,00:06:51,1,True,3,0,3,35,10,1
1,00:05:22,1,True,3,3,0,34,10,1
1,00:04:56,2,True,3,3,0,39,5,1
1,00:04:04,1,False,3,3,0,20,10,1
1,00:03:44,1,False,3,3,0,32,10,1
1,00:02:56,1,False,3,3,0,50,10,1
1,00:01:30,2,True,3,3,0,44,5,1
1,00:01:00,1,True,3,3,0,26,10,1
1,00:00:00,1,True,3,3,0,10,10,1
2,00:14:24,2,True,3,10,-7,35,10,1
2,00:13:58,1,True,3,10,-7,47,10,1
2,00:12:56,1,False,10,3,7,50,10,1
2,00:08:52,1,True,6,10,-4,27,10,1
2,00:07:54,2,True,6,10,-4,42,6,1
2,00:05:56,1,False,10,6,4,15,10,1
2,00:05:32,2,False,10,6,4,16,9,1
2,00:03:07,1,False,10,6,4,39,10,1
2,00:01:42,1,False,10,6,4,27,10,1
2,00:00:38,1,True,6,10,-4,44,10,1
3,00:09:07,1,True,6,13,-7,35,10,1
3,00:07:17,2,True,6,13,-7,50,7,1
3,00:05:43,2,True,6,13,-7,54,22,1
3,00:04:04,1,True,6,13,-7,8,18,1
3,00:03:25,2,True,6,13,-7,10,16,1
3,00:01:44,2,True,6,13,-7,42,5,1
3,00:01:18,1,True,6,13,-7,34,10,1
4,00:09:49,1,False,20,6,14,45,20,1
4,00:09:05,2,False,20,6,14,39,14,1
4,00:07:34,2,False,20,9,11,32,8,1
4,00:06:27,1,False,20,9,11,47,20,1
4,00:04:38,2,True,9,20,-11,52,10,1
4,00:03:20,2,False,20,9,11,44,10,1
4,00:02:27,1,True,12,20,-8,35,10,1
4,00:02:21,1,True,12,20,-8,55,10,1
4,00:02:02,2,False,20,12,8,49,4,1
4,00:01:38,2,False,20,12,8,44,10,1
1,00:13:36,1,False,0,0,0,53,10,1
1,00:12:28,2,True,0,0,0,39,7,1
1,00:09:06,2,True,0,0,0,25,15,1
1,00:07:28,2,False,7,0,7,45,6,1
1,00:06:26,1,True,0,7,-7,51,10,1
1,00:05:34,2,True,0,14,-14,40,4,1
1,00:05:01,1,True,0,14,-14,48,10,1
1,00:04:19,1,False,14,0,14,52,10,1
1,00:03:23,2,False,14,0,14,42,11,1
1,00:02:34,2,False,14,0,14,28,10,1
1,00:00:52,1,True,3,14,-11,53,15,1
1,00:00:30,2,True,3,14,-11,50,12,1
2,00:15:00,1,True,3,15,-12,35,10,1
2,00:14:30,1,True,3,15,-12,49,10,1
2,00:11:42,2,False,15,6,9,25,20,1
2,00:09:39,2,True,6,15,-9,46,6,1
2,00:08:17,2,True,6,16,-10,38,7,1
2,00:07:39,1,True,6,16,-10,48,10,1
2,00:05:48,1,False,16,6,10,17,10,1
2,00:04:39,1,False,16,6,10,19,20,1
2,00:03:01,1,False,16,6,10,35,10,1
2,00:02:25,1,False,16,6,10,51,10,1
2,00:01:26,1,True,6,16,-10,29,10,1
2,00:01:20,1,True,6,16,-10,42,10,1
2,00:00:45,2,False,16,6,10,26,10,1
2,00:00:21,1,True,6,16,-10,38,10,1
2,00:00:01,1,True,6,16,-10,50,10,1
3,00:11:38,1,True,7,16,-9,53,10,1
3,00:09:33,1,True,7,23,-16,33,10,1
3,00:01:22,2,True,9,23,-14,47,13,1
4,00:14:24,1,False,23,16,7,39,20,1
4,00:10:42,1,True,16,26,-10,35,10,1
4,00:09:40,2,True,16,26,-10,52,8,1
4,00:03:54,2,True,23,26,-3,54,4,1
4,00:02:53,2,True,23,26,-3,37,10,1
4,00:01:20,1,True,23,33,-10,32,10,1
1,00:14:20,2,True,0,0,0,27,10,1
1,00:12:02,2,True,0,0,0,10,6,1
1,00:11:20,1,True,0,0,0,22,10,1
1,00:09:15,1,False,0,0,0,39,10,1
1,00:08:05,1,False,0,3,-3,35,10,1
1,00:06:31,1,False,0,3,-3,35,20,1
1,00:01:20,2,True,3,0,3,38,20,1
1,00:00:01,1,False,0,3,-3,20,10,1
2,00:15:00,1,False,0,3,-3,30,10,1
2,00:14:35,1,False,0,3,-3,50,10,1
2,00:14:00,2,False,0,3,-3,53,7,1
2,00:13:18,1,True,3,0,3,50,10,1
2,00:12:42,2,True,3,0,3,35,10,1
2,00:09:33,1,True,3,3,0,47,10,1
2,00:06:29,2,True,3,4,-1,36,9,1
2,00:04:32,1,False,4,3,1,39,10,1
2,00:02:17,2,True,3,4,-1,54,10,1
2,00:02:11,1,False,4,3,1,35,10,1
2,00:01:48,2,False,4,3,1,30,5,1
2,00:00:58,2,False,4,3,1,17,10,1
3,00:11:43,1,False,11,13,-2,7,17,1
3,00:09:55,2,True,13,11,2,55,8,1
3,00:07:24,2,False,11,13,-2,53,10,1
3,00:04:30,2,True,13,14,-1,36,9,1
3,00:03:33,1,False,14,13,1,30,10,1
3,00:03:05,2,False,14,13,1,35,5,1
3,00:00:07,1,True,13,14,-1,33,10,1
4,00:15:00,2,True,13,14,-1,17,5,1
4,00:12:14,1,False,17,13,4,26,10,1
4,00:11:08,2,False,17,13,4,45,9,1
4,00:10:27,1,True,13,17,-4,48,10,1
4,00:09:08,2,True,13,17,-4,21,5,1
4,00:04:30,2,False,24,13,11,16,5,1
4,00:01:56,2,True,13,24,-11,34,9,1
4,00:01:41,1,True,13,24,-11,50,10,1
4,00:01:24,2,False,24,13,11,50,0,1
4,00:00:42,3,False,24,13,11,28,10,1
1,00:14:36,1,True,0,0,0,36,10,1
1,00:12:38,2,False,0,0,0,28,3,1
1,00:10:39,2,False,0,0,0,5,5,1
1,00:09:22,2,False,0,7,-7,13,10,1
1,00:08:11,2,False,0,7,-7,38,5,1
1,00:02:34,2,True,7,7,0,52,8,1
2,00:11:02,2,True,7,7,0,50,5,1
2,00:08:23,2,True,7,7,0,52,9,1
2,00:07:15,2,False,7,7,0,47,14,1
2,00:05:13,1,True,7,7,0,34,10,1
2,00:02:21,2,False,10,7,3,48,10,1
2,00:01:47,2,True,7,10,-3,25,9,1
2,00:01:05,2,True,7,10,-3,14,10,1
3,00:14:20,2,False,13,7,6,34,7,1
3,00:13:50,1,False,13,7,6,43,10,1
3,00:11:45,2,True,7,13,-6,11,10,1
3,00:10:18,2,True,7,20,-13,51,6,1
3,00:08:13,2,True,7,23,-16,36,9,1
3,00:06:59,2,True,7,23,-16,48,8,1
3,00:04:25,2,False,23,7,16,53,15,1
3,00:04:04,3,False,23,7,16,48,10,1
3,00:01:54,1,False,23,10,13,31,10,1
4,00:14:09,2,False,23,10,13,53,10,1
4,00:13:08,1,True,10,23,-13,8,10,1
4,00:12:24,1,True,10,23,-13,52,10,1
4,00:10:04,2,True,17,23,-6,48,10,1
4,00:07:55,2,False,23,17,6,18,8,1
4,00:06:45,1,False,23,17,6,27,10,1
4,00:06:10,2,False,23,17,6,33,4,1
4,00:05:20,1,False,23,17,6,50,10,1
4,00:02:31,1,True,17,23,-6,10,10,1
4,00:01:05,3,True,17,23,-6,23,10,1
1,00:14:54,1,True,0,0,0,37,10,1
1,00:13:40,2,True,0,0,0,54,7,1
1,00:12:49,1,False,0,0,0,47,10,1
1,00:09:22,1,True,1,0,1,44,10,1
1,00:07:27,2,True,1,0,1,50,16,1
1,00:05:45,1,False,0,1,-1,46,20,1
1,00:05:19,1,True,1,0,1,42,10,1
1,00:04:17,2,True,1,0,1,28,10,1
1,00:03:10,1,True,1,3,-2,38,10,1
1,00:01:11,2,False,3,1,2,54,3,1
2,00:13:19,1,True,8,3,5,40,10,1
2,00:10:22,1,False,3,8,-5,34,10,1
2,00:09:20,2,False,3,8,-5,50,13,1
2,00:08:06,1,True,8,3,5,24,10,1
2,00:06:27,1,False,10,8,2,35,10,1
2,00:04:32,2,True,8,10,-2,49,5,1
2,00:02:46,2,True,8,13,-5,35,10,1
2,00:02:03,1,False,13,8,5,41,10,1
2,00:00:47,1,True,8,20,-12,47,10,1
2,00:00:42,1,False,20,8,12,51,10,1
2,00:00:32,2,False,20,8,12,44,3,1
3,00:14:11,2,False,20,15,5,26,20,1
3,00:13:10,1,True,15,20,-5,31,10,1
3,00:12:38,2,True,15,20,-5,27,14,1
3,00:10:10,1,True,15,20,-5,51,10,1
3,00:08:21,1,True,15,20,-5,40,10,1
3,00:06:01,2,False,27,15,12,29,7,1
3,00:03:45,2,True,15,27,-12,25,10,1
3,00:00:38,1,True,15,27,-12,50,10,1
4,00:14:26,2,False,27,15,12,46,8,1
4,00:13:10,1,False,27,15,12,24,10,1
4,00:12:04,1,False,27,15,12,11,10,1
4,00:08:33,2,False,27,23,4,43,10,1
4,00:07:51,2,False,27,23,4,21,10,1
4,00:06:15,1,False,27,30,-3,26,10,1
4,00:04:53,1,False,27,37,-10,33,10,1
4,00:02:17,2,False,27,40,-13,35,10,1
4,00:02:10,1,False,27,40,-13,49,10,1
4,00:01:41,3,False,27,40,-13,49,10,1
4,00:01:32,1,True,40,27,13,46,10,1
4,00:01:19,1,True,40,27,13,34,10,1
4,00:01:02,2,True,40,27,13,27,3,1
1,00:13:12,2,True,2,0,2,54,4,1
1,00:12:35,1,False,0,2,-2,46,10,1
1,00:12:15,2,False,0,2,-2,45,9,1
1,00:08:24,1,True,5,0,5,28,10,1
1,00:06:24,1,False,0,5,-5,38,10,1
1,00:05:57,1,False,0,5,-5,20,10,1
1,00:03:34,2,True,8,0,8,43,7,1
1,00:01:04,1,False,0,8,-8,32,20,1
1,00:00:00,2,False,0,8,-8,22,10,1
2,00:13:10,1,True,15,0,15,53,10,1
2,00:10:35,1,False,0,15,-15,35,15,1
2,00:08:56,2,True,15,0,15,16,12,1
2,00:08:05,1,False,0,15,-15,32,10,1
2,00:07:04,1,True,15,0,15,50,10,1
2,00:05:19,1,False,7,15,-8,44,10,1
2,00:05:01,2,False,7,15,-8,51,3,1
2,00:01:38,2,False,7,15,-8,19,10,1
3,00:14:27,2,True,15,7,8,45,10,1
3,00:13:53,1,False,7,15,-8,20,10,1
3,00:12:13,2,False,7,15,-8,30,10,1
3,00:11:02,2,False,7,15,-8,53,10,1
3,00:10:11,1,True,15,7,8,43,10,1
3,00:09:18,2,True,15,14,1,52,4,1
3,00:08:48,1,False,14,15,-1,48,10,1
3,00:07:00,1,False,14,15,-1,1,10,1
3,00:06:44,1,False,14,15,-1,14,10,1
3,00:05:39,1,False,14,15,-1,28,10,1
3,00:05:11,1,False,14,15,-1,44,10,1
3,00:04:40,2,False,14,15,-1,47,7,1
3,00:03:12,2,True,15,14,1,47,9,1
3,00:02:56,1,True,15,14,1,27,10,1
3,00:01:52,2,True,15,14,1,27,10,1
4,00:15:00,1,False,21,15,6,35,10,1
4,00:14:09,1,True,15,21,-6,54,10,1
4,00:13:30,2,True,15,21,-6,54,10,1
4,00:11:28,2,False,21,18,3,33,12,1
4,00:08:51,1,False,21,18,3,45,10,1
4,00:08:01,1,False,21,18,3,15,10,1
4,00:06:36,2,False,21,18,3,3,3,1
4,00:04:48,1,False,21,25,-4,40,10,1
4,00:04:24,1,False,21,25,-4,52,10,1
4,00:03:45,2,False,21,25,-4,55,7,1
4,00:03:02,3,True,25,21,4,50,2,1
4,00:02:25,2,True,25,24,1,38,7,1
4,00:00:09,3,False,24,26,-2,35,10,1
1,00:13:11,2,False,0,0,0,25,10,1
1,00:10:05,1,True,3,0,3,43,10,1
1,00:08:58,2,False,0,3,-3,35,15,1
1,00:08:00,1,False,0,4,-4,35,10,1
1,00:02:52,2,True,4,7,-3,23,10,1
1,00:01:00,1,False,7,4,3,31,10,1
2,00:12:02,1,False,7,4,3,16,10,1
2,00:11:32,2,False,7,4,3,22,4,1
2,00:08:52,1,False,7,4,3,17,10,1
2,00:03:21,1,False,7,7,0,19,10,1
2,00:02:03,2,True,14,7,7,30,14,1
2,00:00:39,1,True,14,10,4,51,10,1
3,00:14:42,2,False,13,14,-1,45,10,1
3,00:13:49,1,True,14,13,1,9,10,1
3,00:09:21,1,False,13,14,-1,51,10,1
3,00:04:55,1,False,13,17,-4,36,10,1
3,00:03:30,2,False,13,17,-4,46,15,1
3,00:02:23,2,True,17,13,4,43,8,1
4,00:14:20,1,False,13,17,-4,19,10,1
4,00:09:38,1,True,17,13,4,12,10,1
4,00:05:11,1,False,21,17,4,49,10,1
4,00:04:10,2,False,21,17,4,55,4,1
4,00:03:31,2,True,17,28,-11,48,10,1
4,00:03:08,3,True,17,28,-11,55,3,1
4,00:00:20,1,True,23,28,-5,26,10,1
4,00:00:16,2,True,23,28,-5,32,4,1
4,00:00:11,1,True,23,28,-5,48,10,1
1,00:14:51,1,True,0,0,0,48,10,1
1,00:13:22,1,False,0,0,0,9,10,1
1,00:12:36,2,False,0,0,0,25,10,1
1,00:10:10,1,True,0,0,0,42,15,1
1,00:09:45,2,True,0,0,0,52,5,1
1,00:08:18,2,False,0,0,0,24,7,1
1,00:05:11,1,True,1,0,1,24,10,1
1,00:03:42,2,False,0,1,-1,51,5,1
1,00:01:18,1,False,0,8,-8,34,10,1
1,00:00:23,2,True,8,0,8,48,7,1
2,00:11:20,1,True,8,0,8,13,10,1
2,00:10:50,1,True,8,7,1,49,10,1
2,00:09:53,2,False,7,8,-1,42,10,1
2,00:08:28,2,False,7,8,-1,33,13,1
2,00:05:26,1,True,15,14,1,53,10,1
2,00:03:15,1,True,15,14,1,17,10,1
2,00:01:41,2,True,15,14,1,44,10,1
3,00:14:29,2,False,14,15,-1,36,12,1
3,00:09:18,1,False,17,15,2,47,10,1
3,00:06:40,1,False,17,22,-5,29,10,1
4,00:14:44,2,True,22,24,-2,49,5,1
4,00:13:55,1,True,22,24,-2,43,10,1
4,00:11:29,1,True,22,27,-5,35,10,1
4,00:10:56,2,True,22,27,-5,46,10,1
4,00:09:46,2,False,27,22,5,37,2,1
4,00:07:21,1,False,27,25,2,35,10,1
4,00:03:24,2,True,25,34,-9,46,10,1
4,00:02:58,1,False,34,25,9,48,10,1
4,00:02:28,2,False,34,25,9,36,10,1
4,00:02:19,1,False,34,25,9,22,10,1
4,00:01:27,2,False,34,25,9,45,9,1
1,00:13:38,2,True,0,0,0,53,5,1
1,00:11:08,1,False,0,0,0,10,10,1
1,00:07:08,1,False,0,7,-7,20,10,1
1,00:03:48,1,True,7,0,7,50,10,1
1,00:00:02,1,False,3,7,-4,36,10,1
2,00:14:33,1,False,3,7,-4,24,10,1
2,00:05:03,2,False,3,10,-7,44,8,1
2,00:02:17,1,False,3,10,-7,36,10,1
3,00:13:17,1,True,10,3,7,25,10,1
3,00:12:38,2,True,10,3,7,22,13,1
3,00:10:37,2,True,10,3,7,4,4,1
3,00:09:58,2,True,10,9,1,41,10,1
3,00:00:05,1,True,11,9,2,29,10,1
4,00:15:00,2,True,11,9,2,36,3,1
4,00:12:33,1,False,9,11,-2,41,10,1
4,00:10:38,2,False,9,11,-2,51,10,1
4,00:09:06,2,True,11,9,2,12,5,1
4,00:04:56,2,True,11,15,-4,32,7,1
4,00:04:09,2,True,11,15,-4,19,9,1
4,00:02:02,1,False,18,11,7,45,10,1
4,00:00:03,1,True,13,18,-5,52,15,1
1,00:14:56,1,False,0,0,0,36,10,1
1,00:10:45,2,False,0,3,-3,40,5,1
1,00:07:57,2,True,3,0,3,35,10,1
1,00:06:15,1,False,0,3,-3,9,9,1
1,00:02:59,1,True,10,0,10,20,10,1
1,00:02:23,2,True,10,0,10,15,5,1
2,00:14:32,1,True,10,3,7,27,10,1
2,00:13:34,2,False,3,10,-7,52,4,1
2,00:12:11,2,False,3,10,-7,32,15,1
2,00:02:30,1,True,20,3,17,36,10,1
2,00:01:54,2,False,3,20,-17,42,6,1
2,00:01:23,1,False,3,20,-17,12,10,1
3,00:11:18,1,False,3,20,-17,27,10,1
3,00:08:46,1,False,3,27,-24,38,10,1
3,00:08:24,1,False,3,27,-24,55,10,1
3,00:07:50,1,True,27,3,24,42,10,1
3,00:06:58,3,True,27,3,24,35,3,1
3,00:05:39,1,True,27,3,24,32,10,1
3,00:04:56,1,True,27,3,24,46,10,1
3,00:04:18,1,False,3,27,-24,28,10,1
3,00:02:25,1,False,3,27,-24,12,10,1
4,00:10:58,2,True,30,3,27,44,8,1
4,00:10:23,1,False,3,30,-27,38,10,1
4,00:09:09,1,False,3,30,-27,5,5,1
4,00:08:15,2,False,3,37,-34,40,6,1
4,00:06:41,1,True,37,3,34,7,10,1
4,00:03:51,1,False,3,37,-34,49,10,1
4,00:01:44,1,False,3,37,-34,47,10,1
4,00:01:35,2,False,3,37,-34,41,4,1
1,00:14:51,1,False,0,0,0,31,10,1
1,00:11:33,2,True,0,0,0,38,5,1
1,00:10:53,1,False,0,0,0,50,10,1
1,00:09:31,1,False,0,0,0,18,10,1
1,00:05:23,2,True,0,0,0,54,8,1
1,00:04:38,1,True,0,0,0,15,10,1
1,00:02:40,2,True,0,3,-3,40,5,1
1,00:00:58,1,False,3,0,3,9,10,1
1,00:00:11,1,False,3,0,3,31,10,1
2,00:11:36,1,False,3,0,3,36,10,1
2,00:08:37,2,True,7,3,4,27,10,1
2,00:07:03,1,False,3,7,-4,44,10,1
2,00:06:30,1,False,3,7,-4,55,10,1
2,00:05:53,2,True,7,3,4,51,6,1
2,00:01:44,1,True,7,4,3,54,10,1
2,00:01:38,2,True,7,4,3,47,3,1
2,00:01:14,1,True,7,4,3,43,10,1
2,00:01:01,2,True,7,4,3,27,10,1
2,00:00:56,1,True,7,4,3,17,10,1
2,00:00:32,1,True,7,4,3,5,5,1
2,00:00:10,2,True,7,4,3,1,1,1
3,00:13:34,1,False,11,7,4,52,10,1
3,00:10:02,1,False,11,7,4,43,10,1
3,00:08:50,1,True,7,11,-4,52,10,1
3,00:07:24,1,True,7,11,-4,16,10,1
3,00:06:12,2,True,7,11,-4,25,13,1
3,00:05:14,1,True,7,11,-4,37,10,1
3,00:04:23,1,True,7,11,-4,25,10,1
3,00:03:43,2,True,7,11,-4,20,5,1
3,00:02:51,1,True,7,14,-7,35,10,1
3,00:00:13,1,False,14,7,7,52,10,1
4,00:13:14,2,False,14,10,4,30,10,1
4,00:11:35,2,False,14,10,4,29,22,1
4,00:10:12,2,True,10,14,-4,34,8,1
4,00:09:19,1,False,14,10,4,23,10,1
4,00:08:54,1,False,14,17,-3,31,10,1
4,00:05:44,1,False,14,17,-3,40,10,1
4,00:04:30,1,True,17,14,3,33,10,1
4,00:02:29,2,False,14,17,-3,25,18,1
1,00:13:19,1,True,0,0,0,32,10,1
1,00:12:20,2,True,0,0,0,51,10,1
1,00:11:15,1,False,0,0,0,32,10,1
1,00:10:06,1,False,0,0,0,12,10,1
1,00:08:51,1,False,0,7,-7,3,3,1
1,00:07:40,2,False,0,14,-14,20,20,1
1,00:06:37,1,True,14,0,14,48,10,1
1,00:06:23,1,False,0,14,-14,51,10,1
1,00:04:40,2,False,0,14,-14,37,10,1
1,00:03:32,2,False,0,14,-14,25,10,1
1,00:02:32,2,True,14,0,14,48,8,1
1,00:01:28,1,False,0,14,-14,48,10,1
2,00:14:07,1,False,0,17,-17,53,10,1
2,00:12:28,2,True,17,0,17,13,9,1
2,00:09:30,2,True,17,0,17,11,13,1
2,00:07:55,2,True,17,0,17,34,6,1
2,00:06:45,1,False,0,17,-17,49,20,1
2,00:06:17,2,False,0,17,-17,37,8,1
2,00:02:17,2,True,20,0,20,37,6,1
2,00:00:55,1,False,0,20,-20,13,10,1
2,00:00:43,2,False,0,20,-20,19,4,1
2,00:00:21,2,False,0,20,-20,29,10,1
3,00:14:56,1,True,20,1,19,35,10,1
3,00:14:32,1,True,20,1,19,45,10,1
3,00:12:20,2,False,1,20,-19,52,8,1
3,00:09:52,1,True,20,1,19,25,10,1
3,00:09:25,2,True,20,1,19,30,5,1
3,00:08:54,1,False,1,20,-19,44,10,1
3,00:06:21,2,False,1,20,-19,16,8,1
3,00:05:50,1,False,1,20,-19,27,10,1
3,00:05:11,1,False,1,20,-19,40,10,1
3,00:02:27,1,True,20,2,18,35,10,1
3,00:00:39,2,False,2,20,-18,22,6,1
4,00:14:27,2,False,2,20,-18,35,5,1
4,00:13:56,1,False,2,20,-18,43,10,1
4,00:11:30,1,True,20,5,15,30,15,1
4,00:09:15,1,False,5,20,-15,47,10,1
4,00:08:34,2,False,5,20,-15,44,7,1
4,00:07:16,1,False,5,23,-18,35,10,1
4,00:04:32,1,False,5,23,-18,19,10,1
4,00:03:51,2,True,23,5,18,14,10,1
4,00:02:06,2,False,5,23,-18,47,10,1
4,00:00:53,2,False,5,23,-18,7,10,1
4,00:00:26,2,False,5,23,-18,44,10,1
1,00:14:53,1,False,0,0,0,44,10,1
1,00:13:49,2,True,0,0,0,35,10,1
1,00:09:59,2,False,3,0,3,50,4,1
1,00:09:24,1,False,3,0,3,39,10,1
1,00:08:50,1,False,3,0,3,28,10,1
1,00:05:50,1,False,3,3,0,48,10,1
1,00:05:16,1,True,3,3,0,42,10,1
1,00:03:55,1,True,3,3,0,4,10,1
1,00:03:18,2,True,3,3,0,6,8,1
1,00:02:07,2,True,3,3,0,43,9,1
1,00:00:37,1,False,3,3,0,31,10,1
2,00:15:00,2,True,3,3,0,54,5,1
2,00:14:11,1,True,3,3,0,21,10,1
2,00:13:53,1,True,3,10,-7,29,10,1
2,00:11:53,2,False,10,3,7,45,5,1
2,00:11:06,3,False,10,3,7,43,3,1
2,00:07:38,1,False,10,6,4,54,10,1
2,00:06:27,1,False,10,6,4,25,10,1
2,00:04:58,1,True,6,10,-4,50,10,1
2,00:04:37,2,True,6,10,-4,44,4,1
2,00:02:12,1,True,6,17,-11,22,10,1
2,00:02:08,2,True,6,17,-11,28,4,1
2,00:01:53,1,True,6,17,-11,33,10,1
2,00:01:35,2,True,6,17,-11,39,4,1
2,00:01:25,1,True,6,17,-11,54,10,1
2,00:01:01,1,False,17,6,11,46,10,1
2,00:00:55,1,False,17,13,4,45,10,1
2,00:00:49,2,False,17,13,4,50,5,1
2,00:00:23,1,True,13,17,-4,24,10,1
3,00:13:40,1,True,13,24,-11,39,10,1
3,00:13:07,2,True,13,24,-11,45,4,1
3,00:11:18,1,False,24,13,11,19,10,1
3,00:06:57,2,False,24,13,11,23,7,1
3,00:05:56,1,False,24,16,8,41,10,1
3,00:04:32,2,True,16,24,-8,40,5,1
3,00:03:20,2,True,16,24,-8,24,10,1
3,00:01:24,1,True,16,27,-11,46,10,1
4,00:14:39,1,False,27,16,11,44,10,1
4,00:13:37,2,True,16,27,-11,49,9,1
4,00:09:53,1,False,30,16,14,49,10,1
4,00:09:09,2,False,30,16,14,50,11,1
4,00:08:31,1,False,30,16,14,36,10,1
4,00:07:29,3,False,30,16,14,34,8,1
4,00:07:14,1,False,30,16,14,30,10,1
4,00:06:09,2,False,30,16,14,49,3,1
4,00:05:08,2,True,16,30,-14,53,8,1
4,00:04:26,1,True,16,30,-14,36,10,1
4,00:03:42,2,True,16,30,-14,35,9,1
4,00:03:10,1,True,16,30,-14,22,10,1
4,00:02:18,1,True,16,33,-17,35,10,1
1,00:14:17,2,True,0,0,0,42,5,1
1,00:13:37,1,False,0,0,0,22,10,1
1,00:11:32,2,False,0,3,-3,35,10,1
1,00:10:34,1,True,3,0,3,45,10,1
1,00:08:40,1,False,0,4,-4,35,10,1
1,00:05:19,2,True,4,0,4,36,4,1
1,00:04:39,1,True,4,0,4,52,10,1
1,00:00:35,2,False,0,4,-4,34,7,1
2,00:11:14,1,False,0,4,-4,45,10,1
2,00:09:06,1,False,0,11,-11,13,10,1
2,00:08:24,1,False,0,11,-11,28,10,1
2,00:04:20,2,True,11,3,8,37,10,1
2,00:02:41,1,True,11,6,5,35,10,1
2,00:01:45,1,False,6,11,-5,30,10,1
3,00:14:35,2,False,6,11,-5,32,10,1
3,00:13:44,1,True,11,6,5,34,10,1
3,00:12:41,1,False,6,11,-5,37,10,1
3,00:08:01,2,True,14,6,8,34,10,1
3,00:06:35,2,True,14,6,8,52,4,1
3,00:06:06,1,False,6,14,-8,52,10,1
3,00:01:36,2,False,6,14,-8,40,6,1
3,00:00:39,2,False,6,14,-8,23,4,1
4,00:13:51,1,False,6,14,-8,15,15,1
4,00:12:29,2,False,6,14,-8,15,15,1
4,00:12:02,1,False,6,21,-15,25,10,1
4,00:10:59,2,False,6,21,-15,30,15,1
4,00:09:51,1,True,21,6,15,46,10,1
4,00:08:44,2,True,21,6,15,21,10,1
4,00:06:18,2,True,21,9,12,40,8,1
4,00:05:21,1,False,9,21,-12,24,10,1
4,00:04:40,2,False,9,21,-12,20,6,1
4,00:02:43,2,False,9,28,-19,13,10,1
4,00:02:30,2,False,9,28,-19,27,15,1
4,00:02:10,2,False,9,28,-19,40,17,1
4,00:00:56,2,False,9,29,-20,35,10,1
4,00:00:48,1,False,9,29,-20,50,10,1
4,00:00:38,2,True,29,9,20,50,0,1
4,00:00:19,1,True,29,9,20,17,10,1
1,00:14:51,1,False,0,0,0,36,10,1
1,00:14:15,1,False,0,0,0,50,10,1
1,00:13:15,2,True,0,0,0,40,4,1
1,00:12:46,1,True,0,0,0,36,10,1
1,00:11:28,1,True,0,1,-1,35,10,1
1,00:09:33,1,False,1,0,1,29,10,1
1,00:07:20,2,False,1,0,1,11,4,1
1,00:05:17,1,False,1,0,1,33,10,1
1,00:04:15,1,False,1,0,1,53,15,1
1,00:03:32,2,False,1,0,1,49,19,1
2,00:14:02,1,False,1,0,1,6,6,1
2,00:10:10,1,True,7,1,6,40,10,1
2,00:07:42,2,True,7,1,6,18,10,1
2,00:06:20,2,True,7,4,3,41,10,1
3,00:12:33,1,False,4,16,-12,24,10,1
3,00:11:29,1,False,4,16,-12,40,10,1
3,00:11:01,1,False,4,23,-19,31,10,1
3,00:09:08,1,True,23,4,19,44,10,1
3,00:03:23,2,False,7,23,-16,15,8,1
3,00:02:18,1,True,23,7,16,52,10,1
3,00:00:01,1,False,7,24,-17,35,10,1
4,00:15:00,2,False,7,24,-17,41,4,1
4,00:14:27,1,False,7,24,-17,47,10,1
4,00:14:00,1,True,24,7,17,44,10,1
4,00:13:20,2,True,24,7,17,39,5,1
4,00:11:42,2,True,24,7,17,35,7,1
4,00:09:53,1,False,7,24,-17,41,10,1
4,00:08:58,1,False,7,24,-17,52,10,1
4,00:08:24,1,False,7,24,-17,55,10,1
4,00:07:34,1,True,24,7,17,35,10,1
4,00:07:24,2,True,24,7,17,29,4,1
4,00:01:04,1,False,17,24,-7,6,10,1
4,00:00:58,1,False,17,24,-7,18,10,1
4,00:00:24,3,False,17,24,-7,20,8,1
1,00:14:53,1,False,0,0,0,27,10,1
1,00:08:44,2,False,0,0,0,37,10,1
1,00:04:20,2,False,0,1,-1,41,4,1
1,00:01:37,1,True,1,0,1,42,10,1
2,00:12:29,1,True,1,0,1,30,10,1
2,00:08:51,2,False,0,1,-1,53,8,1
2,00:08:08,1,False,0,1,-1,40,10,1
2,00:07:32,2,False,0,1,-1,33,3,1
2,00:06:53,1,False,0,1,-1,22,10,1
2,00:05:40,1,False,0,1,-1,10,10,1
2,00:03:59,2,False,0,8,-8,55,10,1
2,00:01:45,1,False,3,8,-5,44,10,1
2,00:01:09,2,False,3,8,-5,16,10,1
2,00:00:43,1,False,3,15,-12,54,10,1
3,00:14:20,2,True,15,3,12,33,9,1
3,00:09:06,1,False,3,22,-19,33,10,1
3,00:08:14,1,False,3,22,-19,45,10,1
3,00:05:03,2,False,3,22,-19,33,10,1
3,00:00:03,2,True,36,3,33,53,4,1
4,00:14:29,1,True,36,3,33,48,10,1
4,00:13:44,3,True,36,3,33,47,9,1
4,00:08:10,2,False,3,50,-47,49,9,1
4,00:06:49,1,False,3,50,-47,30,10,1
4,00:02:14,2,True,50,3,47,8,5,1
4,00:00:40,2,True,50,11,39,8,8,1
1,00:13:16,2,False,0,0,0,17,10,1
1,00:11:27,2,False,0,0,0,46,3,1
1,00:10:17,2,False,0,7,-7,39,13,1
1,00:06:22,2,True,7,1,6,30,15,1
1,00:05:30,1,False,1,7,-6,17,10,1
1,00:02:37,1,False,1,7,-6,54,10,1
1,00:01:22,1,True,7,1,6,45,10,1
2,00:10:38,1,False,1,15,-14,35,10,1
2,00:08:50,2,True,15,1,14,32,10,1
2,00:08:07,2,False,1,22,-21,32,7,1
2,00:07:24,1,False,1,22,-21,40,10,1
2,00:05:30,2,True,22,1,21,30,6,1
2,00:04:17,2,False,1,22,-21,31,10,1
2,00:02:41,2,False,1,22,-21,55,10,1
2,00:01:35,2,True,22,4,18,45,10,1
2,00:01:10,1,False,4,22,-18,49,10,1
2,00:00:40,1,False,4,22,-18,19,10,1
3,00:14:07,2,False,4,29,-25,33,4,1
3,00:11:56,2,False,4,29,-25,47,10,1
3,00:10:25,2,False,4,29,-25,30,6,1
3,00:10:01,1,False,4,36,-32,31,10,1
3,00:09:26,2,False,4,36,-32,39,2,1
3,00:09:08,1,False,4,36,-32,46,10,1
3,00:08:42,1,True,36,4,32,27,10,1
3,00:07:36,1,True,36,4,32,15,10,1
3,00:06:06,2,True,36,4,32,3,3,1
3,00:03:58,2,False,11,36,-25,46,9,1
3,00:03:11,1,True,36,11,25,16,10,1
3,00:01:27,1,False,18,36,-18,46,10,1
4,00:14:27,1,True,36,18,18,23,10,1
4,00:14:01,2,True,36,18,18,28,5,1
4,00:12:31,2,True,36,18,18,38,12,1
4,00:11:16,1,True,36,18,18,51,10,1
4,00:10:45,1,True,36,18,18,32,10,1
4,00:09:04,2,True,36,18,18,28,10,1
4,00:01:53,3,False,18,43,-25,42,10,1
4,00:00:55,1,False,18,43,-25,50,10,1
4,00:00:35,2,True,43,18,25,53,20,1
4,00:00:27,3,True,43,18,25,44,11,1
1,00:14:54,1,False,0,0,0,28,10,1
1,00:09:36,1,False,0,0,0,49,10,1
1,00:08:12,1,True,0,0,0,55,10,1
1,00:07:36,1,False,0,0,0,27,10,1
1,00:06:53,2,False,0,0,0,20,3,1
1,00:06:10,1,False,0,0,0,14,10,1
1,00:03:33,1,True,7,0,7,44,10,1
1,00:01:22,2,True,7,0,7,46,20,1
1,00:00:46,1,False,0,7,-7,36,10,1
2,00:15:00,1,False,0,7,-7,25,10,1
2,00:13:51,1,False,0,14,-14,26,10,1
2,00:11:57,1,True,14,0,14,14,10,1
2,00:09:50,1,False,0,14,-14,23,10,1
2,00:08:31,1,False,0,14,-14,37,10,1
2,00:07:52,1,False,0,14,-14,49,10,1
2,00:07:05,1,True,14,0,14,25,10,1
2,00:05:31,1,True,14,0,14,23,10,1
2,00:04:42,1,False,0,14,-14,44,10,1
2,00:03:56,1,False,0,14,-14,19,10,1
2,00:02:25,2,False,0,14,-14,9,9,1
2,00:02:17,1,False,0,17,-17,35,10,1
2,00:01:21,1,True,17,0,17,45,10,1
2,00:01:15,1,True,17,7,10,39,10,1
3,00:14:53,1,True,17,7,10,31,10,1
3,00:13:34,2,False,7,17,-10,53,3,1
3,00:12:24,1,False,7,17,-10,52,10,1
3,00:10:52,1,True,17,7,10,15,10,1
3,00:10:07,1,True,17,7,10,27,10,1
3,00:09:45,1,True,17,7,10,43,10,1
3,00:09:06,2,True,17,7,10,48,5,1
3,00:08:22,1,False,7,17,-10,50,10,1
3,00:07:39,2,False,7,17,-10,51,11,1
3,00:03:40,2,False,7,20,-13,32,13,1
3,00:00:20,1,False,7,20,-13,44,10,1
4,00:15:00,2,False,7,20,-13,50,4,1
4,00:14:21,1,True,20,7,13,53,10,1
4,00:13:56,1,True,20,7,13,37,10,1
4,00:11:09,1,True,20,10,10,50,10,1
4,00:09:24,2,True,20,10,10,39,10,1
4,00:08:33,1,True,20,10,10,26,10,1
4,00:04:12,1,False,13,20,-7,41,10,1
4,00:03:28,1,True,20,13,7,47,10,1
4,00:03:04,2,True,20,13,7,43,6,1
4,00:02:00,2,True,20,16,4,35,10,1
4,00:01:33,2,True,20,16,4,50,7,1
4,00:00:30,2,False,16,20,-4,3,19,1
4,00:00:24,1,False,16,20,-4,23,10,1
4,00:00:16,2,False,16,20,-4,32,1,1
1,00:13:48,1,False,0,0,0,39,10,1
1,00:13:12,1,False,0,0,0,28,10,1
1,00:12:25,2,False,0,0,0,33,15,1
1,00:11:19,2,False,0,3,-3,35,10,1
1,00:10:15,1,True,3,0,3,37,10,1
1,00:09:43,2,True,3,0,3,33,14,1
2,00:13:04,2,False,0,7,-7,44,10,1
2,00:12:05,1,False,0,7,-7,15,10,1
2,00:10:37,1,False,0,7,-7,31,10,1
2,00:09:23,1,False,0,7,-7,18,10,1
2,00:03:45,1,False,0,17,-17,25,10,1
2,00:02:46,2,False,0,17,-17,28,7,1
2,00:02:25,1,False,0,17,-17,35,10,1
2,00:00:44,2,True,17,0,17,54,10,1
2,00:00:32,2,True,17,7,10,48,4,1
2,00:00:25,1,True,17,7,10,53,10,1
3,00:14:55,1,True,17,7,10,29,10,1
3,00:12:40,2,False,7,17,-10,22,16,1
3,00:10:40,1,True,17,7,10,13,10,1
3,00:05:05,2,False,7,18,-11,47,10,1
3,00:04:17,1,True,18,7,11,51,10,1
3,00:02:47,1,True,18,7,11,28,10,1
4,00:15:00,2,False,10,18,-8,44,16,1
4,00:12:57,1,False,10,18,-8,35,10,1
4,00:11:18,1,True,18,10,8,12,10,1
4,00:09:07,2,True,18,10,8,19,15,1
4,00:07:23,1,True,18,10,8,36,10,1
4,00:06:03,2,False,10,18,-8,50,3,1
4,00:03:18,1,False,10,18,-8,24,10,1
4,00:02:55,1,False,10,18,-8,54,10,1
4,00:01:44,1,True,18,10,8,37,10,1
4,00:01:37,2,True,18,10,8,40,7,1
1,00:11:15,1,False,0,0,0,44,10,1
1,00:09:31,2,True,0,0,0,50,5,1
1,00:08:16,2,True,0,0,0,37,7,1
1,00:07:19,1,True,0,0,0,22,10,1
1,00:04:10,1,True,0,7,-7,47,10,1
1,00:03:37,1,False,7,0,7,52,10,1
1,00:01:01,2,False,7,3,4,23,18,1
2,00:14:13,1,False,7,3,4,36,10,1
2,00:10:52,1,False,7,10,-3,25,10,1
2,00:09:34,1,False,7,10,-3,40,10,1
2,00:08:56,2,False,7,10,-3,44,6,1
2,00:07:12,1,True,10,7,3,45,10,1
2,00:04:50,1,True,10,7,3,9,9,1
2,00:04:21,1,True,10,14,-4,28,10,1
2,00:03:19,1,True,10,14,-4,38,10,1
2,00:02:57,1,True,10,14,-4,53,10,1
2,00:02:42,2,True,10,14,-4,54,9,1
2,00:01:59,2,False,14,10,4,41,10,1
2,00:01:50,1,False,14,10,4,19,10,1
2,00:01:20,1,False,14,13,1,35,10,1
2,00:01:14,2,False,14,13,1,41,4,1
3,00:11:54,1,True,20,14,6,11,10,1
3,00:10:48,2,True,20,14,6,19,12,1
3,00:10:12,2,True,20,14,6,33,10,1
3,00:08:16,1,False,14,20,-6,27,10,1
3,00:05:42,1,False,14,27,-13,29,10,1
3,00:03:41,2,True,27,14,13,50,8,1
3,00:02:41,1,True,27,14,13,42,10,1
3,00:00:34,1,True,27,17,10,34,10,1
4,00:11:48,1,False,17,27,-10,29,10,1
4,00:10:06,1,False,17,27,-10,47,10,1
4,00:09:49,1,True,27,24,3,32,10,1
4,00:07:45,1,False,24,27,-3,46,10,1
4,00:07:26,2,False,24,27,-3,39,3,1
4,00:05:28,1,False,24,30,-6,35,10,1
4,00:04:59,2,False,24,30,-6,36,9,1
4,00:02:53,2,False,24,37,-13,28,20,1
4,00:02:41,3,False,24,37,-13,43,5,1
4,00:00:43,1,False,24,40,-16,36,10,1
4,00:00:37,1,False,24,40,-16,50,10,1
4,00:00:24,1,True,40,24,16,45,10,1
4,00:00:13,2,True,40,24,16,35,0,1
1,00:14:55,1,False,0,0,0,43,10,1
1,00:13:49,2,False,0,0,0,53,10,1
1,00:11:20,1,False,0,0,0,52,10,1
1,00:09:01,2,True,0,0,0,19,6,1
1,00:06:13,2,True,0,0,0,37,13,1
1,00:05:36,1,False,0,7,-7,34,10,1
1,00:05:20,2,False,0,7,-7,39,5,1
1,00:03:03,1,True,7,0,7,40,10,1
1,00:02:45,2,True,7,0,7,45,5,1
1,00:00:59,2,True,7,0,7,41,19,1
2,00:15:00,1,False,0,7,-7,25,10,1
2,00:12:35,2,True,7,0,7,50,15,1
2,00:10:47,1,False,0,7,-7,28,10,1
2,00:08:53,1,False,0,10,-10,21,10,1
2,00:07:03,1,True,10,0,10,22,10,1
2,00:04:23,1,False,0,13,-13,21,15,1
2,00:02:25,2,False,0,13,-13,23,10,1
2,00:00:26,1,False,0,20,-20,27,10,1
2,00:00:20,1,False,0,20,-20,37,10,1
3,00:14:24,1,False,0,27,-27,15,10,1
3,00:13:04,1,False,0,27,-27,27,15,1
3,00:11:01,1,False,0,27,-27,47,10,1
3,00:10:41,2,False,0,27,-27,40,3,1
3,00:08:10,2,False,0,34,-34,25,10,1
3,00:05:50,1,True,34,0,34,55,10,1
3,00:03:43,1,False,0,34,-34,25,10,1
3,00:03:19,2,False,0,34,-34,30,5,1
3,00:02:34,1,False,0,34,-34,35,10,1
3,00:01:57,2,False,0,34,-34,41,4,1
3,00:00:12,3,True,34,0,34,50,3,1
4,00:15:00,1,True,34,0,34,36,10,1
4,00:14:34,1,True,34,0,34,26,10,1
4,00:13:26,1,True,34,0,34,15,10,1
4,00:09:18,2,False,7,37,-30,30,9,1
4,00:07:58,1,True,37,7,30,36,10,1
4,00:06:40,1,False,7,37,-30,41,10,1
4,00:06:10,2,False,7,37,-30,47,4,1
1,00:14:55,1,True,0,0,0,29,10,1
1,00:13:12,2,False,0,0,0,46,7,1
1,00:10:42,2,True,0,0,0,48,15,1
1,00:09:07,2,False,0,0,0,21,11,1
1,00:06:43,2,False,0,0,0,36,10,1
1,00:01:58,2,True,6,0,6,30,8,1
1,00:01:24,1,True,6,0,6,21,10,1
2,00:13:20,1,False,3,6,-3,55,10,1
2,00:11:59,2,True,6,3,3,51,17,1
2,00:11:01,1,True,6,6,0,35,10,1
2,00:10:40,2,True,6,6,0,38,7,1
2,00:10:02,1,True,6,6,0,53,10,1
2,00:08:12,1,False,6,6,0,55,10,1
2,00:05:43,2,True,6,6,0,28,3,1
2,00:04:52,1,True,6,6,0,32,10,1
2,00:04:26,2,True,6,6,0,33,9,1
2,00:02:27,1,True,6,6,0,33,10,1
2,00:02:13,1,True,6,6,0,46,10,1
2,00:01:21,1,True,6,6,0,47,10,1
2,00:00:30,1,True,6,6,0,11,10,1
2,00:00:22,1,True,6,12,-6,37,10,1
3,00:09:59,2,True,7,13,-6,25,19,1
3,00:09:00,1,True,7,13,-6,53,10,1
3,00:06:20,2,False,20,7,13,50,9,1
3,00:03:43,1,True,14,20,-6,30,10,1
3,00:02:07,2,True,14,20,-6,42,10,1
3,00:00:31,1,True,14,27,-13,28,10,1
4,00:12:30,0,True,14,27,-13,39,0,1
4,00:11:43,1,True,14,27,-13,50,10,1
4,00:08:30,1,True,14,34,-20,27,10,1
4,00:08:07,1,True,14,34,-20,41,10,1
4,00:07:26,2,True,14,34,-20,39,12,1
4,00:07:09,1,True,14,34,-20,55,10,1
4,00:02:45,1,True,20,34,-14,44,15,1
4,00:02:17,2,True,20,34,-14,38,21,1
4,00:02:06,2,False,34,27,7,17,8,1
4,00:01:55,1,True,27,34,-7,45,10,1
1,00:14:36,1,True,0,0,0,33,10,1
1,00:14:03,2,True,0,0,0,40,3,1
1,00:11:17,2,False,0,0,0,45,3,1
1,00:07:43,2,False,0,3,-3,32,5,1
1,00:07:16,1,False,0,3,-3,37,10,1
1,00:04:11,2,True,3,3,0,29,10,1
1,00:03:30,1,True,3,3,0,42,10,1
1,00:01:19,1,False,3,3,0,54,10,1
1,00:00:50,1,False,3,3,0,45,10,1
1,00:00:20,1,False,3,3,0,33,10,1
2,00:13:56,1,False,3,6,-3,27,10,1
2,00:08:32,1,True,6,3,3,37,10,1
2,00:05:42,1,True,6,3,3,42,10,1
2,00:04:18,2,False,3,6,-3,49,6,1
2,00:03:00,2,True,6,3,3,54,10,1
2,00:01:44,1,True,6,6,0,32,10,1
3,00:14:54,1,False,6,6,0,26,10,1
3,00:13:49,1,False,6,6,0,54,10,1
3,00:13:09,1,False,6,6,0,40,10,1
3,00:11:53,1,False,6,9,-3,27,10,1
3,00:10:04,2,False,6,9,-3,44,7,1
3,00:08:54,2,False,6,9,-3,31,9,1
3,00:07:42,1,False,6,9,-3,31,20,1
3,00:04:53,1,True,12,6,6,22,20,1
3,00:04:08,2,True,12,6,6,34,8,1
3,00:01:19,2,False,6,12,-6,48,10,1
4,00:14:30,1,False,6,12,-6,48,10,1
4,00:13:13,1,False,6,12,-6,38,10,1
4,00:11:10,1,False,6,12,-6,24,10,1
4,00:10:33,1,False,6,20,-14,52,10,1
4,00:08:30,2,True,20,6,14,43,5,1
4,00:06:22,1,True,20,6,14,50,10,1
4,00:04:47,2,False,6,20,-14,46,7,1
4,00:03:00,2,False,6,20,-14,36,9,1
1,00:12:11,2,False,0,0,0,26,2,1
1,00:10:31,1,True,0,0,0,35,10,1
1,00:10:03,2,True,0,0,0,40,5,1
1,00:09:13,2,False,0,0,0,50,3,1
1,00:08:40,1,False,0,0,0,39,10,1
1,00:06:46,2,False,0,0,0,18,5,1
1,00:14:28,1,True,0,0,0,17,20,1
1,00:13:57,2,True,0,0,0,24,13,1
1,00:11:26,1,True,0,0,0,34,10,1
1,00:09:08,3,False,0,0,0,32,5,1
1,00:02:35,1,True,0,1,-1,35,10,1
1,00:01:54,2,True,0,1,-1,41,4,1
1,00:00:58,1,False,1,0,1,39,10,1
2,00:15:00,1,True,0,1,-1,7,10,1
2,00:14:28,1,True,0,1,-1,23,10,1
2,00:12:10,1,True,0,1,-1,50,10,1
2,00:06:01,2,False,4,0,4,48,5,1
2,00:03:12,1,False,4,0,4,44,10,1
2,00:01:26,1,True,3,4,-1,7,7,1
2,00:01:02,2,True,3,12,-9,6,5,1
3,00:14:20,2,False,12,3,9,40,7,1
3,00:12:08,1,True,3,12,-9,20,10,1
3,00:09:45,2,False,12,3,9,40,10,1
3,00:05:25,2,True,3,12,-9,34,8,1
3,00:02:20,2,True,3,19,-16,38,8,1
4,00:14:00,2,False,19,3,16,55,10,1
4,00:11:52,1,False,19,3,16,40,10,1
1,00:14:50,1,False,0,0,0,46,10,1
1,00:13:35,2,False,0,0,0,35,11,1
1,00:09:06,1,False,0,7,-7,55,10,1
1,00:06:21,2,True,7,3,4,38,6,1
1,00:03:00,1,False,3,7,-4,42,20,1
1,00:02:10,2,False,3,7,-4,45,17,1
1,00:01:01,1,True,7,3,4,30,10,1
2,00:14:32,1,False,3,7,-4,35,10,1
2,00:13:09,2,False,3,7,-4,49,10,1
2,00:10:21,2,True,7,10,-3,22,10,1
2,00:09:11,1,True,7,10,-3,37,10,1
2,00:08:19,2,True,7,10,-3,26,10,1
2,00:07:25,1,True,7,13,-6,8,10,1
2,00:05:27,1,True,7,20,-13,23,10,1
2,00:02:21,2,False,20,7,13,35,9,1
2,00:00:46,2,False,22,7,15,33,10,1
2,00:00:40,1,False,22,7,15,9,9,1
3,00:14:20,2,True,7,22,-15,33,9,1
3,00:11:06,3,True,7,22,-15,7,7,1
3,00:07:30,2,False,30,7,23,50,10,1
3,00:04:20,1,False,30,7,23,52,10,1
3,00:03:31,2,True,7,30,-23,54,14,1
3,00:00:01,2,False,30,7,23,35,21,1
4,00:14:01,2,False,30,10,20,33,12,1
4,00:06:18,1,False,30,10,20,32,10,1
4,00:05:42,1,False,30,10,20,45,10,1
4,00:01:08,1,True,10,30,-20,35,10,1
1,00:14:52,1,True,0,0,0,46,10,1
1,00:14:25,1,True,0,0,0,28,10,1
1,00:13:36,1,True,0,0,0,15,10,1
1,00:13:16,1,True,0,7,-7,38,10,1
1,00:12:37,2,True,0,7,-7,42,6,1
1,00:12:14,1,False,7,0,7,23,10,1
1,00:07:45,1,False,7,7,0,29,10,1
1,00:07:03,2,False,7,7,0,48,10,1
1,00:06:47,1,True,7,7,0,39,10,1
1,00:04:41,1,True,7,10,-3,30,10,1
1,00:02:16,1,False,10,7,3,13,10,1
1,00:01:35,2,False,10,7,3,19,4,1
1,00:00:01,1,True,7,10,-3,49,10,1
2,00:15:00,1,True,7,10,-3,29,10,1
2,00:10:19,1,False,13,7,6,55,10,1
2,00:09:01,1,True,7,13,-6,44,10,1
2,00:08:22,1,True,7,13,-6,20,10,1
2,00:05:40,1,True,7,20,-13,29,10,1
2,00:05:15,2,True,7,20,-13,35,4,1
2,00:02:39,2,True,7,20,-13,53,11,1
2,00:01:48,2,False,20,7,13,34,10,1
2,00:01:40,1,False,20,7,13,50,10,1
2,00:01:01,1,True,7,20,-13,32,10,1
2,00:00:56,1,True,7,20,-13,44,10,1
2,00:00:38,1,True,7,20,-13,55,10,1
2,00:00:29,2,False,20,7,13,48,3,1
3,00:12:34,2,False,20,7,13,40,10,1
3,00:08:22,1,True,7,20,-13,33,10,1
3,00:05:48,2,True,7,23,-16,38,10,1
3,00:05:10,1,True,7,23,-16,51,10,1
3,00:01:48,1,False,23,7,16,51,10,1
4,00:13:25,1,True,13,23,-10,34,10,1
4,00:12:40,1,True,13,23,-10,15,10,1
4,00:11:21,1,True,13,26,-13,35,10,1
4,00:10:48,1,True,13,26,-13,50,10,1
4,00:08:05,2,False,26,13,13,16,11,1
4,00:07:11,2,False,26,13,13,40,8,1
4,00:06:12,1,True,13,26,-13,23,10,1
4,00:03:58,1,False,26,13,13,44,20,1
4,00:03:20,2,False,26,13,13,31,7,1
4,00:02:42,3,False,26,13,13,17,10,1
4,00:01:34,2,True,15,26,-11,35,10,1
4,00:01:27,1,True,15,26,-11,45,10,1
4,00:01:21,2,True,15,26,-11,51,4,1
4,00:01:00,2,False,26,15,11,44,2,1
4,00:00:47,1,False,26,15,11,37,10,1
4,00:00:21,3,False,26,15,11,33,6,1
4,00:00:01,1,False,26,15,11,11,10,1
1,00:13:07,1,False,0,0,0,45,10,1
1,00:12:11,1,False,0,0,0,11,10,1
1,00:11:03,2,False,0,6,-6,29,7,1
1,00:09:50,2,True,6,0,6,26,9,1
1,00:03:06,1,False,3,6,-3,26,10,1
1,00:01:42,1,True,6,3,3,41,10,1
1,00:00:43,1,True,6,3,3,54,10,1
1,00:00:01,2,False,3,6,-3,53,7,1
2,00:15:00,1,False,3,6,-3,43,10,1
2,00:10:50,1,True,13,10,3,47,10,1
2,00:08:13,1,False,10,16,-6,18,10,1
2,00:05:22,2,False,10,19,-9,52,10,1
2,00:03:04,2,True,19,10,9,50,20,1
2,00:01:40,1,True,19,10,9,50,10,1
2,00:01:17,1,False,10,19,-9,49,10,1
2,00:00:19,1,False,10,19,-9,50,10,1
2,00:00:01,2,False,10,19,-9,54,6,1
3,00:14:45,1,False,13,19,-6,40,10,1
3,00:13:40,2,False,13,19,-6,55,8,1
3,00:13:20,1,True,19,13,6,30,10,1
3,00:11:47,1,True,19,16,3,35,10,1
3,00:11:18,2,True,19,16,3,41,4,1
3,00:09:36,1,False,16,19,-3,52,10,1
3,00:08:52,2,False,16,19,-3,45,3,1
3,00:08:22,1,False,16,19,-3,33,10,1
3,00:05:07,2,True,19,16,3,52,8,1
3,00:03:36,2,False,16,19,-3,39,6,1
3,00:03:13,1,False,16,19,-3,32,10,1
3,00:02:27,1,False,16,19,-3,21,10,1
3,00:01:56,1,False,16,27,-11,47,10,1
4,00:15:00,1,True,27,16,11,15,10,1
4,00:13:35,1,True,27,23,4,29,10,1
4,00:13:03,2,True,27,23,4,38,1,1
4,00:12:26,1,True,27,23,4,44,10,1
4,00:10:59,2,False,23,27,-4,52,7,1
4,00:10:05,2,False,23,27,-4,41,7,1
4,00:08:25,2,False,23,30,-7,41,5,1
4,00:08:03,1,False,23,30,-7,53,10,1
4,00:07:13,2,True,30,23,7,22,10,1
4,00:05:51,2,True,30,23,7,9,9,1
4,00:05:25,1,True,30,30,0,23,10,1
4,00:02:33,1,True,30,30,0,52,10,1
4,00:01:42,2,True,30,30,0,25,5,1
4,00:00:29,1,True,30,37,-7,33,10,1
4,00:00:01,3,True,30,37,-7,45,13,1
1,00:14:47,1,True,0,0,0,45,10,1
1,00:14:13,2,True,0,0,0,46,9,1
1,00:10:54,1,False,0,6,-6,31,10,1
1,00:10:21,1,False,0,6,-6,42,10,1
1,00:09:43,1,True,6,0,6,50,10,1
1,00:08:25,2,True,6,0,6,34,8,1
1,00:06:50,1,False,0,6,-6,46,10,1
2,00:14:38,2,False,0,6,-6,35,12,1
2,00:11:49,1,True,6,0,6,38,10,1
2,00:08:53,1,False,5,6,-1,50,10,1
2,00:05:42,2,False,5,6,-1,4,4,1
2,00:02:32,2,False,5,13,-8,39,11,1
2,00:01:07,2,True,13,5,8,30,10,1
3,00:14:40,2,False,5,13,-8,27,8,1
3,00:12:58,2,False,5,13,-8,46,5,1
3,00:12:15,1,True,13,5,8,51,10,1
3,00:11:40,2,True,13,5,8,45,4,1
3,00:08:33,2,True,13,5,8,13,10,1
3,00:05:03,2,True,13,13,0,37,10,1
3,00:03:50,2,False,13,13,0,47,8,1
3,00:02:24,2,False,13,13,0,41,12,1
3,00:01:07,2,False,13,16,-3,30,15,1
3,00:00:03,1,True,16,13,3,45,10,1
4,00:14:26,1,True,16,13,3,55,10,1
4,00:13:39,1,False,13,16,-3,46,10,1
4,00:12:45,1,True,16,13,3,33,10,1
4,00:11:23,2,True,16,13,3,13,7,1
4,00:08:35,1,False,20,16,4,31,10,1
4,00:03:22,2,False,20,16,4,7,8,1
4,00:03:00,1,False,20,16,4,20,10,1
4,00:02:14,2,False,20,16,4,38,6,1
1,00:14:12,1,True,0,0,0,17,10,1
1,00:13:09,2,True,0,0,0,35,4,1
1,00:11:43,2,True,0,0,0,51,3,1
1,00:09:23,2,True,0,7,-7,29,6,1
1,00:08:43,1,True,0,7,-7,36,10,1
1,00:08:05,1,True,0,7,-7,52,10,1
1,00:05:26,2,False,7,0,7,30,10,1
1,00:05:00,1,False,7,7,0,25,10,1
1,00:04:40,1,False,7,7,0,35,10,1
1,00:04:04,2,False,7,7,0,39,6,1
1,00:03:33,1,False,7,7,0,51,10,1
1,00:02:12,2,True,7,7,0,23,10,1
2,00:12:54,2,False,15,7,8,21,10,1
2,00:11:28,2,False,15,7,8,32,9,1
2,00:10:00,1,True,9,15,-6,45,10,1
2,00:09:38,2,True,9,15,-6,51,4,1
2,00:06:57,1,False,15,10,5,35,10,1
2,00:05:55,1,False,15,10,5,35,10,1
2,00:04:30,1,False,15,10,5,48,10,1
2,00:02:45,2,False,15,10,5,52,8,1
2,00:02:17,2,True,10,15,-5,43,8,1
2,00:01:45,2,True,10,15,-5,34,10,1
3,00:14:50,1,False,18,10,8,20,10,1
3,00:14:21,1,False,18,10,8,34,10,1
3,00:12:40,1,False,18,10,8,46,10,1
3,00:10:54,1,False,18,10,8,16,10,1
3,00:10:08,1,False,18,10,8,26,10,1
3,00:09:19,1,False,18,10,8,35,15,1
3,00:08:49,2,False,18,10,8,41,9,1
3,00:08:05,1,True,10,18,-8,29,10,1
3,00:07:30,2,True,10,18,-8,25,5,1
3,00:04:21,2,True,18,18,0,25,6,1
3,00:03:05,1,False,18,18,0,40,10,1
3,00:02:07,2,True,18,18,0,50,6,1
3,00:01:23,2,True,18,18,0,40,10,1
3,00:00:38,2,True,18,18,0,27,10,1
4,00:15:00,1,True,18,21,-3,35,10,1
4,00:12:22,2,True,18,21,-3,48,6,1
4,00:09:29,2,True,18,22,-4,39,6,1
4,00:08:54,1,True,18,22,-4,45,10,1
4,00:07:26,2,False,22,18,4,12,5,1
4,00:07:03,1,False,22,18,4,7,7,1
4,00:02:35,1,False,22,21,1,35,10,1
4,00:02:31,2,False,22,21,1,41,4,1
4,00:01:45,2,False,22,21,1,51,6,1
4,00:00:27,3,True,21,23,-2,38,18,1
4,00:00:17,1,False,23,21,2,44,10,1
1,00:14:47,1,True,0,0,0,23,10,1
1,00:14:25,1,True,0,0,0,37,10,1
1,00:12:08,1,True,2,0,2,41,10,1
1,00:10:24,2,True,2,0,2,29,30,1
1,00:08:22,1,True,2,0,2,53,10,1
1,00:07:01,1,False,0,2,-2,42,10,1
1,00:06:30,1,False,0,2,-2,53,10,1
1,00:05:15,3,True,2,1,1,35,10,1
1,00:04:42,1,True,2,1,1,54,10,1
1,00:03:22,2,False,1,2,-1,43,8,1
1,00:00:37,1,True,3,1,2,26,10,1
1,00:00:00,1,True,3,7,-4,53,10,1
2,00:14:54,1,False,7,10,-3,28,10,1
2,00:13:06,1,False,7,10,-3,50,10,1
2,00:11:43,1,True,10,7,3,16,5,1
2,00:10:10,2,True,10,7,3,52,17,1
2,00:05:38,1,False,7,10,-3,44,10,1
2,00:02:30,2,True,10,10,0,34,11,1
2,00:01:36,1,False,10,10,0,43,20,1
2,00:01:28,2,False,10,10,0,46,17,1
3,00:14:32,2,False,10,10,0,36,10,1
3,00:12:25,2,False,10,10,0,44,13,1
3,00:08:40,1,True,10,10,0,54,10,1
3,00:07:15,1,False,10,10,0,3,10,1
3,00:06:12,1,False,10,16,-6,42,10,1
3,00:03:02,2,False,10,16,-6,49,11,1
3,00:02:04,2,True,16,10,6,51,18,1
3,00:01:17,1,True,16,11,5,35,10,1
3,00:00:03,1,True,16,11,5,46,10,1
4,00:15:00,2,True,16,11,5,51,5,1
4,00:13:17,1,False,11,24,-13,10,10,1
4,00:11:01,1,False,11,25,-14,35,10,1
4,00:08:38,2,True,25,11,14,45,5,1
4,00:07:55,1,True,25,11,14,53,10,1
4,00:06:14,1,False,11,25,-14,25,10,1
4,00:05:32,1,False,11,25,-14,15,10,1
4,00:01:49,1,False,11,26,-15,40,10,1
1,00:14:48,1,True,0,0,0,21,10,1
1,00:12:49,2,True,0,0,0,40,4,1
1,00:12:17,1,True,0,0,0,47,10,1
1,00:10:37,1,False,0,0,0,51,10,1
1,00:08:59,1,False,0,0,0,13,10,1
1,00:05:28,2,True,0,0,0,18,10,1
1,00:03:32,2,False,0,0,0,35,9,1
1,00:02:56,1,True,0,0,0,50,10,1
1,00:02:27,1,True,0,0,0,29,10,1
1,00:00:59,2,True,0,0,0,6,6,1
2,00:15:00,2,False,7,0,7,53,10,1
2,00:13:34,2,False,7,0,7,36,5,1
2,00:12:39,2,False,7,7,0,38,5,1
2,00:12:17,1,False,7,7,0,47,10,1
2,00:08:31,1,True,7,7,0,21,10,1
2,00:07:47,2,True,7,7,0,21,10,1
2,00:06:39,1,False,7,7,0,35,10,1
2,00:04:39,2,False,7,7,0,51,4,1
2,00:03:40,2,True,7,7,0,35,7,1
2,00:03:00,1,True,7,7,0,26,10,1
2,00:02:34,1,True,7,7,0,12,10,1
2,00:02:06,1,True,7,15,-8,35,10,1
2,00:01:55,2,True,7,15,-8,45,10,1
2,00:01:28,1,False,15,7,8,53,10,1
2,00:01:10,1,False,15,14,1,52,10,1
2,00:00:50,1,True,14,15,-1,31,10,1
3,00:15:00,1,True,14,15,-1,45,10,1
3,00:13:11,2,False,15,22,-7,33,5,1
3,00:12:35,1,False,15,22,-7,42,10,1
3,00:10:05,1,False,15,22,-7,54,10,1
3,00:09:38,2,False,15,22,-7,50,6,1
3,00:08:31,2,False,15,22,-7,37,3,1
3,00:06:21,1,False,15,23,-8,35,10,1
3,00:02:58,2,True,23,15,8,14,10,1
4,00:14:18,2,True,23,23,0,53,7,1
4,00:13:47,1,False,23,23,0,47,10,1
4,00:13:10,2,False,23,23,0,40,3,1
4,00:11:00,2,False,23,23,0,25,15,1
4,00:09:59,1,False,23,26,-3,35,10,1
4,00:09:14,2,True,26,23,3,32,8,1
4,00:08:05,1,True,26,23,3,30,20,1
4,00:07:09,2,True,26,23,3,18,8,1
4,00:06:49,1,True,26,30,-4,10,10,1
4,00:05:26,1,True,26,30,-4,22,10,1
4,00:04:16,2,True,26,30,-4,40,6,1
1,00:14:25,2,False,0,1,-1,41,4,1
1,00:13:54,1,False,0,1,-1,52,10,1
1,00:13:07,1,True,1,0,1,19,10,1
1,00:11:23,1,True,1,3,-2,35,10,1
1,00:08:38,1,False,3,1,2,53,10,1
1,00:07:34,2,False,3,1,2,26,10,1
1,00:06:15,1,False,3,7,-4,34,10,1
1,00:05:51,1,False,3,7,-4,48,10,1
1,00:05:05,1,True,7,3,4,51,10,1
1,00:01:42,3,True,7,3,4,3,3,1
2,00:13:31,1,False,17,7,10,42,10,1
2,00:13:05,2,False,17,7,10,46,6,1
2,00:12:23,1,True,7,17,-10,35,10,1
2,00:10:35,1,True,7,24,-17,28,10,1
2,00:08:46,2,True,7,31,-24,40,8,1
2,00:07:52,1,False,31,7,24,16,10,1
2,00:06:46,1,False,31,7,24,28,15,1
2,00:04:59,2,True,7,31,-24,48,10,1
2,00:03:56,1,True,7,38,-31,15,10,1
2,00:03:00,2,True,7,38,-31,15,10,1
2,00:01:23,1,True,7,38,-31,32,10,1
2,00:01:18,2,True,7,38,-31,36,6,1
2,00:01:13,1,True,7,38,-31,48,10,1
2,00:00:47,2,False,38,7,31,44,5,1
3,00:13:41,1,False,38,13,25,25,10,1
3,00:13:00,2,False,38,13,25,25,10,1
3,00:12:22,1,False,38,13,25,36,10,1
3,00:11:30,1,True,13,38,-25,23,10,1
3,00:08:03,1,True,15,41,-26,38,10,1
3,00:07:00,1,True,15,41,-26,48,10,1
3,00:06:23,1,False,41,15,26,49,10,1
3,00:04:35,1,False,41,18,23,35,10,1
3,00:01:02,1,True,18,49,-31,52,10,1
4,00:15:00,1,False,49,18,31,33,10,1
4,00:14:29,2,False,49,18,31,30,7,1
4,00:13:47,1,False,49,18,31,15,10,1
4,00:11:14,2,False,49,26,23,31,7,1
4,00:10:36,1,False,49,26,23,43,10,1
4,00:09:59,2,False,49,26,23,45,8,1
4,00:08:01,2,False,49,26,23,53,12,1
4,00:06:56,2,True,26,49,-23,37,15,1
4,00:04:40,1,True,26,52,-26,40,10,1
4,00:03:00,2,False,52,26,26,15,6,1
4,00:02:36,1,False,52,26,26,43,10,1
1,00:14:30,2,False,0,0,0,10,10,1
1,00:13:14,2,False,0,0,0,34,6,1
1,00:11:32,2,False,0,0,0,42,9,1
1,00:09:06,2,True,0,0,0,19,6,1
1,00:08:25,1,True,0,0,0,30,10,1
1,00:07:05,1,False,0,0,0,48,10,1
1,00:06:14,2,False,0,0,0,32,6,1
1,00:04:30,2,False,0,0,0,6,6,1
1,00:03:27,2,False,0,7,-7,20,13,1
1,00:00:01,2,False,0,7,-7,46,4,1
2,00:10:41,1,False,0,7,-7,17,10,1
2,00:09:30,1,False,0,10,-10,25,20,1
2,00:07:57,1,True,10,0,10,38,10,1
2,00:04:47,2,True,10,0,10,23,2,1
2,00:04:13,1,False,0,10,-10,51,10,1
2,00:02:29,2,False,0,10,-10,23,10,1
2,00:02:02,1,False,0,10,-10,6,6,1
2,00:01:50,2,False,0,16,-16,31,10,1
2,00:01:35,1,True,16,0,16,54,10,1
3,00:14:51,1,True,16,0,16,45,10,1
3,00:11:56,2,False,0,16,-16,50,6,1
3,00:08:30,2,False,0,16,-16,25,5,1
3,00:07:15,2,False,0,16,-16,15,5,1
3,00:06:23,1,False,0,22,-22,43,10,1
3,00:05:56,2,False,0,22,-22,47,6,1
3,00:05:36,1,True,22,0,22,45,10,1
3,00:05:01,2,True,22,0,22,41,6,1
3,00:04:13,2,True,22,0,22,30,20,1
3,00:01:20,2,True,22,3,19,48,10,1
4,00:14:45,1,False,3,25,-22,35,10,1
4,00:09:32,2,True,25,11,14,28,10,1
4,00:06:51,1,False,11,25,-14,9,10,1
4,00:06:10,1,False,11,25,-14,21,10,1
4,00:05:45,2,False,11,25,-14,22,9,1
4,00:05:10,1,False,11,25,-14,28,10,1
4,00:02:47,2,False,11,28,-17,35,10,1
4,00:02:41,3,False,11,28,-17,42,3,1
4,00:02:19,2,False,11,28,-17,46,12,1
4,00:01:17,1,True,29,11,18,50,10,1
4,00:01:01,1,True,29,11,18,39,10,1
1,00:14:54,1,True,0,0,0,32,10,1
1,00:14:16,1,True,0,0,0,48,10,1
1,00:13:25,1,False,0,0,0,48,10,1
1,00:12:44,2,False,0,0,0,45,7,1
1,00:10:26,1,False,0,0,0,13,10,1
1,00:09:45,1,True,0,0,0,47,10,1
1,00:06:26,2,True,0,3,-3,40,5,1
1,00:05:45,1,True,0,3,-3,50,10,1
1,00:04:44,2,False,3,0,3,43,7,1
1,00:00:19,2,False,3,0,3,20,7,1
1,00:00:01,1,False,3,0,3,31,10,1
2,00:11:37,1,False,3,0,3,54,10,1
2,00:10:04,1,True,0,3,-3,29,10,1
2,00:08:54,2,True,0,3,-3,18,11,1
2,00:06:22,1,False,6,0,6,54,10,1
2,00:06:15,2,False,6,0,6,50,6,1
2,00:04:01,1,False,6,0,6,7,7,1
2,00:03:13,2,False,6,7,-1,35,8,1
2,00:02:45,1,False,6,7,-1,47,10,1
2,00:00:41,1,False,7,7,0,10,20,1
2,00:00:34,2,False,7,7,0,20,10,1
2,00:00:07,2,True,7,7,0,51,10,1
3,00:12:05,2,False,9,10,-1,19,27,1
3,00:09:45,1,False,9,10,-1,51,10,1
3,00:08:50,1,False,9,10,-1,40,10,1
3,00:05:15,2,False,9,13,-4,38,12,1
3,00:04:47,1,True,13,9,4,43,10,1
3,00:03:37,2,True,13,9,4,26,10,1
3,00:03:08,1,True,13,16,-3,42,10,1
3,00:00:01,2,False,16,13,3,39,5,1
4,00:14:47,1,False,16,13,3,30,10,1
4,00:14:31,1,False,16,20,-4,47,10,1
4,00:11:56,2,True,20,16,4,31,10,1
4,00:11:16,1,True,20,16,4,44,10,1
4,00:09:45,1,False,16,20,-4,54,10,1
4,00:08:12,2,False,16,20,-4,11,5,1
4,00:06:54,2,False,16,27,-11,41,10,1
4,00:05:38,1,True,27,16,11,30,10,1
4,00:03:26,2,False,16,27,-11,42,10,1
4,00:02:33,2,False,16,27,-11,48,8,1
4,00:01:35,3,False,16,27,-11,27,4,1
1,00:13:40,2,False,0,0,0,51,8,1
1,00:12:22,1,True,0,0,0,50,10,1
1,00:08:45,1,True,0,3,-3,47,10,1
1,00:08:01,1,False,3,0,3,45,10,1
1,00:07:07,1,False,3,0,3,33,10,1
1,00:06:27,1,False,3,0,3,20,10,1
1,00:03:56,2,False,3,3,0,40,10,1
1,00:01:18,1,True,3,3,0,42,15,1
1,00:00:58,1,True,3,3,0,26,10,1
1,00:00:01,2,True,3,3,0,25,9,1
2,00:15:00,1,True,3,3,0,14,10,1
2,00:14:11,1,True,3,3,0,2,2,1
2,00:13:15,2,True,3,10,-7,28,9,1
2,00:11:00,2,False,10,3,7,20,8,1
2,00:10:10,1,False,10,3,7,53,10,1
2,00:09:13,2,False,10,3,7,38,8,1
2,00:08:14,2,False,10,3,7,29,10,1
2,00:04:17,1,False,10,9,1,35,10,1
2,00:03:45,2,False,10,9,1,34,11,1
2,00:01:38,1,True,9,10,-1,34,10,1
2,00:01:19,2,True,9,10,-1,41,3,1
2,00:00:41,1,True,9,10,-1,35,20,1
2,00:00:33,1,False,10,9,1,43,10,1
2,00:00:23,2,False,10,9,1,35,2,1
2,00:00:08,1,False,10,9,1,28,10,1
3,00:14:44,1,True,17,10,7,52,10,1
3,00:14:16,2,False,10,17,-7,54,6,1
3,00:13:37,1,False,10,17,-7,43,10,1
3,00:10:33,1,False,10,17,-7,17,20,1
3,00:09:43,2,False,10,17,-7,21,21,1
3,00:08:23,2,False,10,20,-10,40,5,1
3,00:07:44,1,False,10,20,-10,46,10,1
3,00:04:57,1,True,20,11,9,35,10,1
3,00:04:36,2,True,20,11,9,41,4,1
3,00:02:45,1,False,11,21,-10,25,20,1
3,00:02:14,2,False,11,21,-10,29,16,1
3,00:01:08,1,True,21,11,10,34,10,1
4,00:15:00,2,True,21,11,10,40,7,1
4,00:13:34,2,True,21,11,10,13,8,1
4,00:12:36,2,True,21,11,10,34,10,1
4,00:10:58,2,True,21,11,10,52,4,1
4,00:08:54,2,True,21,18,3,24,8,1
4,00:06:11,1,False,18,21,-3,46,10,1
4,00:05:41,2,False,18,21,-3,50,6,1
4,00:04:58,1,True,21,18,3,47,10,1
4,00:02:17,2,True,21,21,0,53,5,1
4,00:01:01,1,False,21,28,-7,30,10,1
4,00:00:51,1,True,28,21,7,47,10,1
4,00:00:43,2,True,28,21,7,40,3,1
4,00:00:17,1,True,28,21,7,25,10,1
4,00:00:06,2,True,28,21,7,16,1,1
5,00:00:00,1,False,28,28,0,35,10,1
5,00:00:00,1,False,28,28,0,9,10,1
5,00:00:00,2,True,34,28,6,35,10,1
5,00:00:00,1,True,34,28,6,9,9,1
5,00:00:00,1,True,34,34,0,11,10,1
5,00:00:00,1,False,42,34,8,35,10,1
5,00:00:00,1,False,42,34,8,25,10,1
1,00:14:36,2,False,0,0,0,27,10,1
1,00:13:20,2,False,0,0,0,44,8,1
1,00:12:10,2,False,0,0,0,55,10,1
1,00:08:36,1,False,0,0,0,51,10,1
1,00:06:30,2,False,0,7,-7,21,14,1
1,00:05:30,1,False,0,7,-7,32,10,1
1,00:04:03,1,False,0,7,-7,9,9,1
1,00:03:46,1,False,0,14,-14,35,10,1
2,00:12:55,1,False,0,20,-20,53,20,1
2,00:12:20,2,False,0,20,-20,43,10,1
2,00:11:19,2,False,0,20,-20,15,10,1
2,00:10:21,1,False,0,20,-20,2,2,1
2,00:09:35,1,False,0,26,-26,33,5,1
2,00:06:18,2,False,0,29,-29,35,10,1
2,00:02:20,2,True,29,8,21,50,8,1
2,00:01:53,2,False,8,29,-21,9,9,1
2,00:01:47,1,False,8,36,-28,22,10,1
2,00:01:42,2,False,8,36,-28,30,2,1
2,00:01:29,1,False,8,36,-28,37,10,1
2,00:01:01,1,False,8,36,-28,48,10,1
2,00:00:48,3,True,36,8,28,50,10,1
2,00:00:43,1,True,36,8,28,38,10,1
3,00:12:10,1,True,36,11,25,40,10,1
3,00:10:20,2,True,36,11,25,19,3,1
3,00:09:08,2,True,36,11,25,13,10,1
3,00:07:40,1,False,14,36,-22,39,10,1
3,00:06:28,1,False,14,43,-29,38,10,1
3,00:04:40,2,True,43,14,29,35,18,1
3,00:01:50,1,True,43,14,29,37,10,1
3,00:01:20,1,True,43,14,29,23,10,1
3,00:00:35,1,True,43,14,29,12,10,1
3,00:00:05,2,True,43,14,29,11,9,1
4,00:12:57,2,True,43,14,29,26,15,1
4,00:11:57,1,True,43,17,26,35,10,1
4,00:11:31,1,True,43,17,26,54,10,1
4,00:08:14,2,False,17,43,-26,27,10,1
4,00:06:40,1,False,17,46,-29,45,10,1
4,00:01:00,2,True,46,17,29,10,10,1
1,00:13:00,2,True,0,0,0,51,12,1
1,00:10:50,2,True,0,0,0,31,7,1
1,00:09:15,2,True,0,0,0,13,5,1
1,00:08:37,1,True,0,0,0,47,10,1
1,00:08:05,2,True,0,0,0,54,3,1
1,00:04:21,1,True,3,0,3,53,10,1
1,00:02:33,1,False,0,6,-6,35,10,1
1,00:01:30,2,False,0,6,-6,54,6,1
1,00:00:51,1,True,6,0,6,30,10,1
2,00:15:00,1,True,6,0,6,22,10,1
2,00:13:09,2,True,6,3,3,38,7,1
2,00:09:46,1,False,3,12,-9,30,10,1
2,00:09:06,1,False,3,12,-9,47,10,1
2,00:07:38,1,True,12,3,9,53,10,1
2,00:03:00,1,False,10,12,-2,31,10,1
2,00:03:00,2,False,10,12,-2,30,11,1
2,00:02:27,1,True,12,10,2,18,10,1
2,00:02:01,2,True,12,10,2,24,4,1
2,00:01:59,1,True,12,10,2,29,10,1
2,00:01:31,1,True,12,10,2,47,10,1
3,00:14:53,1,False,10,19,-9,37,10,1
3,00:13:33,1,False,10,19,-9,53,10,1
3,00:12:53,1,True,19,10,9,22,10,1
3,00:11:19,2,True,19,13,6,38,7,1
3,00:10:51,1,False,13,19,-6,50,10,1
3,00:09:16,1,False,13,19,-6,7,10,1
3,00:08:55,2,False,13,19,-6,14,3,1
3,00:06:48,1,True,19,13,6,51,10,1
3,00:06:09,2,False,13,19,-6,54,5,1
3,00:04:55,2,False,13,19,-6,41,6,1
3,00:03:03,2,False,13,19,-6,33,9,1
3,00:01:31,1,False,13,22,-9,35,10,1
3,00:00:46,1,True,22,13,9,32,10,1
3,00:00:01,2,True,22,13,9,25,3,1
4,00:13:45,1,True,22,20,2,33,10,1
4,00:12:20,2,False,20,22,-2,41,4,1
4,00:11:41,1,False,20,22,-2,35,10,1
4,00:09:58,2,False,20,25,-5,35,10,1
4,00:07:13,1,True,25,20,5,40,10,1
4,00:05:42,1,False,20,25,-5,24,10,1
4,00:04:28,1,False,20,25,-5,52,10,1
4,00:02:45,2,True,25,23,2,30,15,1
1,00:14:53,1,False,0,0,0,15,10,1
1,00:14:23,2,False,0,0,0,22,3,1
1,00:10:49,2,True,0,0,0,18,6,1
1,00:08:37,1,False,0,0,0,29,10,1
1,00:08:07,1,False,0,0,0,41,10,1
1,00:05:41,1,True,0,0,0,45,10,1
1,00:04:10,1,False,7,0,7,39,10,1
1,00:03:54,1,True,0,7,-7,54,10,1
1,00:02:53,1,False,7,0,7,35,10,1
1,00:01:19,2,False,7,0,7,18,6,1
1,00:00:23,1,False,7,3,4,35,10,1
1,00:00:01,2,False,7,3,4,41,4,1
2,00:14:30,2,False,7,3,4,45,11,1
2,00:13:31,1,True,3,7,-4,37,10,1
2,00:12:47,1,True,3,7,-4,52,10,1
2,00:12:12,1,False,7,3,4,10,10,1
2,00:10:51,2,False,7,3,4,11,10,1
2,00:09:49,1,False,7,6,1,35,10,1
2,00:09:03,2,False,7,6,1,34,11,1
2,00:08:29,1,True,6,7,-1,34,10,1
2,00:07:16,1,False,7,6,1,13,10,1
2,00:02:35,2,False,7,6,1,44,20,1
2,00:02:07,1,True,6,7,-1,10,10,1
2,00:02:00,2,True,6,7,-1,10,10,1
2,00:01:29,1,True,6,7,-1,32,10,1
2,00:01:13,2,True,6,7,-1,40,2,1
2,00:00:49,2,True,6,7,-1,48,10,1
3,00:14:53,1,True,6,7,-1,34,10,1
3,00:14:02,2,True,6,7,-1,37,7,1
3,00:12:39,1,False,7,6,1,18,10,1
3,00:10:13,1,False,7,9,-2,35,10,1
3,00:08:21,2,True,9,7,2,33,5,1
3,00:05:16,2,True,9,7,2,10,10,1
3,00:04:51,1,True,9,15,-6,36,10,1
3,00:04:08,1,False,15,9,6,54,10,1
3,00:03:23,1,False,15,9,6,39,10,1
3,00:02:06,1,False,15,12,3,35,10,1
3,00:01:29,1,True,12,15,-3,44,10,1
3,00:00:41,2,True,12,15,-3,36,2,1
4,00:12:28,2,True,12,22,-10,34,10,1
4,00:11:34,1,False,22,12,10,40,10,1
4,00:10:00,1,True,12,22,-10,36,20,1
4,00:09:25,1,False,22,12,10,50,10,1
4,00:08:23,1,False,22,12,10,27,10,1
4,00:06:38,2,False,22,12,10,7,3,1
4,00:04:47,1,False,22,18,4,54,10,1
4,00:03:33,1,True,18,22,-4,20,20,1
4,00:02:15,1,True,18,29,-11,30,10,1
4,00:02:07,2,True,18,29,-11,37,3,1
4,00:01:38,1,False,29,18,11,46,10,1
4,00:00:38,2,False,29,26,3,53,15,1
5,00:00:00,1,False,32,29,3,35,10,1
5,00:00:00,2,False,32,29,3,4,4,1
1,00:14:20,2,False,0,0,0,34,5,1
1,00:12:42,2,True,0,0,0,5,14,1
1,00:11:49,1,True,0,0,0,53,10,1
1,00:10:35,1,True,0,0,0,16,10,1
1,00:09:32,2,True,0,0,0,34,7,1
1,00:08:28,2,False,0,0,0,52,9,1
1,00:06:39,1,False,0,0,0,27,10,1
1,00:06:10,1,False,0,0,0,43,10,1
1,00:05:06,2,True,0,0,0,40,10,1
1,00:03:09,2,False,0,0,0,55,9,1
1,00:02:01,2,True,0,0,0,42,10,1
1,00:00:22,2,True,0,0,0,8,8,1
2,00:12:43,1,True,0,7,-7,8,10,1
2,00:10:31,1,False,7,0,7,53,20,1
2,00:08:07,1,False,7,0,7,3,3,1
2,00:03:35,2,True,14,7,7,54,16,1
2,00:02:39,1,False,7,14,-7,6,6,1
2,00:02:34,1,False,7,21,-14,31,10,1
2,00:02:27,1,False,7,21,-14,47,10,1
2,00:01:55,2,False,7,21,-14,51,6,1
2,00:01:18,2,True,21,14,7,52,8,1
3,00:14:50,1,True,22,14,8,33,10,1
3,00:13:15,1,True,22,14,8,44,10,1
3,00:10:20,1,False,14,22,-8,36,10,1
3,00:07:40,1,False,14,22,-8,48,10,1
3,00:06:45,2,True,22,14,8,49,10,1
3,00:05:44,1,True,22,17,5,35,10,1
3,00:01:15,2,True,22,17,5,26,10,1
3,00:00:01,1,True,22,17,5,53,10,1
4,00:14:20,1,True,22,17,5,44,15,1
4,00:13:43,2,True,22,17,5,49,20,1
4,00:12:18,2,True,22,20,2,23,22,1
4,00:06:30,1,True,22,20,2,25,10,1
4,00:06:02,1,True,22,20,2,39,10,1
4,00:05:22,1,True,22,20,2,51,10,1
4,00:02:39,2,False,20,22,-2,34,10,1
4,00:02:04,1,False,20,22,-2,35,25,1
4,00:01:56,2,False,20,22,-2,30,20,1
4,00:01:27,1,False,20,25,-5,35,10,1
4,00:01:13,3,False,20,25,-5,42,2,1
1,00:14:49,1,True,0,0,0,54,10,1
1,00:13:04,1,False,0,1,-1,35,10,1
1,00:12:43,1,True,1,0,1,53,10,1
1,00:12:00,2,True,1,0,1,50,7,1
1,00:10:56,2,True,1,0,1,10,10,1
1,00:08:49,1,False,0,1,-1,23,10,1
1,00:06:34,1,True,1,0,1,50,10,1
1,00:05:19,2,True,1,0,1,41,19,1
1,00:04:37,1,False,0,1,-1,20,10,1
1,00:02:37,1,False,0,1,-1,31,10,1
1,00:01:31,2,False,0,1,-1,16,7,1
1,00:00:41,1,False,0,4,-4,35,10,1
1,00:00:05,2,False,0,4,-4,40,5,1
2,00:14:43,2,False,0,4,-4,50,10,1
2,00:13:45,1,True,4,0,4,39,10,1
2,00:12:50,1,True,4,0,4,29,10,1
2,00:12:09,2,True,4,0,4,8,4,1
2,00:11:03,1,True,4,0,4,3,3,1
2,00:10:43,1,True,4,7,-3,21,10,1
2,00:08:55,1,False,7,4,3,48,10,1
2,00:08:06,1,False,7,4,3,36,10,1
2,00:05:04,2,False,7,4,3,1,10,1
2,00:03:47,1,False,7,4,3,11,10,1
2,00:02:39,2,False,7,4,3,23,9,1
2,00:02:12,1,False,7,4,3,54,10,1
2,00:01:34,1,False,7,7,0,35,10,1
2,00:01:00,1,True,7,7,0,44,10,1
3,00:14:37,1,False,10,7,3,6,15,1
3,00:11:50,1,True,7,10,-3,23,10,1
3,00:10:12,1,True,7,10,-3,45,10,1
3,00:09:39,1,False,10,7,3,40,10,1
3,00:09:18,1,False,10,7,3,24,10,1
3,00:08:39,1,False,10,7,3,14,10,1
3,00:07:31,2,False,10,7,3,20,16,1
3,00:06:41,2,False,10,14,-4,31,10,1
3,00:04:11,2,True,14,10,4,23,10,1
3,00:04:00,1,True,14,10,4,35,10,1
3,00:00:47,2,False,10,14,-4,34,20,1
3,00:00:01,2,False,10,14,-4,52,15,1
4,00:14:29,2,True,14,10,4,36,6,1
4,00:12:48,1,True,14,13,1,35,10,1
4,00:12:18,1,True,14,13,1,52,10,1
4,00:09:39,1,False,13,14,-1,54,10,1
4,00:06:56,2,False,13,14,-1,37,4,1
4,00:02:16,2,False,13,17,-4,45,10,1
4,00:02:03,1,False,13,17,-4,10,10,1
4,00:01:57,1,False,13,17,-4,20,10,1
4,00:00:40,1,False,13,17,-4,23,10,1
1,00:14:54,1,False,0,0,0,35,10,1
1,00:14:15,2,False,0,0,0,49,10,1
1,00:11:25,2,False,2,0,2,50,3,1
1,00:08:23,2,True,0,2,-2,15,10,1
1,00:07:39,1,False,2,0,2,48,10,1
1,00:05:57,2,True,0,2,-2,26,10,1
1,00:00:45,1,False,5,0,5,50,10,1
2,00:15:00,2,False,5,0,5,55,15,1
2,00:13:05,2,True,0,5,-5,19,10,1
2,00:11:57,2,True,0,5,-5,46,10,1
2,00:10:54,1,True,0,5,-5,25,10,1
2,00:10:10,2,True,0,5,-5,38,10,1
2,00:09:20,2,True,0,5,-5,50,9,1
2,00:07:12,1,False,5,0,5,51,10,1
2,00:06:30,2,True,0,5,-5,54,5,1
2,00:04:11,1,True,0,8,-8,35,10,1
2,00:02:37,1,False,8,0,8,53,10,1
2,00:01:43,1,True,0,8,-8,27,10,1
2,00:01:34,1,True,0,8,-8,49,10,1
2,00:01:29,2,True,0,8,-8,50,9,1
2,00:01:00,1,False,8,0,8,49,10,1
2,00:00:38,1,False,8,0,8,29,10,1
2,00:00:33,1,False,8,0,8,18,10,1
2,00:00:30,2,False,8,0,8,12,4,1
3,00:14:55,1,True,3,8,-5,38,10,1
3,00:12:14,2,False,8,3,5,31,10,1
3,00:09:00,2,True,6,8,-2,26,9,1
3,00:06:36,1,True,6,11,-5,51,10,1
3,00:04:28,1,True,6,11,-5,24,10,1
3,00:03:55,2,True,6,11,-5,32,2,1
3,00:03:22,1,True,6,11,-5,35,10,1
3,00:01:56,1,True,6,11,-5,46,10,1
3,00:00:48,1,False,11,6,5,54,10,1
3,00:00:01,1,False,11,6,5,41,10,1
4,00:15:00,2,False,11,6,5,35,4,1
4,00:14:45,1,False,11,6,5,29,10,1
4,00:13:55,2,False,11,6,5,22,3,1
4,00:13:33,1,False,11,6,5,13,10,1
4,00:09:46,1,False,11,12,-1,47,10,1
4,00:08:53,2,True,12,17,-5,41,6,1
4,00:05:52,1,True,12,17,-5,54,10,1
4,00:04:10,1,True,12,20,-8,35,10,1
4,00:03:12,2,True,12,20,-8,34,5,1
4,00:02:20,1,True,12,23,-11,35,10,1
4,00:00:51,2,True,12,23,-11,10,6,1
1,00:12:20,1,False,0,0,0,45,10,1
1,00:10:10,2,True,0,0,0,8,4,1
1,00:08:22,2,True,0,0,0,5,5,1
1,00:05:31,1,False,7,0,7,16,10,1
1,00:04:08,1,False,7,0,7,26,15,1
1,00:00:01,1,False,7,0,7,40,15,1
2,00:15:00,2,False,7,0,7,43,12,1
2,00:13:37,2,True,0,8,-8,40,5,1
2,00:12:51,1,True,0,8,-8,46,10,1
2,00:12:07,2,True,0,8,-8,45,11,1
2,00:06:18,2,True,3,9,-6,35,10,1
2,00:05:30,2,True,3,9,-6,50,10,1
2,00:02:22,1,True,4,9,-5,15,10,1
2,00:01:45,1,True,4,9,-5,54,10,1
3,00:13:47,1,True,4,17,-13,25,20,1
3,00:12:03,2,True,4,17,-13,50,10,1
3,00:09:36,2,False,17,4,13,17,8,1
3,00:08:53,2,False,17,11,6,30,10,1
3,00:04:18,2,True,11,20,-9,35,10,1
3,00:01:05,1,True,11,20,-9,51,10,1
4,00:13:58,2,True,11,27,-16,21,4,1
4,00:13:18,1,True,11,27,-16,35,10,1
4,00:12:26,2,False,27,11,16,45,10,1
4,00:10:18,2,False,27,11,16,35,10,1
4,00:08:35,2,False,27,11,16,20,12,1
4,00:06:06,2,True,14,27,-13,33,10,1
4,00:05:41,1,True,14,27,-13,46,10,1
4,00:05:06,2,True,14,27,-13,51,5,1
4,00:04:42,1,False,27,14,13,41,10,1
4,00:01:39,1,True,17,27,-10,23,10,1
4,00:01:31,1,False,27,17,10,38,10,1
4,00:01:24,2,False,27,17,10,35,7,1
4,00:01:02,2,False,27,17,10,16,10,1
1,00:10:31,2,False,1,0,1,35,10,1
1,00:10:14,1,True,0,8,-8,19,10,1
1,00:06:28,1,True,0,8,-8,24,10,1
1,00:01:30,1,False,16,0,16,19,10,1
1,00:00:38,1,False,16,8,8,37,10,1
2,00:14:41,1,True,8,16,-8,47,10,1
2,00:14:01,1,False,16,8,8,43,10,1
2,00:10:30,1,False,16,16,0,35,10,1
2,00:03:20,2,True,16,16,0,44,10,1
2,00:02:22,2,False,16,16,0,11,5,1
2,00:02:03,1,False,16,16,0,19,10,1
2,00:01:41,1,False,16,16,0,33,10,1
2,00:01:29,2,False,16,16,0,39,4,1
2,00:01:12,1,False,16,16,0,49,10,1
3,00:14:48,1,False,16,16,0,33,10,1
3,00:12:11,1,True,16,16,0,44,10,1
3,00:09:58,1,False,16,16,0,44,10,1
3,00:09:42,2,False,16,16,0,46,8,1
3,00:06:14,2,True,16,16,0,54,4,1
3,00:03:39,1,False,16,16,0,19,10,1
3,00:01:33,2,False,16,23,-7,35,4,1
3,00:00:16,1,False,16,23,-7,31,20,1
4,00:14:52,1,True,23,22,1,26,10,1
4,00:13:25,1,False,22,23,-1,48,10,1
4,00:12:55,2,False,22,23,-1,46,12,1
4,00:11:25,2,False,22,23,-1,41,27,1
4,00:07:58,2,True,23,22,1,44,6,1
4,00:06:29,1,True,23,25,-2,25,20,1
4,00:04:27,2,True,23,25,-2,49,8,1
4,00:02:14,1,False,25,26,-1,35,10,1
4,00:02:09,2,False,25,26,-1,42,3,1
4,00:01:45,1,True,26,25,1,51,10,1
1,00:14:40,2,True,0,0,0,27,10,1
1,00:10:03,2,False,0,0,0,39,8,1
1,00:09:30,1,False,0,0,0,55,10,1
1,00:08:26,1,True,0,0,0,33,10,1
1,00:07:19,2,True,0,8,-8,15,17,1
1,00:04:29,2,True,0,11,-11,35,10,1
1,00:04:00,1,True,0,11,-11,46,10,1
1,00:02:55,2,True,0,11,-11,46,20,1
1,00:02:01,2,False,11,0,11,37,10,1
1,00:00:19,2,False,11,0,11,24,11,1
2,00:14:35,2,False,11,8,3,36,10,1
2,00:12:35,2,True,8,11,-3,29,6,1
2,00:11:18,1,True,8,19,-11,36,10,1
2,00:07:15,1,False,19,8,11,30,20,1
2,00:06:50,2,False,19,8,11,26,16,1
2,00:04:20,1,True,11,19,-8,46,10,1
2,00:04:06,1,False,19,11,8,51,10,1
2,00:03:30,1,False,19,11,8,16,10,1
2,00:02:26,2,False,19,11,8,6,6,1
2,00:02:07,2,False,19,17,2,29,10,1
2,00:00:55,1,False,19,17,2,26,10,1
3,00:13:55,2,False,19,17,2,23,20,1
3,00:10:00,1,True,17,19,-2,33,10,1
3,00:09:55,2,True,17,19,-2,25,2,1
3,00:08:10,2,True,17,22,-5,35,10,1
3,00:07:26,1,False,22,17,5,40,10,1
3,00:05:55,2,False,22,20,2,37,8,1
3,00:04:55,1,False,22,20,2,49,10,1
3,00:01:58,2,True,20,23,-3,34,11,1
3,00:00:35,2,True,20,23,-3,42,14,1
3,00:00:13,1,False,23,20,3,54,10,1
4,00:11:15,2,False,23,20,3,45,9,1
4,00:09:08,1,True,20,23,-3,21,10,1
4,00:08:10,2,True,20,23,-3,26,5,1
4,00:07:21,2,False,23,26,-3,24,10,1
4,00:06:50,1,False,23,26,-3,34,10,1
4,00:06:00,1,False,23,26,-3,47,10,1
4,00:04:53,2,True,26,23,3,47,10,1
4,00:03:52,1,True,26,26,0,35,10,1
4,00:03:25,2,True,26,26,0,40,5,1
4,00:02:48,2,True,26,26,0,46,12,1
4,00:02:24,1,False,26,26,0,48,10,1
4,00:02:07,1,False,26,26,0,36,10,1
4,00:01:03,1,False,26,26,0,10,10,1
4,00:00:54,1,False,26,26,0,30,10,1
4,00:00:37,1,False,26,26,0,40,10,1
1,00:14:31,2,True,0,0,0,24,10,1
1,00:13:22,1,False,0,0,0,35,10,1
1,00:11:40,1,True,0,0,0,54,10,1
1,00:09:18,2,True,0,0,0,55,12,1
1,00:08:26,2,False,0,0,0,32,7,1
1,00:07:48,1,False,0,0,0,23,10,1
1,00:04:43,1,True,7,0,7,55,10,1
1,00:04:05,1,False,0,7,-7,32,10,1
1,00:03:19,2,False,0,7,-7,25,3,1
1,00:02:57,1,False,0,14,-14,32,10,1
1,00:02:20,2,False,0,14,-14,26,16,1
1,00:01:08,1,False,0,14,-14,48,10,1
1,00:00:14,2,False,0,14,-14,30,5,1
2,00:15:00,1,False,0,14,-14,12,10,1
2,00:10:41,1,True,21,0,21,54,10,1
2,00:09:57,1,True,21,7,14,24,15,1
2,00:05:07,2,True,21,7,14,29,10,1
2,00:02:29,1,True,21,7,14,50,10,1
2,00:01:40,1,False,7,21,-14,31,10,1
2,00:01:25,2,False,7,21,-14,35,6,1
3,00:14:54,1,False,7,21,-14,28,10,1
3,00:14:10,2,False,7,21,-14,34,4,1
3,00:13:28,1,True,21,7,14,44,10,1
3,00:09:44,2,False,10,21,-11,30,10,1
3,00:07:38,2,True,21,10,11,55,10,1
3,00:06:28,1,False,10,21,-11,49,10,1
3,00:06:07,2,False,10,21,-11,55,4,1
3,00:05:23,1,True,21,10,11,23,10,1
3,00:05:00,1,True,21,10,11,11,10,1
3,00:03:27,1,True,21,18,3,15,10,1
3,00:02:15,1,False,18,21,-3,36,10,1
3,00:00:58,1,False,18,21,-3,47,10,1
3,00:00:35,2,False,18,21,-3,50,7,1
4,00:14:43,1,True,21,18,3,43,10,1
4,00:13:21,2,True,21,18,3,44,25,1
4,00:10:49,2,False,21,21,0,13,26,1
4,00:09:25,2,False,21,21,0,54,5,1
4,00:07:25,2,False,21,21,0,35,12,1
4,00:05:57,2,False,21,24,-3,35,10,1
4,00:05:03,1,True,24,21,3,29,10,1
4,00:03:31,1,True,24,21,3,5,5,1
4,00:02:22,1,False,27,27,0,35,10,1
4,00:02:08,1,True,27,27,0,44,10,1
4,00:02:01,2,True,27,27,0,38,4,1
4,00:00:46,1,True,27,30,-3,35,10,1
1,00:14:55,1,True,0,0,0,30,10,1
1,00:11:57,1,True,0,0,0,42,10,1
1,00:11:26,2,True,0,0,0,48,4,1
1,00:10:35,2,False,0,0,0,39,9,1
1,00:09:35,2,False,0,0,0,43,24,1
1,00:08:13,2,False,0,0,0,6,10,1
1,00:07:33,1,False,0,0,0,16,10,1
1,00:05:21,1,False,0,1,-1,35,10,1
1,00:01:15,1,True,1,3,-2,30,10,1
2,00:15:00,1,False,3,1,2,52,10,1
2,00:13:24,2,True,1,3,-2,26,7,1
2,00:11:35,2,False,3,1,2,35,8,1
2,00:09:58,1,False,3,4,-1,23,10,1
2,00:08:53,2,False,3,4,-1,35,10,1
2,00:06:57,2,True,4,3,1,23,10,1
2,00:05:49,2,False,3,4,-1,29,10,1
2,00:04:22,2,True,4,3,1,31,11,1
2,00:02:35,1,True,4,3,1,39,10,1
2,00:00:22,1,True,4,3,1,38,10,1
3,00:12:49,1,True,4,3,1,7,10,1
3,00:12:37,1,True,4,3,1,26,10,1
3,00:12:22,2,True,4,3,1,33,3,1
3,00:11:10,2,True,4,3,1,34,15,1
3,00:06:00,2,False,3,11,-8,47,2,1
3,00:04:22,2,False,3,11,-8,54,6,1
3,00:03:04,2,False,3,11,-8,47,12,1
3,00:02:11,1,False,3,11,-8,25,10,1
3,00:00:53,2,False,3,18,-15,28,16,1
4,00:08:43,2,False,3,18,-15,15,8,1
4,00:06:55,3,True,25,3,22,44,10,1
4,00:04:50,2,False,3,25,-22,12,12,1
4,00:02:35,1,False,3,32,-29,21,10,1
4,00:02:29,2,False,3,32,-29,27,4,1
4,00:02:15,1,False,3,32,-29,32,10,1
4,00:01:58,2,False,3,32,-29,37,5,1
4,00:01:47,1,False,3,32,-29,42,10,1
1,00:13:59,1,False,0,0,0,53,10,1
1,00:12:03,1,True,0,0,0,55,5,1
1,00:10:58,2,False,0,0,0,47,7,1
1,00:09:48,1,False,0,0,0,36,10,1
1,00:07:35,1,False,0,3,-3,52,10,1
1,00:06:15,1,True,3,0,3,42,10,1
1,00:05:27,2,True,3,7,-4,8,7,1
1,00:05:01,1,True,3,7,-4,21,10,1
1,00:04:00,2,True,3,7,-4,32,10,1
1,00:01:16,1,False,7,3,4,38,10,1
1,00:00:01,1,True,3,7,-4,45,20,1
2,00:13:26,2,True,3,10,-7,36,9,1
2,00:12:31,2,True,3,10,-7,52,10,1
2,00:12:05,1,False,10,3,7,40,10,1
2,00:11:25,2,False,10,3,7,36,6,1
2,00:09:20,1,False,10,6,4,35,10,1
2,00:08:01,2,False,10,6,4,51,7,1
2,00:07:35,1,True,6,10,-4,49,10,1
2,00:07:00,2,True,6,10,-4,49,10,1
2,00:04:46,2,True,6,11,-5,41,4,1
2,00:01:09,1,True,6,14,-8,46,10,1
2,00:00:48,2,False,14,6,8,49,10,1
2,00:00:42,1,False,14,6,8,38,10,1
2,00:00:25,2,False,14,6,8,30,2,1
2,00:00:13,1,False,14,6,8,19,10,1
3,00:14:23,1,True,14,14,0,44,10,1
3,00:13:49,2,False,14,14,0,51,10,1
3,00:13:23,1,False,14,14,0,25,10,1
3,00:12:58,2,False,14,14,0,19,4,1
3,00:10:51,1,False,14,21,-7,15,10,1
3,00:07:36,1,True,21,17,4,35,10,1
3,00:04:25,2,False,17,21,-4,23,15,1
3,00:02:01,2,True,21,17,4,48,7,1
4,00:12:00,1,False,20,21,-1,44,10,1
4,00:11:45,1,False,20,21,-1,54,10,1
4,00:10:12,2,True,21,20,1,38,11,1
4,00:07:42,2,True,21,20,1,18,15,1
4,00:05:57,2,True,21,28,-7,26,5,1
4,00:04:19,1,False,28,21,7,48,10,1
4,00:03:16,2,True,21,28,-7,36,6,1
4,00:01:17,2,True,21,31,-10,39,6,1
1,00:14:13,2,True,0,0,0,23,6,1
1,00:13:48,1,True,0,0,0,31,10,1
1,00:10:35,2,False,0,0,0,22,7,1
1,00:08:56,1,True,7,0,7,46,10,1
1,00:04:57,1,False,3,7,-4,12,10,1
1,00:03:45,1,False,3,7,-4,47,10,1
1,00:02:35,1,False,3,7,-4,32,20,1
1,00:01:06,1,False,3,7,-4,25,10,1
2,00:13:46,1,True,7,6,1,30,15,1
2,00:12:55,2,True,7,6,1,46,11,1
2,00:08:32,1,False,6,7,-1,4,14,1
2,00:08:00,2,False,6,7,-1,10,8,1
2,00:03:01,1,True,7,6,1,35,10,1
2,00:02:43,2,True,7,6,1,28,3,1
2,00:02:00,1,True,7,6,1,24,10,1
2,00:01:02,1,False,13,7,6,34,20,1
2,00:00:15,1,False,13,7,6,40,10,1
3,00:14:16,2,False,14,10,4,36,8,1
3,00:12:45,1,True,10,14,-4,46,20,1
3,00:12:06,2,True,10,14,-4,45,19,1
3,00:08:35,2,False,15,10,5,5,9,1
3,00:06:42,1,True,10,15,-5,36,10,1
3,00:03:45,2,True,10,15,-5,46,10,1
3,00:02:35,2,True,10,15,-5,25,17,1
3,00:01:38,1,True,10,15,-5,25,10,1
4,00:14:29,1,True,10,18,-8,35,10,1
4,00:10:20,2,True,10,18,-8,25,10,1
4,00:08:23,1,False,18,13,5,35,10,1
4,00:07:45,1,False,18,13,5,53,10,1
4,00:06:38,1,True,13,18,-5,46,10,1
4,00:04:14,2,True,13,18,-5,8,7,1
4,00:01:20,1,True,13,18,-5,32,20,1
2,00:04:29,3,False,7,3,4,55,12,10
2,00:01:48,1,True,3,7,-4,0,5,10
3,00:09:08,3,True,3,17,-14,38,4,10
3,00:04:20,2,False,17,3,14,15,1,10
4,00:14:19,1,True,6,24,-18,45,10,10
4,00:01:16,0,False,24,6,18,39,0,10
1,00:12:14,1,False,0,7,-7,51,10,10
1,00:10:55,2,False,0,7,-7,46,15,10
1,00:10:39,0,False,0,7,-7,50,0,10
1,00:07:26,2,True,7,0,7,21,3,10
2,00:14:38,0,True,7,6,1,42,0,10
2,00:10:45,0,False,13,7,6,34,0,10
3,00:03:05,3,True,12,26,-14,35,10,10
3,00:00:10,3,True,12,26,-14,16,16,10
4,00:13:27,1,True,12,33,-21,15,0,10
4,00:10:30,1,True,19,33,-14,51,10,10
4,00:09:05,3,False,33,19,14,50,9,10
4,00:03:31,3,False,33,26,7,35,10,10
4,00:03:17,1,True,26,33,-7,42,10,10
4,00:00:59,3,True,26,33,-7,43,15,10
1,00:13:19,2,False,0,0,0,29,7,10
1,00:05:11,1,True,7,0,7,31,10,10
1,00:01:29,3,True,7,0,7,13,10,10
2,00:14:22,1,True,7,0,7,27,10,10
2,00:02:17,1,False,7,14,-7,16,10,10
2,00:00:35,3,False,7,14,-7,48,15,10
2,00:00:24,1,True,14,7,7,9,10,10
1,00:06:33,0,False,3,0,3,31,0,10
1,00:03:50,2,False,3,0,3,52,7,10
2,00:15:00,3,True,7,10,-3,37,8,10
2,00:14:40,1,False,10,7,3,19,10,10
2,00:09:10,2,True,7,11,-4,38,7,10
2,00:05:34,2,True,7,11,-4,48,9,10
2,00:00:31,3,True,14,11,3,19,4,10
3,00:07:32,3,True,14,11,3,17,25,10
1,00:14:23,2,False,0,0,0,18,8,10
1,00:05:01,3,False,2,0,2,44,3,10
2,00:02:56,1,True,7,10,-3,40,10,10
2,00:00:33,3,True,14,18,-4,39,1,10
4,00:14:37,1,True,24,18,6,52,10,10
4,00:02:38,1,False,25,41,-16,42,10,10
1,00:04:02,2,True,3,0,3,45,5,10
2,00:12:53,2,False,7,3,4,30,10,10
2,00:12:34,2,False,7,3,4,20,15,10
2,00:10:14,3,False,7,10,-3,38,8,10
2,00:05:49,3,False,7,10,-3,43,5,10
2,00:01:06,1,True,17,14,3,42,10,10
2,00:00:32,0,False,14,17,-3,36,0,10
3,00:11:33,3,False,17,17,0,40,8,10
3,00:10:05,3,True,17,17,0,18,2,10
3,00:05:56,1,True,17,17,0,13,10,10
3,00:04:20,2,True,17,20,-3,39,6,10
3,00:03:53,2,True,17,20,-3,34,11,10
4,00:05:44,2,False,26,20,6,24,10,10
4,00:02:07,1,True,27,26,1,41,10,10
1,00:14:18,2,True,0,0,0,37,7,10
1,00:11:22,0,False,0,7,-7,35,0,10
1,00:02:39,0,False,0,17,-17,35,0,10
2,00:11:34,0,True,17,0,17,43,0,10
2,00:09:50,3,False,0,17,-17,24,10,10
2,00:04:44,0,True,17,7,10,35,0,10
3,00:09:40,2,False,7,20,-13,1,1,10
3,00:03:38,3,False,7,30,-23,20,19,10
4,00:08:20,1,True,37,7,30,35,10,10
2,00:10:42,2,True,8,3,5,35,4,10
2,00:09:09,3,True,8,3,5,45,10,10
2,00:04:01,1,True,8,10,-2,17,10,10
4,00:13:10,0,True,8,20,-12,35,0,10
4,00:10:01,1,False,20,9,11,53,10,10
4,00:04:22,0,True,9,20,-11,39,0,10
2,00:13:42,2,False,7,2,5,30,13,10
2,00:13:18,3,False,7,2,5,25,18,10
2,00:03:08,3,True,9,10,-1,52,5,10
2,00:02:03,3,True,9,10,-1,40,18,10
3,00:09:50,0,False,10,10,0,27,0,10
3,00:06:45,3,True,10,17,-7,52,6,10
3,00:06:23,3,False,17,10,7,53,11,10
1,00:13:50,2,True,0,0,0,31,22,10
1,00:10:20,2,True,0,7,-7,32,8,10
1,00:08:54,3,False,7,0,7,48,4,10
1,00:08:33,1,False,7,0,7,29,10,10
1,00:00:26,2,False,7,0,7,45,15,10
2,00:13:37,3,True,0,7,-7,37,9,10
2,00:10:36,2,False,7,0,7,24,4,10
2,00:00:28,3,True,9,10,-1,55,24,10
3,00:09:26,0,False,10,9,1,17,0,10
3,00:04:55,3,False,13,9,4,17,14,10
3,00:01:26,1,True,9,13,-4,38,10,10
3,00:01:12,0,False,13,9,4,40,0,10
4,00:06:05,1,True,12,19,-7,35,10,10
4,00:03:16,0,False,19,12,7,14,0,10
1,00:02:55,2,True,3,0,3,15,2,10
2,00:04:47,1,True,17,5,12,38,10,10
3,00:10:26,3,False,8,31,-23,33,10,10
4,00:00:04,1,False,29,37,-8,55,10,10
1,00:13:19,1,True,7,0,7,45,10,10
1,00:10:22,3,True,7,1,6,40,5,10
2,00:01:29,2,False,5,13,-8,35,10,10
3,00:12:34,3,True,16,5,11,21,10,10
3,00:10:15,2,True,16,8,8,35,10,10
4,00:14:08,2,False,28,30,-2,55,1,10
4,00:05:16,3,True,30,30,0,28,17,10
2,00:09:17,1,True,14,0,14,55,10,10
2,00:08:02,3,False,0,14,-14,53,8,10
2,00:07:50,1,False,0,14,-14,6,10,10
2,00:01:12,0,True,27,0,27,5,0,10
2,00:01:12,0,False,0,28,-28,35,0,10
2,00:01:12,0,True,28,0,28,25,0,10
3,00:13:52,3,True,35,0,35,55,3,10
3,00:10:40,3,False,0,35,-35,29,8,10
4,00:10:27,3,False,0,44,-44,54,10,10
4,00:07:19,3,False,0,44,-44,51,4,10
4,00:01:58,1,False,0,52,-52,45,10,10
4,00:00:44,0,True,52,0,52,54,0,10
1,00:14:53,1,True,0,0,0,46,10,10
1,00:08:45,3,True,0,0,0,1,1,10
1,00:05:05,2,True,7,3,4,27,11,10
1,00:02:18,1,True,7,3,4,20,10,10
2,00:14:50,0,False,6,7,-1,35,0,10
2,00:07:33,2,True,7,9,-2,32,10,10
2,00:04:56,0,False,9,7,2,40,0,10
3,00:06:38,1,False,13,17,-4,45,10,10
4,00:10:29,3,True,24,13,11,17,11,10
4,00:00:35,2,True,25,13,12,26,10,10
1,00:03:36,1,True,7,3,4,37,10,10
2,00:12:12,3,True,7,10,-3,32,19,10
2,00:07:39,3,True,7,11,-4,40,5,10
2,00:02:03,2,True,7,14,-7,55,10,10
3,00:08:12,0,False,14,16,-2,35,0,10
4,00:07:40,3,True,23,21,2,45,6,10
4,00:03:18,2,True,23,21,2,19,10,10
1,00:11:48,2,True,0,7,-7,46,8,10
2,00:10:45,3,False,8,6,2,39,6,10
2,00:04:34,2,True,13,8,5,50,9,10
3,00:12:38,3,False,15,13,2,35,12,10
3,00:04:19,2,False,22,16,6,35,10,10
3,00:03:39,3,False,22,16,6,30,15,10
3,00:02:43,1,True,16,22,-6,47,10,10
2,00:11:05,0,False,7,8,-1,12,0,10
2,00:05:13,1,True,8,14,-6,0,1,10
3,00:13:37,0,True,8,17,-9,43,0,10
3,00:09:36,2,False,17,8,9,10,1,10
4,00:13:33,1,True,15,20,-5,42,10,10
4,00:12:03,0,False,26,15,11,5,0,10
4,00:03:54,1,False,27,22,5,2,2,10
4,00:02:41,2,False,27,22,5,2,13,10
1,00:05:01,0,True,7,0,7,6,0,10
1,00:04:10,0,False,0,10,-10,54,0,10
2,00:14:38,3,False,0,17,-17,47,2,10
2,00:07:55,3,True,17,0,17,45,7,10
3,00:08:06,2,True,24,3,21,15,10,10
4,00:13:50,2,False,4,24,-20,0,11,10
4,00:02:20,0,False,7,25,-18,21,0,10
4,00:00:40,0,True,25,7,18,0,0,10
1,00:08:59,2,False,14,0,14,2,10,10
2,00:05:36,3,True,11,20,-9,36,8,10
2,00:03:10,2,True,13,20,-7,47,10,10
3,00:11:11,2,False,23,27,-4,40,5,10
3,00:05:38,1,True,30,24,6,35,10,10
4,00:13:47,3,True,33,24,9,17,6,10
4,00:11:42,3,True,33,24,9,2,10,10
4,00:09:36,0,False,31,33,-2,46,0,10
4,00:08:26,1,False,31,33,-2,34,10,10
4,00:07:55,0,True,33,31,2,47,0,10
4,00:05:26,2,True,33,31,2,23,1,10
1,00:08:54,1,False,8,0,8,22,10,10
1,00:03:14,2,False,11,0,11,12,8,10
2,00:14:46,2,False,11,3,8,35,10,10
2,00:12:26,3,False,11,3,8,31,4,10
2,00:05:36,0,True,10,11,-1,24,0,10
3,00:14:12,3,True,20,12,8,44,6,10
3,00:07:47,0,True,23,12,11,35,0,10
3,00:06:15,0,True,23,12,11,49,0,10
4,00:14:42,1,True,23,15,8,47,10,10
4,00:06:28,0,True,23,30,-7,51,0,10
2,00:13:50,0,False,21,15,6,35,0,10
2,00:01:06,1,False,31,25,6,53,10,10
2,00:00:23,3,True,25,31,-6,45,8,10
3,00:01:37,3,True,32,34,-2,54,9,10
4,00:12:14,1,True,32,34,-2,37,10,10
4,00:03:00,3,False,34,39,-5,41,26,10
1,00:07:36,1,False,0,5,-5,49,10,10
1,00:02:11,3,False,0,5,-5,29,15,10
1,00:00:33,3,True,5,0,5,49,7,10
2,00:08:22,3,False,0,8,-8,43,2,10
2,00:01:19,1,True,15,0,15,32,10,10
3,00:14:05,2,False,0,15,-15,31,6,10
3,00:03:13,0,False,6,15,-9,5,0,10
4,00:14:54,1,False,7,22,-15,33,10,10
4,00:13:32,3,False,7,22,-15,31,12,10
4,00:06:47,0,False,14,29,-15,13,0,10
4,00:02:47,2,False,14,29,-15,14,10,10
4,00:01:31,1,True,36,14,22,36,10,10
1,00:08:08,3,False,0,7,-7,40,0,10
2,00:02:36,0,True,24,6,18,40,0,10
4,00:11:33,2,True,38,21,17,27,10,10
4,00:10:26,0,True,38,24,14,35,0,10
4,00:05:00,3,False,24,41,-17,24,21,10
4,00:00:46,0,False,24,44,-20,20,0,10
1,00:08:42,1,False,0,7,-7,48,10,10
1,00:06:27,1,False,0,7,-7,47,10,10
1,00:04:36,0,True,7,0,7,51,0,10
1,00:02:42,0,False,0,14,-14,35,0,10
2,00:12:29,3,False,0,17,-17,53,3,10
2,00:06:01,3,True,20,3,17,36,9,10
2,00:05:39,3,True,20,3,17,31,14,10
2,00:01:18,3,False,4,20,-16,35,7,10
2,00:01:07,1,True,20,4,16,47,10,10
3,00:13:33,2,False,11,27,-16,38,9,10
3,00:05:00,1,False,11,27,-16,34,10,10
4,00:06:52,1,True,27,17,10,15,10,10
4,00:01:02,3,False,24,27,-3,29,10,10
1,00:11:12,0,False,0,0,0,9,0,10
1,00:07:00,2,True,0,7,-7,49,6,10
2,00:01:42,2,True,1,15,-14,34,13,10
3,00:15:00,0,False,22,1,21,35,0,10
3,00:13:59,3,True,1,22,-21,17,3,10
3,00:04:15,3,False,36,4,32,43,14,10
3,00:03:02,3,False,36,4,32,10,7,10
4,00:06:36,0,True,12,39,-27,5,0,10
4,00:00:10,1,False,39,15,24,4,10,10
2,00:06:38,2,True,3,8,-5,36,9,10
2,00:05:57,3,True,3,8,-5,41,4,10
2,00:02:32,2,False,8,3,5,40,9,10
2,00:00:47,3,False,8,3,5,31,1,10
3,00:11:06,0,True,3,8,-5,49,0,10
4,00:10:20,3,True,4,9,-5,46,9,10
1,00:11:24,3,False,0,0,0,51,10,10
2,00:14:26,0,False,0,10,-10,35,0,10
3,00:13:23,0,False,3,14,-11,34,0,10
4,00:15:00,2,True,17,6,11,35,8,10
4,00:08:46,3,True,17,9,8,37,9,10
1,00:15:00,0,False,0,0,0,35,0,10
1,00:04:41,3,False,7,3,4,46,10,10
1,00:03:04,1,True,3,7,-4,51,10,10
2,00:02:10,2,False,14,11,3,0,10,10
4,00:08:41,0,True,28,21,7,20,0,10
4,00:04:01,3,False,21,35,-14,29,14,10
1,00:14:24,2,False,0,0,0,29,5,10
1,00:10:48,2,True,0,7,-7,54,20,10
1,00:10:07,2,True,0,7,-7,20,25,10
1,00:02:32,3,False,16,7,9,20,15,10
1,00:01:11,3,True,7,16,-9,54,15,10
2,00:10:35,3,True,7,16,-9,50,3,10
2,00:05:01,3,False,16,10,6,35,10,10
3,00:13:04,3,True,13,16,-3,47,11,10
3,00:01:24,0,False,23,13,10,47,0,10
4,00:13:10,1,True,13,23,-10,38,10,10
4,00:05:00,3,False,30,20,10,55,5,10
1,00:14:50,1,False,0,0,0,42,10,10
1,00:14:24,1,False,0,0,0,33,15,10
1,00:08:33,1,False,0,0,0,47,10,10
2,00:13:14,3,False,7,10,-3,39,3,10
2,00:12:50,3,False,7,10,-3,34,8,10
2,00:09:42,3,False,7,10,-3,43,8,10
2,00:07:13,3,False,7,10,-3,50,8,10
3,00:03:21,1,True,13,19,-6,35,10,10
4,00:10:29,1,False,19,22,-3,27,10,10
4,00:05:57,1,False,19,25,-6,35,10,10
1,00:06:29,0,True,3,0,3,0,0,10
2,00:13:44,3,False,7,11,-4,49,8,10
2,00:08:24,0,True,11,7,4,0,0,10
2,00:03:59,0,False,14,11,3,23,0,10
2,00:03:13,3,True,11,14,-3,48,13,10
2,00:01:59,3,True,11,14,-3,26,9,10
2,00:00:50,0,True,11,21,-10,35,0,10
4,00:04:54,3,True,21,32,-11,43,7,10
4,00:04:44,1,True,21,32,-11,1,10,10
4,00:00:01,2,True,28,39,-11,45,17,10
1,00:02:58,3,False,7,10,-3,41,8,10
2,00:00:53,3,True,18,15,3,36,8,10
3,00:01:30,0,True,25,25,0,41,0,10
3,00:01:09,1,True,25,25,0,54,20,10
3,00:00:49,1,False,25,25,0,50,25,10
4,00:10:56,3,True,25,25,0,31,10,10
4,00:02:40,0,True,26,32,-6,0,0,10
4,00:00:19,1,True,26,33,-7,45,10,10
1,00:11:11,1,False,0,0,0,41,10,10
1,00:06:40,2,False,0,7,-7,37,4,10
1,00:06:06,2,False,0,7,-7,32,9,10
1,00:05:42,3,False,0,7,-7,18,23,10
2,00:07:46,1,True,7,6,1,43,10,10
2,00:00:35,3,False,13,7,6,25,2,10
3,00:06:24,3,False,16,7,9,49,7,10
4,00:08:47,0,True,7,19,-12,54,0,10
4,00:06:35,3,True,7,19,-12,54,17,10
1,00:04:53,2,False,15,7,8,30,9,10
2,00:08:57,3,True,7,15,-8,54,1,10
2,00:01:49,0,True,7,33,-26,35,0,10
3,00:06:40,3,True,14,40,-26,26,4,10
4,00:07:57,3,False,50,14,36,39,10,10
4,00:04:21,3,False,50,17,33,55,5,10
4,00:01:09,3,True,17,53,-36,41,4,10
1,00:10:44,3,False,0,7,-7,44,10,10
1,00:00:29,3,False,0,8,-8,47,10,10
1,00:00:01,1,False,0,8,-8,45,10,10
2,00:12:30,0,True,9,6,3,54,0,10
2,00:04:15,2,True,9,6,3,42,4,10
2,00:02:24,0,True,9,13,-4,35,0,10
2,00:00:22,2,True,12,13,-1,52,4,10
3,00:13:59,3,False,13,13,0,33,12,10
3,00:08:40,3,False,13,14,-1,24,5,10
3,00:04:46,3,False,13,17,-4,31,14,10
3,00:02:53,3,True,17,13,4,51,2,10
4,00:11:20,3,False,13,18,-5,23,22,10
4,00:11:00,1,True,18,13,5,50,10,10
4,00:02:40,0,True,25,20,5,35,0,10
1,00:10:48,1,False,0,0,0,44,10,10
1,00:08:11,2,False,0,0,0,45,3,10
1,00:03:58,0,False,0,3,-3,35,0,10
2,00:10:53,3,True,3,0,3,25,1,10
2,00:06:32,1,True,3,0,3,52,10,10
2,00:03:04,2,False,0,3,-3,34,11,10
3,00:10:12,0,True,3,8,-5,35,0,10
3,00:00:57,1,False,15,3,12,43,10,10
4,00:06:21,3,True,3,15,-12,52,7,10
4,00:05:48,2,True,3,15,-12,23,10,10
4,00:02:22,2,False,17,3,14,38,10,10
4,00:02:13,3,False,17,3,14,40,12,10
4,00:00:39,1,False,17,3,14,53,10,10
1,00:04:16,1,False,0,1,-1,35,10,10
2,00:09:51,2,True,1,14,-13,43,18,10
2,00:02:55,2,False,14,1,13,29,10,10
2,00:02:51,2,False,14,1,13,24,15,10
2,00:02:45,3,False,14,1,13,26,13,10
3,00:08:20,3,True,4,20,-16,38,10,10
3,00:00:01,0,True,10,27,-17,5,0,10
3,00:00:01,0,True,10,27,-17,10,0,10
4,00:11:48,3,True,11,34,-23,35,5,10
4,00:09:55,0,False,34,11,23,49,0,10
4,00:04:09,2,False,35,11,24,26,5,10
1,00:12:03,1,False,0,3,-3,42,10,10
1,00:05:32,3,True,3,7,-4,42,3,10
1,00:05:08,3,True,3,7,-4,37,8,10
1,00:03:21,3,False,7,3,4,50,4,10
2,00:01:29,0,True,6,21,-15,35,0,10
3,00:12:24,2,True,6,21,-15,43,3,10
3,00:08:39,2,False,28,6,22,40,7,10
3,00:08:05,3,False,28,6,22,51,18,10
4,00:12:28,3,True,9,31,-22,22,12,10
4,00:09:00,3,True,9,32,-23,8,6,10
4,00:02:19,1,False,35,9,26,11,10,10
1,00:13:12,3,True,0,0,0,42,10,10
2,00:09:11,0,True,1,3,-2,50,0,10
2,00:06:42,3,True,1,3,-2,11,7,10
2,00:05:19,3,False,3,1,2,44,16,10
2,00:02:13,2,False,3,1,2,37,2,10
3,00:03:22,3,False,4,4,0,50,10,10
3,00:00:45,2,True,11,4,7,47,8,10
4,00:14:43,3,True,11,4,7,35,10,10
4,00:06:18,3,True,14,12,2,35,10,10
4,00:00:21,3,True,17,12,5,28,10,10
1,00:02:54,1,True,0,17,-17,20,10,10
2,00:08:14,3,False,24,3,21,50,8,10
2,00:03:53,0,False,24,10,14,35,0,10
2,00:01:04,3,False,24,13,11,35,10,10
3,00:12:10,3,False,24,19,5,31,1,10
3,00:07:38,1,True,22,24,-2,21,10,10
3,00:00:50,1,False,24,35,-11,27,10,10
4,00:14:47,3,False,24,35,-11,33,10,10
4,00:12:06,0,False,24,35,-11,0,0,10
4,00:00:05,0,False,27,38,-11,25,0,10
3,00:12:22,3,False,10,10,0,44,3,10
3,00:02:35,0,False,10,24,-14,47,0,10
1,00:15:00,0,True,0,0,0,35,0,10
2,00:11:23,1,False,3,1,2,18,10,10
2,00:10:28,3,False,3,1,2,24,4,10
3,00:08:37,0,False,6,12,-6,35,0,10
3,00:06:22,2,False,6,12,-6,50,0,10
4,00:10:20,3,False,21,12,9,35,10,10
1,00:11:05,3,False,0,0,0,40,11,10
1,00:06:02,3,True,0,0,0,41,5,10
2,00:12:14,0,True,3,0,3,44,0,10
2,00:06:19,3,False,0,6,-6,44,1,10
2,00:03:21,1,False,0,13,-13,21,10,10
3,00:12:34,0,True,16,0,16,25,0,10
3,00:04:56,0,False,0,16,-16,0,0,10
3,00:02:28,0,False,0,16,-16,28,0,10
4,00:03:21,1,True,37,0,37,36,10,10
1,00:06:37,2,True,3,3,0,44,12,10
1,00:05:35,1,False,3,3,0,22,10,10
1,00:04:38,2,False,3,3,0,17,15,10
1,00:01:56,2,False,3,3,0,0,1,10
2,00:12:45,2,True,10,3,7,45,2,10
2,00:09:56,3,False,3,10,-7,19,7,10
2,00:09:24,1,False,3,13,-10,35,10,10
2,00:05:01,3,True,13,6,7,39,6,10
3,00:12:45,2,True,20,6,14,46,10,10
4,00:07:41,1,False,27,26,1,2,10,10
4,00:06:42,3,False,27,26,1,6,6,10
4,00:03:03,3,False,27,29,-2,39,6,10
1,00:14:00,3,True,0,0,0,41,4,10
1,00:13:03,1,False,0,0,0,24,5,10
2,00:14:54,1,False,8,7,1,39,10,10
4,00:11:42,3,True,17,34,-17,44,3,10
4,00:10:19,3,False,34,17,17,16,3,10
4,00:09:44,1,False,34,17,17,36,10,10
4,00:02:37,1,False,37,17,20,51,10,10
1,00:11:37,0,False,0,3,-3,35,0,10
2,00:09:48,1,True,10,12,-2,25,10,10
2,00:00:24,3,True,17,26,-9,29,12,10
4,00:13:50,3,False,32,20,12,35,10,10
4,00:05:15,1,True,20,32,-12,42,10,10
4,00:00:56,3,False,32,20,12,50,3,10
1,00:05:50,3,False,3,0,3,34,3,10
1,00:03:19,1,False,3,0,3,30,10,10
1,00:01:52,3,True,0,3,-3,25,15,10
2,00:02:16,2,True,14,6,8,44,6,10
2,00:01:58,2,True,14,6,8,49,11,10
2,00:01:58,2,True,14,6,8,54,16,10
3,00:08:06,0,True,14,9,5,7,0,10
3,00:05:07,0,False,9,21,-12,35,0,10
4,00:02:24,0,False,12,31,-19,35,0,10
4,00:01:56,1,False,12,31,-19,19,10,10
1,00:09:10,3,False,0,1,-1,29,16,10
1,00:08:56,1,True,1,0,1,24,10,10
1,00:01:51,0,True,1,1,0,3,0,10
2,00:03:35,0,True,15,1,14,33,0,10
2,00:03:35,3,True,15,1,14,18,17,10
2,00:02:00,2,False,1,15,-14,21,6,10
3,00:11:55,3,False,1,15,-14,39,10,10
4,00:15:00,3,True,22,11,11,46,10,10
4,00:03:51,0,True,22,20,2,46,0,10
1,00:13:30,1,False,0,0,0,43,10,10
1,00:02:30,3,True,3,3,0,39,16,10
1,00:01:01,1,False,3,3,0,46,10,10
2,00:12:55,1,False,3,3,0,27,10,10
2,00:03:00,0,False,10,6,4,19,0,10
2,00:01:33,0,True,6,17,-11,35,0,10
3,00:12:16,3,False,17,6,11,46,6,10
3,00:11:48,1,False,17,6,11,28,10,10
3,00:11:37,1,False,17,6,11,10,15,10
1,00:12:29,1,True,0,0,0,31,10,10
1,00:01:40,3,False,8,0,8,23,10,10
2,00:13:23,1,True,3,8,-5,50,10,10
2,00:03:55,0,False,15,3,12,46,0,10
4,00:14:15,3,True,16,22,-6,35,10,10
4,00:06:31,0,True,19,30,-11,35,0,10
4,00:03:57,1,False,30,19,11,51,10,10
4,00:02:12,0,False,30,19,11,27,0,10
2,00:15:00,3,True,3,8,-5,41,8,10
2,00:05:57,1,False,9,10,-1,42,10,10
2,00:00:11,2,True,17,16,1,48,9,10
3,00:09:19,2,True,17,16,1,44,12,10
4,00:15:00,3,False,17,17,0,45,10,10
4,00:14:40,1,False,17,17,0,6,10,10
4,00:00:59,3,False,20,27,-7,38,1,10
4,00:00:35,1,True,27,20,7,45,10,10
1,00:11:54,3,False,0,0,0,42,14,10
1,00:08:13,0,True,0,0,0,38,0,10
2,00:15:00,3,False,0,3,-3,30,10,10
2,00:13:41,2,True,3,0,3,45,9,10
2,00:00:42,1,False,15,3,12,40,10,10
3,00:15:00,0,True,3,16,-13,35,0,10
3,00:01:58,3,True,10,23,-13,36,19,10
4,00:09:54,2,False,25,10,15,10,4,10
4,00:02:00,3,True,17,28,-11,46,10,10
1,00:12:31,3,True,0,7,-7,35,9,10
1,00:11:03,1,True,0,7,-7,41,10,10
2,00:12:53,3,True,0,21,-21,50,2,10
2,00:08:17,3,False,21,0,21,54,6,10
2,00:02:57,2,True,0,28,-28,37,10,10
2,00:02:46,3,True,0,28,-28,32,15,10
3,00:14:20,0,True,3,31,-28,41,0,10
3,00:06:03,0,False,31,3,28,28,0,10
4,00:05:34,3,False,32,13,19,46,10,10
4,00:01:54,3,False,35,13,22,49,3,10
4,00:00:09,1,False,38,13,25,42,10,10
1,00:06:05,0,True,13,0,13,5,0,10
2,00:13:28,2,True,16,0,16,52,10,10
2,00:12:17,0,False,0,16,-16,38,0,10
2,00:02:06,0,True,22,7,15,5,0,10
4,00:10:15,0,True,28,20,8,25,0,10
4,00:02:39,1,False,27,35,-8,1,1,10
1,00:14:07,0,True,0,0,0,25,0,10
1,00:09:12,0,False,7,0,7,29,0,10
2,00:14:27,1,False,14,3,11,48,10,10
3,00:05:38,2,True,3,31,-28,38,3,10
4,00:14:04,0,True,3,39,-36,35,0,10
4,00:10:47,1,True,3,40,-37,35,10,10
4,00:08:47,0,False,40,10,30,35,0,10
1,00:01:00,1,False,10,0,10,45,10,10
2,00:02:38,0,True,7,17,-10,35,0,10
3,00:15:00,0,True,7,17,-10,35,0,10
3,00:14:14,3,True,7,17,-10,47,3,10
3,00:11:00,0,False,17,7,10,32,0,10
3,00:08:46,3,True,7,17,-10,17,11,10
4,00:01:30,3,True,18,34,-16,15,11,10
1,00:09:41,1,False,0,3,-3,38,10,10
2,00:13:14,1,True,17,3,14,23,10,10
3,00:06:10,3,True,28,4,24,35,4,10
4,00:05:09,3,False,11,38,-27,48,3,10
1,00:13:47,3,False,0,0,0,41,1,10
1,00:02:39,3,True,7,3,4,43,7,10
2,00:13:48,3,True,7,4,3,41,6,10
2,00:11:18,3,True,7,4,3,55,10,10
3,00:09:23,2,True,9,10,-1,39,12,10
3,00:05:22,0,False,11,9,2,46,0,10
3,00:00:16,0,True,11,11,0,0,0,10
4,00:08:21,3,True,14,14,0,55,2,10
4,00:03:06,0,False,14,14,0,33,0,10
4,00:02:46,3,True,14,14,0,21,22,10
1,00:10:44,3,True,3,0,3,51,8,10
1,00:07:24,3,False,0,3,-3,49,10,10
1,00:02:42,3,False,0,10,-10,25,10,10
2,00:09:38,3,True,16,3,13,37,2,10
3,00:00:01,3,False,18,26,-8,47,3,10
1,00:08:50,3,True,7,0,7,29,10,10
1,00:04:38,1,True,7,0,7,0,10,10
2,00:12:47,0,False,7,14,-7,31,0,10
2,00:00:43,2,False,16,21,-5,32,4,10
3,00:13:17,0,True,21,16,5,54,0,10
1,00:14:09,3,False,0,0,0,39,10,10
1,00:05:10,2,False,3,0,3,46,10,10
2,00:13:00,3,False,3,7,-4,45,6,10
4,00:07:34,3,False,9,14,-5,32,3,10
4,00:07:13,1,False,9,14,-5,29,10,10
4,00:04:01,3,True,14,9,5,44,4,10
1,00:03:57,2,True,7,3,4,50,10,10
2,00:07:51,2,False,9,14,-5,55,11,10
2,00:04:11,3,True,14,9,5,46,7,10
2,00:00:43,1,False,16,14,2,10,10,10
3,00:10:28,0,False,16,24,-8,35,0,10
3,00:09:02,3,False,16,24,-8,25,10,10
3,00:05:57,2,False,16,24,-8,29,6,10
3,00:03:06,2,False,16,26,-10,6,6,10
4,00:13:21,0,True,33,16,17,35,0,10
4,00:03:58,3,True,33,23,10,32,1,10
4,00:03:30,1,True,33,23,10,50,10,10
4,00:00:19,0,False,26,36,-10,24,0,10
1,00:09:00,0,True,0,3,-3,0,0,10
2,00:02:31,0,True,7,10,-3,0,0,10
3,00:07:35,2,True,20,17,3,30,9,10
1,00:09:46,2,True,0,0,0,43,7,10
1,00:02:59,3,True,0,12,-12,25,14,10
1,00:00:01,2,True,0,12,-12,26,10,10
2,00:14:41,0,True,0,12,-12,54,0,10
3,00:12:54,2,False,21,14,7,33,6,10
3,00:11:18,0,True,14,28,-14,35,0,10
3,00:10:14,2,False,28,14,14,1,1,10
3,00:07:51,3,False,28,21,7,47,6,10
4,00:13:08,0,False,28,27,1,35,0,10
4,00:11:04,2,False,28,27,1,41,10,10
4,00:09:50,2,True,27,28,-1,21,10,10
1,00:09:39,0,False,0,7,-7,35,0,10
1,00:05:36,0,False,2,7,-5,25,0,10
1,00:00:02,0,False,4,7,-3,0,0,10
2,00:13:07,0,True,7,7,0,35,0,10
2,00:11:30,2,True,7,7,0,22,13,10
2,00:04:50,0,True,7,14,-7,37,0,10
3,00:05:12,0,True,14,21,-7,38,0,10
4,00:06:47,2,True,14,29,-15,41,10,10
4,00:03:00,1,True,14,29,-15,41,10,10
1,00:01:50,2,False,1,2,-1,23,10,10
1,00:00:27,1,False,1,9,-8,49,10,10
2,00:14:38,3,True,9,1,8,16,13,10
2,00:01:33,0,False,1,16,-15,0,0,10
2,00:01:25,1,True,16,1,15,27,20,10
1,00:13:56,3,False,0,0,0,36,6,10
2,00:13:21,1,True,17,0,17,4,10,10
2,00:08:40,3,True,17,0,17,34,7,10
2,00:08:15,2,False,0,17,-17,29,6,10
2,00:04:35,3,True,24,0,24,25,8,10
4,00:08:56,1,False,14,27,-13,45,10,10
1,00:07:08,3,False,3,3,0,33,3,10
2,00:06:46,3,True,10,6,4,51,5,10
4,00:04:11,0,False,29,27,2,45,0,10
4,00:01:27,0,False,30,27,3,50,0,10
1,00:09:09,2,False,0,0,0,42,9,10
1,00:07:29,2,True,0,0,0,31,10,10
1,00:02:32,2,True,0,3,-3,38,7,10
2,00:06:55,0,True,3,10,-7,37,0,10
2,00:01:34,0,True,3,20,-17,35,0,10
3,00:15:00,0,True,10,20,-10,35,0,10
3,00:10:20,1,True,10,20,-10,54,10,10
3,00:07:08,2,False,20,10,10,32,3,10
4,00:08:52,0,True,13,23,-10,42,0,10
4,00:08:13,2,False,23,13,10,25,20,10
1,00:06:36,3,True,3,3,0,42,14,10
1,00:04:26,3,True,3,3,0,48,8,10
3,00:12:18,3,True,3,23,-20,45,1,10
4,00:14:45,3,False,23,10,13,34,12,10
4,00:02:07,2,False,23,17,6,13,10,10
1,00:10:50,3,True,0,0,0,50,5,10
2,00:01:58,3,False,7,28,-21,43,3,10
3,00:08:12,0,True,31,14,17,35,0,10
3,00:05:31,0,True,31,14,17,0,0,10
4,00:13:45,0,True,31,14,17,49,0,10
4,00:12:12,2,False,14,32,-18,35,10,10
4,00:06:32,0,True,32,14,18,46,0,10
4,00:05:00,3,True,32,14,18,46,19,10
4,00:03:51,2,False,14,32,-18,0,20,10
1,00:14:28,2,False,0,0,0,40,10,10
1,00:13:43,3,False,0,0,0,45,5,10
1,00:12:33,3,True,0,0,0,44,8,10
1,00:12:01,2,False,0,0,0,40,13,10
1,00:02:24,2,False,0,14,-14,41,8,10
3,00:14:54,0,False,3,31,-28,53,0,10
3,00:12:35,0,True,31,3,28,9,0,10
3,00:09:09,1,False,3,34,-31,35,10,10
1,00:02:16,1,True,10,0,10,1,1,10
2,00:05:46,0,True,13,10,3,0,0,10
2,00:02:44,3,True,21,10,11,48,3,10
3,00:01:54,1,True,27,17,10,23,10,10
4,00:08:45,0,False,20,27,-7,24,0,10
4,00:05:30,1,False,21,27,-6,34,10,10
4,00:01:23,3,False,21,36,-15,46,7,10
1,00:03:08,1,False,10,0,10,42,10,10
1,00:00:54,3,False,10,1,9,40,5,10
1,00:00:01,2,True,1,10,-9,25,2,10
2,00:13:17,3,False,12,1,11,48,5,10
3,00:06:05,0,False,15,29,-14,35,0,10
3,00:02:10,3,False,15,29,-14,38,8,10
4,00:09:05,1,True,36,15,21,53,10,10
1,00:14:07,3,True,0,0,0,42,7,10
1,00:13:09,3,False,0,0,0,44,2,10
2,00:00:21,3,True,3,16,-13,48,4,10
4,00:13:18,0,False,23,10,13,34,0,10
4,00:11:29,0,False,23,17,6,35,0,10
4,00:00:54,0,True,27,24,3,44,0,10
1,00:05:05,1,False,3,0,3,16,10,10
2,00:15:00,2,False,3,3,0,29,10,10
3,00:12:09,3,False,15,13,2,51,10,10
3,00:00:04,1,False,18,19,-1,54,10,10
1,00:09:21,3,False,0,7,-7,46,7,10
1,00:05:08,3,False,0,7,-7,25,10,10
3,00:15:00,0,False,15,11,4,35,0,10
3,00:07:28,0,False,15,17,-2,35,0,10
4,00:14:42,1,True,19,15,4,51,10,10
4,00:05:31,0,True,20,15,5,6,0,10
4,00:04:32,3,True,20,15,5,43,2,10
1,00:01:24,1,False,3,7,-4,52,10,10
2,00:00:41,2,False,4,17,-13,31,20,10
3,00:08:41,2,True,17,4,13,45,10,10
3,00:00:12,1,False,7,17,-10,47,10,10
4,00:11:22,1,False,7,20,-13,54,10,10
4,00:11:00,1,False,7,20,-13,30,15,10
1,00:09:43,3,False,0,0,0,14,4,10
1,00:04:40,2,True,3,0,3,14,12,10
2,00:15:00,1,False,3,3,0,33,10,10
2,00:12:05,0,True,6,3,3,20,0,10
2,00:07:33,1,True,6,3,3,0,2,10
2,00:04:58,3,True,6,10,-4,32,3,10
2,00:00:35,3,True,6,17,-11,21,10,10
1,00:04:56,0,True,0,10,-10,45,0,10
2,00:01:00,0,False,13,10,3,54,0,10
3,00:09:34,2,False,13,10,3,24,10,10
4,00:08:25,3,False,23,23,0,32,21,10
4,00:02:33,3,True,26,23,3,54,4,10
1,00:13:05,2,True,0,0,0,50,10,10
1,00:10:01,3,True,0,0,0,23,9,10
1,00:07:05,3,True,0,1,-1,46,14,10
1,00:06:25,2,True,0,1,-1,49,2,10
1,00:02:22,0,False,2,0,2,17,0,10
2,00:13:06,3,True,0,2,-2,15,2,10
2,00:09:25,3,False,2,0,2,20,10,10
2,00:03:05,3,False,2,0,2,55,2,10
1,00:10:49,3,False,0,0,0,20,10,10
2,00:15:00,1,True,3,0,3,14,10,10
2,00:03:44,0,False,14,6,8,55,0,10
3,00:07:06,0,False,24,16,8,33,0,10
1,00:12:09,3,True,0,0,0,50,8,10
2,00:08:32,1,True,6,14,-8,33,10,10
3,00:06:44,3,True,13,22,-9,13,3,10
3,00:01:56,1,True,13,22,-9,39,10,10
2,00:13:36,2,False,10,7,3,29,10,10
2,00:00:41,1,True,24,10,14,4,4,10
3,00:09:14,1,False,24,24,0,2,10,10
4,00:12:16,1,False,27,24,3,29,10,10
4,00:08:35,3,True,24,27,-3,53,6,10
4,00:04:56,1,True,24,27,-3,32,10,10
4,00:04:04,0,False,27,24,3,38,0,10
1,00:02:43,0,True,7,3,4,34,0,10
2,00:11:49,3,False,3,10,-7,32,13,10
2,00:05:16,1,False,3,24,-21,32,10,10
2,00:01:36,3,False,6,31,-25,33,10,10
3,00:04:45,3,True,31,6,25,35,10,10
3,00:02:39,0,True,31,13,18,35,0,10
4,00:10:46,2,True,31,16,15,34,4,10
4,00:10:23,0,False,16,31,-15,47,0,10
4,00:05:02,0,False,16,38,-22,35,0,10
1,00:12:57,3,True,0,0,0,52,10,10
1,00:11:33,0,False,0,0,0,45,0,10
1,00:01:45,0,False,7,3,4,53,0,10
2,00:01:14,3,False,14,13,1,51,6,10
3,00:14:15,2,True,13,14,-1,50,2,10
3,00:11:12,3,False,14,13,1,50,10,10
4,00:13:25,3,True,13,17,-4,20,9,10
4,00:10:17,2,False,17,13,4,0,8,10
4,00:08:55,2,False,17,16,1,35,10,10
4,00:06:40,1,True,16,24,-8,37,10,10
1,00:13:45,1,False,0,0,0,52,10,10
2,00:12:53,3,False,3,7,-4,50,10,10
2,00:06:53,3,True,7,3,4,30,6,10
2,00:04:46,3,True,7,3,4,36,17,10
2,00:03:23,3,True,7,4,3,39,6,10
2,00:01:09,3,True,7,4,3,23,7,10
2,00:00:50,1,False,4,7,-3,47,10,10
3,00:10:34,0,True,10,4,6,35,0,10
3,00:07:25,1,False,4,10,-6,33,10,10
3,00:02:55,1,True,11,4,7,54,10,10
3,00:00:32,2,False,4,11,-7,25,10,10
4,00:15:00,1,True,11,4,7,49,10,10
4,00:01:25,1,True,11,11,0,31,10,10
1,00:03:47,3,True,0,7,-7,37,5,10
2,00:04:10,1,True,7,10,-3,42,10,10
3,00:12:36,3,True,7,17,-10,29,5,10
3,00:10:08,3,False,20,7,13,27,6,10
4,00:09:45,3,True,21,23,-2,55,2,10
4,00:03:09,2,True,28,23,5,33,3,10
1,00:09:44,3,True,7,0,7,55,5,10
1,00:03:01,2,False,0,10,-10,39,4,10
3,00:08:16,2,True,10,21,-11,54,6,10
4,00:15:00,0,False,21,17,4,38,0,10
4,00:04:54,1,True,17,21,-4,37,10,10
1,00:09:23,3,False,0,7,-7,55,5,10
2,00:15:00,2,False,0,14,-14,30,10,10
2,00:11:27,1,True,14,3,11,37,10,10
2,00:02:27,3,False,4,17,-13,51,10,10
4,00:02:12,3,False,20,17,3,51,7,10
4,00:00:16,0,True,20,20,0,30,0,10
1,00:02:40,1,False,3,14,-11,39,10,10
2,00:08:55,3,False,6,21,-15,34,5,10
4,00:09:34,3,True,35,16,19,40,5,10
4,00:02:22,2,False,23,35,-12,7,2,10
1,00:00:32,0,False,7,4,3,35,0,10
2,00:12:09,3,False,14,4,10,51,10,10
2,00:00:11,1,True,7,15,-8,5,5,10
3,00:09:48,3,False,23,7,16,45,5,10
3,00:08:52,3,False,23,7,16,19,10,10
3,00:04:27,1,True,10,23,-13,29,10,10
3,00:02:26,2,False,23,10,13,45,8,10
4,00:12:45,0,False,26,10,16,35,0,10
4,00:03:56,3,False,26,10,16,41,1,10
1,00:12:36,3,False,0,0,0,51,10,10
1,00:12:24,0,True,0,0,0,47,0,10
1,00:07:34,2,True,0,0,0,32,10,10
1,00:02:56,1,True,0,0,0,53,10,10
2,00:06:50,1,True,14,0,14,53,10,10
2,00:02:22,0,True,14,1,13,55,0,10
3,00:14:18,1,True,14,2,12,23,10,10
3,00:11:28,3,True,14,9,5,52,16,10
3,00:01:58,3,False,16,14,2,49,6,10
4,00:10:17,3,False,16,14,2,35,3,10
4,00:03:35,1,False,16,14,2,40,10,10
4,00:02:43,3,False,16,14,2,37,13,10
4,00:01:18,1,True,14,16,-2,25,10,10
1,00:12:17,2,True,0,0,0,38,8,10
1,00:11:17,0,False,0,0,0,18,0,10
1,00:00:44,2,False,0,17,-17,50,9,10
3,00:07:32,0,True,24,13,11,16,0,10
4,00:14:35,1,False,13,34,-21,35,10,10
4,00:01:20,3,True,37,13,24,55,11,10
1,00:09:37,3,True,7,0,7,52,3,10
1,00:04:07,1,False,0,13,-13,5,5,10
1,00:03:40,0,True,14,0,14,33,0,10
2,00:14:03,1,False,0,17,-17,49,10,10
2,00:12:47,1,True,17,0,17,14,10,10
2,00:10:27,3,True,17,0,17,44,6,10
2,00:09:59,1,False,0,17,-17,15,10,10
3,00:04:21,0,False,14,38,-24,35,0,10
4,00:14:41,1,True,38,14,24,40,10,10
4,00:07:54,0,False,14,45,-31,35,0,10
4,00:01:20,0,True,45,21,24,5,0,10
1,00:08:07,3,True,1,0,1,31,18,10
1,00:00:47,3,True,4,0,4,54,5,10
2,00:03:34,0,True,11,0,11,0,0,10
2,00:02:40,2,True,11,0,11,26,4,10
3,00:08:59,3,False,0,14,-14,50,10,10
3,00:00:32,3,True,15,0,15,43,14,10
4,00:13:08,1,False,1,22,-21,25,10,10
4,00:12:07,3,False,1,22,-21,32,5,10
4,00:06:11,0,True,29,1,28,32,0,10
1,00:09:55,3,False,0,7,-7,51,22,10
1,00:03:49,3,False,7,7,0,32,10,10
3,00:12:33,0,True,17,13,4,26,0,10
4,00:13:51,3,False,20,17,3,55,1,10
4,00:11:07,1,True,17,20,-3,47,10,10
4,00:06:57,0,False,27,17,10,44,0,10
1,00:06:04,0,False,0,10,-10,35,0,10
1,00:04:25,1,True,12,0,12,49,10,10
1,00:02:40,0,True,12,0,12,49,0,10
1,00:00:53,3,False,0,12,-12,28,22,10
2,00:08:19,3,True,21,0,21,50,5,10
2,00:05:35,0,True,21,1,20,25,0,10
2,00:02:16,2,False,1,21,-20,22,13,10
3,00:15:00,0,False,1,24,-23,35,0,10
3,00:08:07,1,True,31,1,30,43,10,10
3,00:04:31,0,False,3,31,-28,25,0,10
4,00:11:18,3,True,31,3,28,6,6,10
4,00:09:05,0,False,3,31,-28,36,0,10
4,00:04:24,3,False,10,31,-21,55,10,10
4,00:04:12,0,False,10,31,-21,46,0,10
4,00:02:53,3,True,31,10,21,21,21,10
1,00:14:08,3,True,0,0,0,34,10,10
1,00:03:51,0,False,14,7,7,35,0,10
2,00:13:01,3,False,21,7,14,45,2,10
2,00:03:44,3,True,14,21,-7,48,1,10
2,00:03:22,3,True,14,21,-7,53,6,10
2,00:01:14,2,False,21,14,7,33,6,10
3,00:08:50,3,False,21,20,1,33,22,10
3,00:08:28,0,False,21,20,1,55,0,10
4,00:09:18,3,False,28,26,2,46,7,10
4,00:07:17,3,True,26,28,-2,21,16,10
4,00:06:53,0,True,26,28,-2,44,0,10
4,00:00:11,3,False,28,36,-8,38,7,10
1,00:00:52,0,True,14,0,14,34,0,10
2,00:14:11,1,False,0,14,-14,13,10,10
3,00:11:09,2,True,20,0,20,40,10,10
3,00:00:08,1,True,20,3,17,33,10,10
1,00:02:56,1,True,7,0,7,5,5,10
2,00:13:40,3,False,7,7,0,24,2,10
2,00:11:52,1,False,7,7,0,20,10,10
2,00:05:46,2,True,10,7,3,35,5,10
2,00:05:30,2,True,10,7,3,30,10,10
3,00:07:16,3,False,17,10,7,20,1,10
4,00:13:07,0,False,17,13,4,32,0,10
4,00:08:47,0,True,20,24,-4,5,0,10
1,00:12:59,3,False,0,0,0,38,10,10
1,00:03:28,1,True,7,0,7,44,10,10
2,00:02:58,2,True,17,1,16,48,12,10
2,00:01:18,3,False,1,17,-16,37,2,10
3,00:08:36,2,False,1,24,-23,25,15,10
3,00:01:36,0,True,25,15,10,35,0,10
4,00:04:05,0,False,15,41,-26,35,0,10
1,00:11:39,1,True,0,3,-3,38,10,10
1,00:07:48,1,True,7,3,4,36,10,10
1,00:03:15,3,False,10,7,3,30,19,10
2,00:12:05,1,True,10,10,0,54,10,10
2,00:04:50,0,True,10,10,0,30,0,10
2,00:00:09,1,True,13,16,-3,11,10,10
3,00:05:54,0,False,22,20,2,24,0,10
3,00:04:50,2,True,20,22,-2,42,1,10
3,00:02:16,0,False,22,23,-1,35,0,10
3,00:00:33,0,True,23,22,1,53,0,10
4,00:01:18,1,True,33,28,5,34,10,10
1,00:13:40,3,False,0,0,0,15,13,10
1,00:07:55,3,True,0,0,0,44,2,10
1,00:07:29,1,True,0,0,0,10,10,10
2,00:13:12,0,True,1,0,1,53,0,10
2,00:08:38,3,True,1,0,1,53,8,10
2,00:07:05,0,True,1,7,-6,35,0,10
2,00:02:18,3,False,7,1,6,53,4,10
3,00:13:00,0,True,10,7,3,38,0,10
4,00:14:01,0,False,8,18,-10,35,0,10
4,00:03:27,2,True,25,11,14,23,7,10
4,00:02:52,2,True,25,11,14,55,0,10
1,00:14:03,0,True,0,0,0,35,0,10
1,00:04:50,1,False,3,6,-3,35,10,10
2,00:01:17,1,False,17,6,11,11,10,10
3,00:03:48,2,False,31,12,19,46,10,10
4,00:08:04,0,True,15,34,-19,34,0,10
4,00:05:57,3,True,15,34,-19,35,5,10
4,00:05:28,0,True,15,34,-19,51,0,10
1,00:09:58,3,False,1,0,1,54,10,10
3,00:12:38,2,True,13,14,-1,35,6,10
3,00:12:14,2,True,13,14,-1,40,11,10
3,00:10:58,3,True,13,14,-1,20,6,10
3,00:06:56,3,True,13,14,-1,14,8,10
3,00:05:16,1,True,13,14,-1,42,10,10
3,00:01:28,3,True,13,16,-3,50,2,10
3,00:00:41,2,True,13,16,-3,46,4,10
4,00:10:59,0,False,19,13,6,46,0,10
4,00:06:20,2,True,13,19,-6,15,7,10
4,00:01:46,0,False,26,13,13,46,0,10
1,00:13:54,3,True,0,0,0,13,6,10
1,00:10:28,1,True,0,0,0,43,10,10
1,00:08:43,1,True,0,0,0,20,10,10
1,00:05:07,3,True,0,7,-7,41,9,10
3,00:11:34,3,True,3,13,-10,36,17,10
3,00:02:22,0,False,13,3,10,52,0,10
3,00:00:01,3,False,13,3,10,37,10,10
4,00:09:49,0,True,3,20,-17,35,0,10
4,00:08:40,3,True,3,20,-17,5,12,10
4,00:03:02,3,True,3,23,-20,23,6,10
4,00:00:31,3,False,26,3,23,49,7,10
4,00:00:23,1,True,3,26,-23,30,10,10
1,00:09:08,2,True,0,3,-3,35,8,10
1,00:00:14,0,False,3,3,0,45,0,10
2,00:14:10,1,True,3,4,-1,40,10,10
2,00:13:53,0,False,4,3,1,40,0,10
2,00:04:40,3,True,6,7,-1,27,18,10
3,00:15:00,0,True,9,7,2,35,0,10
3,00:14:59,0,True,9,7,2,1,0,10
3,00:11:12,3,False,7,9,-2,49,10,10
3,00:03:48,2,False,7,9,-2,28,10,10
3,00:00:41,2,True,12,7,5,48,5,10
4,00:13:15,1,False,14,12,2,54,10,10
4,00:11:52,3,False,14,12,2,51,7,10
4,00:01:37,3,True,15,14,1,34,5,10
1,00:10:05,3,True,0,1,-1,28,10,10
1,00:06:08,1,True,0,1,-1,15,10,10
1,00:01:43,2,True,0,4,-4,35,10,10
2,00:14:27,1,False,4,0,4,30,10,10
2,00:13:37,3,True,0,4,-4,52,2,10
2,00:11:18,1,False,4,0,4,44,10,10
2,00:08:46,2,False,4,0,4,16,2,10
3,00:04:18,1,True,7,4,3,8,10,10
4,00:13:47,2,True,7,7,0,39,10,10
4,00:13:24,3,True,7,7,0,29,20,10
1,00:01:42,3,False,3,10,-7,38,17,10
2,00:14:43,3,True,10,3,7,42,5,10
2,00:13:48,2,False,3,10,-7,38,8,10
2,00:13:28,0,False,3,10,-7,50,0,10
2,00:00:23,1,False,3,20,-17,51,10,10
3,00:13:31,1,False,3,20,-17,25,10,10
3,00:12:31,3,False,3,20,-17,40,25,10
3,00:10:30,1,True,20,3,17,40,10,10
4,00:15:00,1,False,3,27,-24,49,10,10
1,00:13:49,1,True,0,0,0,27,10,10
1,00:08:47,0,True,3,3,0,46,0,10
1,00:04:50,3,True,3,10,-7,29,4,10
2,00:10:30,3,False,10,10,0,43,7,10
2,00:08:22,0,False,10,10,0,52,0,10
2,00:08:07,0,True,10,10,0,54,0,10
3,00:15:00,0,True,13,20,-7,35,0,10
3,00:08:20,1,False,20,20,0,24,10,10
3,00:07:25,3,False,20,20,0,26,8,10
3,00:01:57,2,True,20,20,0,17,10,10
4,00:15:00,3,True,20,23,-3,51,11,10
4,00:11:53,0,False,23,20,3,44,0,10
4,00:05:19,0,True,20,26,-6,31,0,10
4,00:00:39,2,True,22,26,-4,35,10,10
1,00:13:41,1,True,0,0,0,22,10,10
1,00:08:35,0,True,0,3,-3,35,0,10
3,00:12:41,2,False,9,6,3,40,10,10
3,00:08:14,3,True,6,12,-6,36,9,10
4,00:15:00,1,True,6,23,-17,44,13,10
4,00:12:01,3,False,23,6,17,40,19,10
1,00:13:45,0,False,0,7,-7,35,0,10
1,00:09:43,2,True,7,0,7,32,4,10
2,00:12:58,0,True,14,14,0,35,0,10
2,00:06:36,1,True,14,17,-3,35,10,10
2,00:00:26,1,False,17,17,0,37,10,10
3,00:10:43,0,False,17,20,-3,32,0,10
3,00:01:52,0,True,23,20,3,14,0,10
1,00:10:22,0,False,0,14,-14,35,0,10
1,00:09:46,2,False,0,14,-14,36,9,10
1,00:03:45,3,True,14,3,11,37,8,10
1,00:01:11,2,True,14,6,8,39,6,10
2,00:08:43,0,True,14,6,8,26,0,10
2,00:02:57,0,True,21,6,15,0,0,10
2,00:00:30,3,False,6,28,-22,34,3,10
3,00:02:52,0,False,6,31,-25,8,0,10
4,00:07:20,3,False,9,37,-28,37,8,10
4,00:01:46,2,True,37,9,28,31,3,10
1,00:08:01,2,True,0,3,-3,41,7,10
1,00:03:32,0,False,6,0,6,48,0,10
1,00:02:08,3,True,0,6,-6,40,5,10
1,00:00:37,3,False,6,0,6,23,5,10
2,00:07:16,2,False,6,6,0,53,4,10
2,00:05:00,0,False,6,6,0,47,0,10
2,00:00:18,0,False,13,6,7,42,0,10
3,00:15:00,0,True,6,13,-7,35,0,10
3,00:14:10,3,True,6,13,-7,10,10,10
3,00:10:25,2,True,6,20,-14,54,3,10
3,00:05:58,0,False,20,13,7,40,0,10
4,00:09:57,0,True,29,20,9,25,0,10
4,00:08:55,3,False,20,29,-9,44,19,10
4,00:04:24,2,True,29,20,9,45,8,10
4,00:03:38,3,True,29,20,9,50,3,10
1,00:04:08,1,True,4,0,4,26,10,10
2,00:15:00,0,False,3,4,-1,15,0,10
2,00:09:14,0,False,3,5,-2,53,0,10
3,00:01:34,0,True,5,17,-12,48,0,10
4,00:11:32,3,False,19,5,14,44,7,10
4,00:07:28,3,True,5,21,-16,48,7,10
4,00:04:29,3,False,21,5,16,29,2,10
1,00:06:19,0,False,6,0,6,5,0,10
3,00:12:46,3,True,21,10,11,51,1,10
3,00:07:45,3,True,21,10,11,16,8,10
4,00:05:58,1,False,19,24,-5,35,10,10
4,00:00:04,0,False,25,24,1,22,0,10
1,00:13:54,3,True,0,0,0,32,5,10
1,00:10:27,0,True,0,7,-7,35,0,10
1,00:10:20,1,True,0,7,-7,22,10,10
3,00:14:06,3,True,7,32,-25,37,3,10
3,00:11:06,2,True,7,32,-25,29,7,10
3,00:07:58,2,True,7,32,-25,12,6,10
3,00:07:22,0,False,32,7,25,17,0,10
4,00:12:55,0,False,35,7,28,47,0,10
4,00:12:13,2,True,7,35,-28,28,20,10
4,00:09:37,3,False,35,7,28,35,11,10
4,00:05:44,0,False,38,14,24,35,0,10
4,00:05:06,0,True,14,38,-24,54,0,10
4,00:04:13,3,False,38,14,24,36,19,10
1,00:12:58,2,True,0,0,0,52,8,10
1,00:09:34,0,False,0,0,0,30,0,10
1,00:07:46,0,True,0,3,-3,35,0,10
1,00:06:29,0,True,0,3,-3,25,0,10
1,00:06:13,1,False,3,0,3,11,20,10
2,00:11:42,1,True,3,3,0,11,10,10
2,00:05:07,0,False,3,10,-7,35,0,10
2,00:01:40,0,False,3,10,-7,35,0,10
2,00:01:06,3,True,10,3,7,45,20,10
3,00:13:46,3,False,3,10,-7,41,0,10
3,00:13:16,1,True,10,3,7,29,10,10
3,00:07:46,0,True,10,3,7,33,0,10
3,00:05:49,3,True,10,3,7,44,5,10
3,00:04:24,1,False,3,10,-7,48,10,10
3,00:04:16,1,False,3,10,-7,43,15,10
4,00:07:19,1,True,11,16,-5,47,10,10
4,00:00:30,0,True,17,23,-6,48,0,10
1,00:01:33,2,False,10,2,8,18,5,10
1,00:00:01,2,False,10,5,5,32,7,10
2,00:14:11,2,True,5,10,-5,37,10,10
2,00:12:37,2,False,10,5,5,16,13,10
2,00:09:18,3,True,8,17,-9,15,10,10
2,00:06:50,3,True,8,20,-12,40,5,10
2,00:01:17,1,True,8,27,-19,42,10,10
3,00:15:00,0,False,30,8,22,35,0,10
3,00:06:54,1,False,30,8,22,20,10,10
1,00:14:54,1,True,0,0,0,44,10,10
1,00:11:14,1,False,0,3,-3,37,10,10
1,00:10:01,0,False,0,3,-3,38,0,10
1,00:01:53,3,True,10,3,7,42,10,10
1,00:01:14,2,False,3,10,-7,25,10,10
2,00:06:50,0,True,17,13,4,35,0,10
3,00:09:22,1,True,20,19,1,14,10,10
3,00:08:20,2,True,20,19,1,38,18,10
4,00:13:58,3,False,26,27,-1,40,14,10
4,00:05:19,2,False,29,30,-1,50,8,10
4,00:02:04,3,False,29,33,-4,42,3,10
1,00:05:26,0,False,0,7,-7,53,0,10
1,00:03:53,0,True,7,0,7,36,0,10
1,00:03:03,2,False,0,7,-7,16,13,10
1,00:00:02,3,True,7,0,7,50,7,10
2,00:14:20,3,False,0,7,-7,27,17,10
2,00:12:00,0,False,0,14,-14,35,0,10
2,00:06:30,2,False,0,14,-14,54,4,10
2,00:03:11,0,True,14,0,14,0,0,10
2,00:02:00,2,True,21,0,21,40,10,10
3,00:14:25,2,True,28,7,21,38,9,10
3,00:05:53,1,True,31,7,24,20,10,10
3,00:04:29,0,True,31,14,17,35,0,10
3,00:01:42,3,False,14,31,-17,39,11,10
4,00:03:49,1,True,38,17,21,3,3,10
4,00:03:24,2,True,38,17,21,13,13,10
4,00:02:43,3,True,38,17,21,11,11,10
1,00:14:53,1,False,0,0,0,25,10,10
1,00:08:37,0,True,0,7,-7,35,0,10
1,00:01:08,3,False,7,0,7,36,4,10
2,00:09:10,0,False,7,7,0,50,0,10
2,00:08:55,2,False,7,7,0,40,12,10
2,00:06:45,1,True,7,7,0,46,10,10
2,00:06:16,0,False,7,7,0,26,0,10
2,00:01:02,2,False,14,14,0,18,17,10
3,00:15:00,0,False,14,21,-7,35,0,10
3,00:12:55,2,True,21,14,7,46,10,10
3,00:12:18,3,True,21,14,7,32,24,10
3,00:08:06,0,True,21,21,0,35,0,10
3,00:06:28,3,True,21,21,0,39,6,10
3,00:02:34,0,False,21,21,0,50,0,10
4,00:13:33,0,False,21,28,-7,0,0,10
4,00:08:09,2,False,21,31,-10,35,10,10
4,00:07:26,0,False,21,31,-10,46,0,10
1,00:08:24,3,True,1,0,1,20,2,10
1,00:07:16,3,False,0,1,-1,34,7,10
2,00:08:09,0,True,7,4,3,37,0,10
2,00:02:52,3,True,8,4,4,45,2,10
3,00:12:12,2,True,8,4,4,19,3,10
3,00:09:44,0,False,4,8,-4,0,0,10
3,00:07:07,2,True,8,4,4,46,18,10
3,00:00:02,1,True,8,7,1,49,10,10
1,00:12:23,2,True,0,0,0,47,18,10
2,00:09:46,3,False,10,7,3,50,12,10
2,00:02:32,0,True,7,17,-10,32,0,10
3,00:14:12,2,False,17,7,10,53,9,10
3,00:13:12,0,True,7,17,-10,55,0,10
3,00:12:22,3,False,17,7,10,42,23,10
2,00:03:00,0,True,4,4,0,55,0,10
3,00:14:18,2,False,4,4,0,35,20,10
4,00:08:07,2,False,4,12,-8,17,10,10
4,00:07:28,3,False,4,12,-8,13,14,10
4,00:02:16,1,False,11,13,-2,35,10,10
4,00:01:35,0,True,13,11,2,33,0,10
4,00:00:12,0,False,11,16,-5,40,0,10
1,00:08:31,0,False,6,0,6,5,0,10
1,00:00:47,3,True,0,10,-10,24,5,10
1,00:00:02,0,True,0,10,-10,38,0,10
2,00:05:40,1,False,10,6,4,40,10,10
2,00:00:32,3,False,13,6,7,33,19,10
3,00:12:45,1,False,13,9,4,35,10,10
3,00:03:52,1,False,13,10,3,35,10,10
3,00:03:15,3,False,13,10,3,28,17,10
4,00:05:02,3,True,17,26,-9,30,6,10
1,00:01:26,3,True,1,0,1,49,9,10
1,00:00:41,0,True,1,0,1,51,0,10
2,00:11:21,3,True,1,0,1,51,3,10
2,00:01:06,1,False,3,1,2,30,10,10
4,00:00:40,3,False,16,24,-8,39,6,10
1,00:00:30,0,True,7,7,0,36,0,10
2,00:08:11,3,False,7,14,-7,37,10,10
4,00:09:00,2,False,24,34,-10,35,10,10
1,00:09:14,0,False,0,7,-7,53,0,10
1,00:08:25,3,True,7,0,7,25,20,10
1,00:06:09,0,False,0,7,-7,15,0,10
1,00:02:48,0,True,7,7,0,35,0,10
2,00:04:47,3,True,7,8,-1,50,30,10
3,00:12:04,1,False,8,7,1,10,10,10
3,00:06:38,1,True,7,8,-1,47,10,10
4,00:09:31,3,True,7,11,-4,13,1,10
1,00:08:13,1,True,10,0,10,49,10,10
2,00:01:57,3,True,13,6,7,47,8,10
2,00:00:37,1,True,13,6,7,49,10,10
2,00:00:16,0,False,6,13,-7,20,0,10
3,00:15:00,0,False,9,13,-4,35,0,10
3,00:12:40,3,False,9,13,-4,8,1,10
4,00:13:32,2,True,16,19,-3,51,10,10
4,00:13:13,3,True,16,19,-3,40,21,10
4,00:10:10,3,True,16,19,-3,25,1,10
4,00:07:27,1,False,19,16,3,30,10,10
1,00:13:31,1,True,0,0,0,45,10,10
2,00:04:35,0,True,8,3,5,40,0,10
2,00:01:15,1,False,3,8,-5,33,10,10
2,00:00:57,2,False,3,8,-5,39,5,10
3,00:15:00,0,True,8,3,5,35,0,10
3,00:11:20,3,False,3,9,-6,38,7,10
4,00:11:43,1,False,3,13,-10,52,10,10
4,00:05:34,1,False,10,13,-3,17,10,10
4,00:03:30,0,False,10,20,-10,33,0,10
4,00:01:24,0,False,10,20,-10,38,0,10
1,00:11:01,2,True,0,0,0,32,15,10
1,00:10:30,1,True,0,0,0,7,10,10
1,00:09:45,3,True,0,0,0,5,12,10
2,00:13:58,0,True,0,7,-7,26,0,10
2,00:13:44,1,False,7,0,7,23,20,10
2,00:06:19,0,False,7,11,-4,35,0,10
3,00:14:02,0,True,14,7,7,54,0,10
1,00:06:48,3,False,1,10,-9,42,10,10
1,00:04:41,2,True,10,1,9,20,3,10
1,00:04:05,3,True,10,1,9,20,3,10
1,00:00:40,1,True,10,3,7,1,10,10
2,00:09:01,2,True,10,3,7,43,15,10
2,00:06:36,0,True,10,3,7,52,0,10
2,00:02:26,3,False,3,13,-10,35,10,10
2,00:00:22,0,True,13,10,3,35,0,10
3,00:13:52,3,False,10,13,-3,31,12,10
3,00:06:29,3,True,13,12,1,54,8,10
3,00:03:00,3,False,12,13,-1,54,2,10
3,00:02:06,2,False,12,13,-1,47,3,10
4,00:13:44,3,False,12,13,-1,32,17,10
1,00:15:00,0,True,0,0,0,35,0,10
1,00:03:13,3,False,7,8,-1,46,10,10
1,00:02:46,3,False,7,8,-1,33,5,10
1,00:01:22,0,True,8,7,1,33,0,10
1,00:00:02,1,False,7,8,-1,13,5,10
2,00:06:35,3,True,15,7,8,30,8,10
2,00:01:37,2,True,15,10,5,47,6,10
3,00:00:02,3,True,18,10,8,48,1,10
4,00:05:35,0,False,10,25,-15,18,0,10
1,00:11:40,1,False,0,3,-3,50,10,10
1,00:05:01,0,True,3,0,3,23,0,10
2,00:14:40,0,True,3,0,3,28,0,10
2,00:10:29,0,False,0,3,-3,23,0,10
2,00:07:42,0,True,3,3,0,38,0,10
2,00:05:59,1,False,3,3,0,26,10,10
2,00:05:25,0,False,3,3,0,54,0,10
2,00:01:15,2,False,3,5,-2,50,5,10
3,00:07:37,1,False,6,5,1,49,10,10
3,00:05:52,2,True,5,6,-1,44,3,10
3,00:02:20,3,False,7,5,2,40,17,10
4,00:12:39,3,True,5,7,-2,42,6,10
4,00:03:22,1,False,7,5,2,42,10,10
4,00:00:25,2,True,5,7,-2,15,10,10
1,00:14:02,3,True,0,0,0,41,9,10
1,00:02:02,0,False,3,0,3,25,0,10
2,00:10:47,0,False,3,0,3,48,0,10
2,00:04:23,3,True,7,10,-3,38,8,10
4,00:13:47,3,False,31,10,21,7,0,10
4,00:08:42,3,True,13,31,-18,4,8,10
2,00:12:05,2,False,17,7,10,39,8,10
2,00:04:28,1,True,7,17,-10,49,10,10
2,00:03:48,2,True,7,17,-10,54,15,10
2,00:01:36,3,True,7,20,-13,50,10,10
4,00:07:37,3,True,31,24,7,45,1,10
4,00:02:22,2,True,38,24,14,53,10,10
4,00:01:02,2,True,38,24,14,38,5,10
4,00:00:32,0,False,24,38,-14,8,0,10
1,00:06:36,3,True,0,0,0,28,7,10
2,00:14:25,0,True,7,8,-1,35,0,10
2,00:11:42,2,False,8,7,1,28,3,10
2,00:04:37,0,False,13,8,5,38,0,10
2,00:03:20,3,True,8,13,-5,29,16,10
2,00:00:38,0,True,8,27,-19,35,0,10
3,00:09:43,2,False,27,15,12,31,5,10
3,00:03:28,2,False,30,15,15,52,10,10
4,00:15:00,1,True,16,30,-14,7,10,10
4,00:01:36,1,False,30,24,6,45,10,10
1,00:12:36,1,False,0,0,0,41,10,10
1,00:08:52,3,True,0,0,0,53,7,10
1,00:06:01,3,True,2,0,2,47,12,10
2,00:13:10,0,False,0,5,-5,40,0,10
2,00:06:41,2,False,3,5,-2,24,10,10
2,00:00:50,3,True,6,3,3,11,4,10
3,00:12:53,2,False,6,6,0,4,3,10
3,00:09:45,1,True,9,6,3,35,10,10
3,00:08:58,3,True,9,6,3,30,15,10
4,00:14:19,0,True,12,16,-4,35,0,10
4,00:06:57,0,False,16,26,-10,35,0,10
4,00:02:23,2,False,16,26,-10,14,1,10
2,00:04:22,0,True,3,29,-26,35,0,10
2,00:04:12,0,False,29,3,26,29,0,10
3,00:15:00,0,True,10,29,-19,35,0,10
3,00:10:15,0,True,10,32,-22,35,0,10
3,00:07:58,1,False,32,18,14,27,10,10
3,00:06:55,3,False,32,18,14,10,27,10
3,00:05:02,0,False,32,25,7,35,0,10
4,00:04:22,1,False,33,33,0,33,10,10
4,00:02:16,0,True,33,33,0,13,0,10
4,00:01:10,0,False,33,40,-7,48,0,10
4,00:00:28,1,True,40,33,7,27,10,10
2,00:08:54,0,True,6,3,3,49,0,10
2,00:01:42,2,False,3,8,-5,16,10,10
3,00:13:58,3,True,15,3,12,55,5,10
3,00:03:02,0,False,6,16,-10,45,0,10
3,00:02:09,3,False,6,16,-10,55,20,10
3,00:01:05,3,True,16,6,10,28,10,10
4,00:15:00,3,False,6,16,-10,39,10,10
4,00:07:00,3,False,9,19,-10,41,4,10
4,00:04:33,3,False,9,19,-10,13,13,10
4,00:02:27,3,False,9,26,-17,27,19,10
4,00:00:15,1,False,9,26,-17,22,10,10
2,00:09:10,3,False,0,13,-13,53,3,10
3,00:09:30,0,True,13,3,10,42,0,10
3,00:01:35,0,True,20,3,17,35,0,10
4,00:03:28,0,False,3,27,-24,35,0,10
1,00:13:20,0,True,0,0,0,23,0,10
2,00:13:10,2,True,0,11,-11,50,2,10
2,00:06:24,0,True,8,18,-10,8,0,10
3,00:09:12,0,True,9,28,-19,35,0,10
3,00:04:47,2,True,9,28,-19,40,8,10
3,00:01:01,0,False,28,9,19,4,0,10
4,00:13:53,0,False,28,9,19,30,0,10
1,00:15:00,0,True,0,0,0,35,0,10
1,00:06:20,3,True,0,0,0,53,4,10
1,00:01:58,3,False,0,0,0,33,17,10
2,00:00:57,1,False,15,3,12,55,10,10
3,00:07:56,3,True,6,15,-9,26,12,10
3,00:02:58,1,True,7,15,-8,51,10,10
4,00:13:18,1,False,15,10,5,1,10,10
4,00:07:39,1,True,17,15,2,25,10,10
4,00:01:46,3,False,16,24,-8,36,4,10
1,00:14:55,1,False,0,0,0,39,10,10
1,00:11:01,3,True,0,0,0,39,0,10
1,00:10:06,2,True,0,0,0,42,5,10
2,00:10:55,0,True,7,0,7,40,0,10
3,00:06:53,3,False,15,15,0,37,6,10
4,00:05:36,3,True,28,15,13,53,1,10
1,00:11:24,2,True,0,0,0,29,9,10
1,00:09:22,3,True,0,0,0,15,4,10
3,00:04:17,3,False,29,17,12,30,5,10
3,00:03:04,0,True,17,29,-12,25,0,10
4,00:07:34,3,False,29,24,5,53,6,10
1,00:15:00,0,True,0,0,0,35,0,10
1,00:09:37,3,True,0,0,0,47,1,10
2,00:14:47,2,False,0,0,0,12,5,10
2,00:08:43,0,True,0,7,-7,11,0,10
2,00:01:41,0,True,0,10,-10,18,0,10
3,00:11:50,3,True,7,11,-4,44,1,10
3,00:10:18,0,True,7,11,-4,51,0,10
3,00:07:37,3,True,7,12,-5,40,5,10
3,00:00:52,2,True,7,12,-5,45,10,10
4,00:14:09,2,True,7,12,-5,14,5,10
4,00:09:06,2,True,7,12,-5,47,9,10
1,00:10:06,0,False,0,7,-7,36,0,10
1,00:07:55,1,False,0,7,-7,43,10,10
1,00:01:30,3,False,0,10,-10,23,16,10
2,00:12:02,0,True,12,0,12,8,0,10
2,00:09:39,1,True,13,0,13,44,10,10
3,00:03:30,2,True,17,0,17,35,12,10
4,00:10:24,3,True,17,0,17,43,5,10
4,00:01:50,2,True,17,0,17,46,3,10
1,00:11:29,0,True,0,3,-3,35,0,10
1,00:03:05,3,True,0,3,-3,47,12,10
2,00:15:00,3,False,3,0,3,41,0,10
2,00:12:52,0,True,2,3,-1,46,0,10
2,00:10:07,0,False,9,2,7,5,0,10
2,00:00:51,3,True,5,10,-5,49,10,10
3,00:14:20,0,False,10,5,5,24,0,10
3,00:12:15,0,False,13,5,8,46,0,10
3,00:09:38,3,True,5,13,-8,52,16,10
3,00:08:05,0,True,5,13,-8,48,0,10
3,00:07:12,3,True,5,13,-8,43,17,10
4,00:07:00,1,False,16,5,11,26,10,10
4,00:05:30,0,False,16,11,5,35,0,10
4,00:00:16,2,False,16,11,5,3,3,10
2,00:07:54,3,True,0,7,-7,52,11,10
2,00:07:35,1,True,0,7,-7,28,10,10
3,00:14:08,3,True,3,7,-4,38,4,10
3,00:01:43,2,False,7,11,-4,45,10,10
3,00:00:42,1,False,7,11,-4,31,10,10
1,00:11:00,2,False,0,7,-7,46,10,10
1,00:04:30,2,True,7,7,0,31,6,10
3,00:09:24,0,False,17,31,-14,22,0,10
3,00:04:24,0,True,31,20,11,29,0,10
4,00:12:49,2,False,20,42,-22,35,10,10
4,00:10:37,3,False,20,42,-22,54,1,10
4,00:04:24,1,True,42,20,22,24,10,10
1,00:11:18,3,True,0,0,0,34,5,10
1,00:11:08,3,True,0,0,0,29,10,10
1,00:08:21,0,False,0,0,0,21,0,10
1,00:07:49,2,True,0,0,0,43,28,10
1,00:07:25,3,True,0,0,0,44,29,10
1,00:04:18,3,True,0,2,-2,51,7,10
2,00:11:24,3,False,2,0,2,35,10,10
3,00:13:46,3,True,0,9,-9,34,12,10
3,00:07:28,0,True,0,17,-17,35,0,10
3,00:00:01,1,False,24,8,16,1,1,10
1,00:02:54,0,False,7,17,-10,35,0,10
1,00:02:42,0,True,17,7,10,13,0,10
2,00:11:10,3,False,7,17,-10,34,1,10
2,00:00:42,2,False,21,20,1,41,10,10
3,00:10:08,0,True,20,21,-1,39,0,10
3,00:01:26,1,False,21,23,-2,35,10,10
4,00:09:56,2,True,29,21,8,40,7,10
1,00:03:35,3,False,0,0,0,37,4,10
2,00:13:16,3,False,10,0,10,27,8,10
2,00:04:21,3,True,6,10,-4,54,10,10
3,00:15:00,0,False,10,9,1,35,0,10
3,00:07:20,3,False,10,12,-2,40,9,10
3,00:03:07,0,True,12,17,-5,35,0,10
3,00:00:56,0,True,12,17,-5,45,0,10
4,00:06:48,2,True,14,17,-3,49,10,10
1,00:15:00,0,True,0,0,0,35,0,10
1,00:13:25,3,True,0,0,0,28,5,10
1,00:12:31,0,True,0,0,0,50,0,10
1,00:08:59,0,True,0,7,-7,35,0,10
1,00:07:45,1,True,0,7,-7,45,10,10
2,00:13:56,1,False,10,0,10,54,10,10
2,00:11:21,0,False,10,0,10,24,0,10
2,00:02:33,0,False,13,7,6,10,0,10
3,00:13:28,1,True,10,20,-10,21,10,10
3,00:12:13,0,False,20,10,10,0,0,10
3,00:10:14,0,True,10,23,-13,53,0,10
3,00:02:35,2,True,13,30,-17,22,16,10
4,00:09:09,3,True,20,30,-10,53,10,10
4,00:09:00,1,False,30,20,10,42,10,10
4,00:01:50,3,False,33,27,6,26,8,10
1,00:15:00,0,False,0,0,0,35,0,10
1,00:07:17,1,False,0,3,-3,47,10,10
1,00:01:09,0,False,0,3,-3,32,0,10
2,00:13:59,0,False,0,3,-3,45,0,10
2,00:03:47,0,False,3,10,-7,39,0,10
2,00:01:56,3,False,3,17,-14,29,7,10
3,00:08:35,3,False,3,24,-21,50,4,10
4,00:10:55,3,False,3,34,-31,45,2,10
4,00:06:59,0,True,34,3,31,16,0,10
1,00:09:43,3,True,0,0,0,19,13,10
1,00:07:52,3,False,0,0,0,51,9,10
1,00:00:38,1,False,7,0,7,42,10,10
1,00:00:20,1,False,7,0,7,30,15,10
2,00:14:33,3,False,7,0,7,40,5,10
2,00:11:47,3,True,0,7,-7,31,4,10
2,00:07:09,3,True,7,7,0,47,10,10
2,00:05:55,3,False,7,7,0,14,4,10
2,00:00:49,3,False,7,14,-7,52,10,10
4,00:12:52,3,True,34,7,27,49,12,10
1,00:11:04,3,False,0,0,0,31,5,10
1,00:08:30,1,False,0,0,0,32,10,10
1,00:03:32,2,False,0,7,-7,18,10,10
1,00:01:36,3,False,0,10,-10,40,5,10
2,00:02:35,1,False,0,28,-28,5,10,10
3,00:06:34,1,False,3,40,-37,47,10,10
4,00:10:03,0,False,9,41,-32,38,0,10
4,00:08:39,3,True,41,9,32,35,10,10
4,00:02:32,1,False,9,41,-32,5,10,10
1,00:07:44,3,False,0,3,-3,34,11,10
1,00:06:15,0,True,3,0,3,29,0,10
2,00:10:24,3,True,4,0,4,40,3,10
2,00:07:09,0,True,4,1,3,40,0,10
2,00:01:55,3,False,1,4,-3,32,21,10
3,00:11:04,2,True,7,1,6,15,10,10
3,00:08:47,0,True,7,3,4,53,0,10
3,00:02:52,0,True,7,3,4,55,0,10
4,00:10:07,2,False,6,15,-9,24,7,10
4,00:07:00,3,False,6,16,-10,51,10,10
1,00:12:41,2,False,0,0,0,40,10,10
2,00:02:48,2,False,10,6,4,41,8,10
2,00:01:34,2,False,10,6,4,30,7,10
2,00:00:23,3,True,6,10,-4,50,4,10
3,00:08:01,3,True,6,13,-7,36,9,10
3,00:04:18,0,False,13,6,7,24,0,10
4,00:06:48,0,False,20,9,11,41,0,10
1,00:09:46,2,True,0,0,0,20,10,10
1,00:06:26,0,False,13,0,13,5,0,10
1,00:01:16,1,True,3,14,-11,48,10,10
2,00:04:58,0,True,6,16,-10,36,0,10
2,00:03:09,3,False,16,6,10,49,10,10
3,00:13:09,1,False,16,7,9,40,10,10
4,00:14:57,0,True,16,23,-7,52,0,10
1,00:13:54,3,True,0,0,0,35,2,10
1,00:06:50,0,True,3,0,3,45,0,10
1,00:01:43,0,True,3,0,3,48,0,10
2,00:10:29,3,True,3,3,0,41,4,10
3,00:11:54,0,True,13,11,2,32,0,10
3,00:09:27,0,True,13,11,2,15,0,10
3,00:08:16,3,True,13,11,2,54,20,10
3,00:08:04,1,False,11,13,-2,38,10,10
3,00:00:42,1,True,13,14,-1,20,10,10
4,00:14:12,0,False,14,13,1,0,0,10
4,00:02:22,0,False,24,13,11,38,0,10
1,00:10:25,0,False,0,7,-7,35,0,10
1,00:00:49,2,False,7,7,0,27,3,10
2,00:11:57,2,True,7,7,0,50,9,10
2,00:03:00,2,True,7,10,-3,39,6,10
2,00:00:15,1,True,7,13,-6,48,10,10
4,00:13:37,3,True,10,23,-13,51,4,10
4,00:08:47,2,False,23,17,6,9,10,10
4,00:01:43,3,True,17,23,-6,46,1,10
4,00:00:58,1,True,17,23,-6,15,10,10
1,00:06:10,0,False,0,1,-1,20,0,10
2,00:10:40,3,True,8,3,5,52,8,10
2,00:01:12,3,False,13,8,5,51,10,10
2,00:00:08,1,False,20,8,12,1,1,10
4,00:11:48,0,False,27,21,6,35,0,10
4,00:11:34,0,True,21,27,-6,28,0,10
4,00:01:41,3,False,27,40,-13,54,5,10
1,00:14:20,0,True,2,0,2,17,0,10
1,00:01:30,0,True,8,0,8,3,0,10
2,00:12:13,0,True,15,0,15,31,0,10
2,00:10:53,1,False,0,15,-15,40,10,10
2,00:06:20,0,True,15,7,8,7,0,10
2,00:05:52,1,False,7,15,-8,51,20,10
2,00:01:13,0,True,15,7,8,45,0,10
3,00:15:00,0,True,15,7,8,33,0,10
3,00:07:30,3,False,14,15,-1,45,7,10
4,00:05:26,1,False,21,18,3,1,1,10
1,00:13:52,3,True,0,0,0,42,7,10
1,00:09:40,1,False,0,3,-3,30,10,10
1,00:00:25,2,False,7,4,3,35,6,10
2,00:07:14,0,True,7,7,0,27,0,10
3,00:15:00,0,False,13,14,-1,35,0,10
3,00:14:08,3,False,13,14,-1,52,3,10
3,00:12:54,3,True,14,13,1,15,4,10
3,00:11:03,2,False,13,14,-1,55,10,10
3,00:07:29,0,False,13,17,-4,35,0,10
3,00:03:52,2,False,13,17,-4,51,10,10
4,00:15:00,0,True,17,13,4,53,0,10
4,00:10:46,0,True,17,13,4,49,0,10
4,00:07:12,2,True,17,20,-3,38,9,10
4,00:00:45,3,True,23,28,-5,47,12,10
1,00:10:18,1,True,0,0,0,47,10,10
2,00:13:21,0,False,0,8,-8,46,0,10
2,00:03:37,3,True,15,14,1,42,9,10
2,00:01:00,1,True,15,14,1,21,10,10
2,00:00:28,3,True,15,14,1,44,33,10
3,00:00:50,2,True,22,24,-2,35,8,10
4,00:06:02,3,False,27,25,2,50,11,10
1,00:10:59,0,False,0,7,-7,35,0,10
1,00:08:22,2,True,7,0,7,28,3,10
2,00:11:45,3,False,3,10,-7,45,7,10
2,00:01:03,3,False,3,10,-7,55,5,10
3,00:12:56,0,False,3,10,-7,35,0,10
3,00:07:11,2,False,9,11,-2,35,10,10
3,00:06:17,0,True,11,9,2,44,0,10
4,00:14:34,0,False,9,11,-2,55,0,10
4,00:03:10,0,False,18,11,7,42,0,10
4,00:02:34,0,False,18,11,7,0,0,10
4,00:00:03,1,False,18,13,5,53,10,10
1,00:14:24,2,False,0,0,0,40,6,10
1,00:04:45,3,False,0,10,-10,34,10,10
2,00:08:00,1,True,17,3,14,34,10,10
2,00:05:17,3,False,3,17,-14,22,15,10
2,00:03:22,3,False,3,17,-14,32,2,10
2,00:02:41,3,False,3,20,-17,38,7,10
2,00:15:00,2,False,3,0,3,28,13,10
2,00:04:17,3,True,7,4,3,35,10,10
4,00:14:01,0,False,14,10,4,35,0,10
4,00:13:45,1,False,14,10,4,25,10,10
4,00:09:44,1,False,14,10,4,48,10,10
1,00:14:16,2,True,0,0,0,46,9,10
1,00:09:50,1,False,0,7,-7,51,10,10
1,00:08:23,0,True,14,0,14,40,0,10
1,00:03:12,3,False,0,14,-14,29,6,10
2,00:06:59,1,False,0,17,-17,35,10,10
3,00:11:34,3,False,1,20,-19,51,7,10
4,00:11:42,1,True,20,5,15,40,10,10
4,00:06:03,0,True,23,5,18,47,0,10
4,00:05:21,2,False,5,23,-18,46,9,10
1,00:00:47,3,False,3,3,0,49,10,10
2,00:08:05,2,False,10,6,4,43,15,10
2,00:00:23,0,True,13,24,-11,35,0,10
3,00:11:49,3,False,24,13,11,43,8,10
4,00:12:50,2,True,16,27,-11,33,10,10
1,00:06:17,3,False,0,4,-4,48,8,10
2,00:13:53,2,True,4,0,4,53,10,10
2,00:04:59,3,True,11,3,8,27,18,10
4,00:14:20,0,True,14,6,8,1,0,10
4,00:13:11,0,True,14,6,8,0,0,10
4,00:10:31,3,False,6,21,-15,39,6,10
4,00:03:15,0,False,9,28,-19,35,0,10
4,00:02:34,1,False,9,28,-19,32,10,10
1,00:05:36,3,True,0,1,-1,55,14,10
1,00:04:21,1,True,0,1,-1,52,10,10
2,00:14:43,2,False,1,0,1,23,1,10
2,00:07:06,3,True,7,1,6,7,0,10
2,00:05:51,0,True,7,4,3,40,0,10
2,00:05:21,1,True,7,4,3,43,20,10
2,00:04:25,2,True,7,4,3,40,23,10
2,00:00:45,0,False,4,16,-12,35,0,10
3,00:12:05,3,False,4,16,-12,30,4,10
4,00:03:11,0,False,16,24,-8,5,0,10
1,00:08:12,3,False,0,0,0,43,4,10
1,00:05:48,2,False,0,0,0,39,6,10
2,00:12:50,3,False,0,1,-1,34,6,10
2,00:01:09,0,False,3,15,-12,35,0,10
3,00:03:59,0,False,3,29,-26,35,0,10
3,00:03:38,1,False,3,29,-26,13,10,10
3,00:03:30,2,False,3,29,-26,8,15,10
3,00:03:11,2,False,3,29,-26,4,19,10
4,00:11:43,1,True,43,3,40,4,4,10
4,00:09:02,3,False,3,50,-47,30,11,10
4,00:07:15,3,False,3,50,-47,48,8,10
4,00:05:18,1,True,50,3,47,19,10,10
4,00:01:58,2,True,50,11,39,40,10,10
1,00:13:52,3,True,0,0,0,30,11,10
1,00:11:04,1,False,0,7,-7,42,10,10
1,00:10:51,1,False,0,7,-7,37,15,10
1,00:08:22,3,True,7,0,7,17,11,10
3,00:05:55,0,True,36,11,25,35,0,10
3,00:03:00,0,True,36,18,18,35,0,10
4,00:08:30,3,True,36,18,18,34,4,10
4,00:05:22,3,False,18,36,-18,49,6,10
4,00:00:42,0,False,18,43,-25,36,0,10
1,00:10:48,2,True,0,0,0,37,10,10
1,00:02:06,2,False,0,7,-7,54,10,10
1,00:01:43,2,True,7,0,7,51,15,10
2,00:10:14,3,True,14,0,14,33,6,10
2,00:05:57,3,True,14,0,14,19,4,10
3,00:11:52,0,False,7,17,-10,35,0,10
3,00:08:02,0,True,17,7,10,41,0,10
3,00:02:10,2,True,20,7,13,25,10,10
4,00:01:12,3,True,20,16,4,53,4,10
1,00:12:49,0,True,0,0,0,18,0,10
1,00:07:39,3,False,0,3,-3,24,8,10
2,00:10:55,3,False,0,7,-7,18,7,10
2,00:05:35,0,True,17,0,17,48,0,10
2,00:04:50,2,False,0,17,-17,43,13,10
3,00:10:12,3,True,17,7,10,15,8,10
4,00:09:26,2,True,18,10,8,24,10,10
4,00:03:40,3,False,10,18,-8,53,18,10
4,00:02:33,0,False,10,18,-8,44,0,10
1,00:14:11,3,False,0,0,0,35,10,10
1,00:06:59,1,True,0,7,-7,40,10,10
1,00:04:41,3,False,7,0,7,38,7,10
3,00:13:25,0,False,14,20,-6,45,0,10
4,00:12:21,3,True,27,17,10,35,8,10
4,00:03:15,0,False,24,37,-13,49,0,10
1,00:09:37,1,True,0,0,0,15,10,10
2,00:14:28,2,False,0,7,-7,30,5,10
2,00:09:49,0,False,0,10,-10,35,0,10
2,00:09:21,2,False,0,10,-10,11,14,10
2,00:04:41,1,False,0,13,-13,26,10,10
2,00:03:57,2,False,0,13,-13,28,8,10
2,00:00:40,3,False,0,20,-20,25,5,10
3,00:13:18,1,False,0,27,-27,32,10,10
3,00:12:34,2,False,0,27,-27,34,8,10
1,00:10:20,3,True,0,0,0,54,9,10
4,00:14:30,2,True,14,27,-13,41,10,10
4,00:03:05,1,True,20,34,-14,49,10,10
4,00:02:17,0,True,27,34,-7,25,0,10
2,00:15:00,2,False,3,3,0,20,10,10
2,00:12:51,3,False,3,6,-3,38,9,10
2,00:08:50,1,True,6,3,3,33,10,10
2,00:00:44,0,False,6,6,0,47,0,10
3,00:08:05,0,True,9,6,3,15,0,10
3,00:05:09,0,False,6,12,-6,40,0,10
3,00:01:55,3,True,12,6,6,35,18,10
3,00:00:42,0,False,6,12,-6,25,0,10
4,00:07:55,3,True,20,6,14,41,3,10
4,00:01:41,3,False,6,20,-14,33,18,10
4,00:00:56,3,False,6,20,-14,13,19,10
1,00:14:45,0,False,0,0,0,30,0,10
1,00:13:25,3,True,0,0,0,33,4,10
1,00:07:55,2,False,0,0,0,25,10,10
1,00:04:57,0,True,0,0,0,18,0,10
1,00:00:03,3,False,1,0,1,45,4,10
2,00:12:32,3,True,0,1,-1,46,3,10
2,00:07:00,2,False,4,0,4,54,5,10
2,00:03:39,0,False,4,0,4,51,0,10
2,00:01:46,0,True,3,4,-1,52,0,10
3,00:13:01,2,True,3,12,-9,47,4,10
3,00:12:44,2,True,3,12,-9,52,9,10
3,00:03:05,0,True,3,19,-16,35,0,10
3,00:00:06,0,True,3,19,-16,20,0,10
1,00:05:41,1,True,7,3,4,45,10,10
1,00:03:19,0,True,7,3,4,52,0,10
1,00:02:25,2,False,3,7,-4,50,12,10
1,00:01:28,3,False,3,7,-4,55,7,10
2,00:15:00,3,True,7,3,4,42,10,10
2,00:09:32,3,True,7,10,-3,30,2,10
2,00:07:38,0,True,7,13,-6,35,0,10
2,00:02:41,1,False,20,7,13,37,10,10
2,00:01:08,0,True,7,22,-15,30,0,10
3,00:08:25,1,False,30,7,23,50,10,10
3,00:03:53,0,True,7,30,-23,45,0,10
3,00:00:10,2,False,30,7,23,30,16,10
4,00:14:46,1,False,30,10,20,35,10,10
4,00:13:16,3,False,30,10,20,34,11,10
4,00:12:25,0,True,10,30,-20,45,0,10
4,00:12:13,2,True,10,30,-20,55,11,10
4,00:09:40,1,False,30,10,20,13,10,10
4,00:02:11,0,False,30,10,20,49,0,10
4,00:01:38,3,False,30,10,20,53,9,10
1,00:05:55,0,False,7,7,0,0,0,10
1,00:02:31,3,True,7,10,-3,39,12,10
2,00:11:30,2,True,7,13,-6,40,2,10
2,00:07:02,1,True,7,13,-6,0,8,10
2,00:01:11,3,True,7,20,-13,54,4,10
3,00:12:58,3,True,7,20,-13,35,17,10
3,00:02:05,3,False,23,7,16,18,6,10
4,00:11:53,3,True,13,23,-10,9,4,10
4,00:04:16,0,True,13,26,-13,30,0,10
1,00:14:19,3,True,0,0,0,35,10,10
1,00:13:42,2,False,0,0,0,53,10,10
1,00:06:32,2,True,6,3,3,44,3,10
1,00:06:04,3,True,6,3,3,37,8,10
1,00:03:33,3,True,6,3,3,44,7,10
2,00:11:33,1,True,13,3,10,1,1,10
2,00:08:25,0,False,10,16,-6,35,0,10
2,00:03:38,0,False,10,19,-9,20,0,10
2,00:00:53,0,True,19,10,9,37,0,10
3,00:07:10,3,False,16,19,-3,32,9,10
3,00:00:29,0,False,16,27,-11,0,0,10
3,00:00:07,3,False,16,27,-11,54,17,10
4,00:05:39,0,True,30,30,0,35,0,10
4,00:03:15,0,False,30,30,0,18,0,10
1,00:01:44,1,True,6,0,6,26,10,10
2,00:15:00,2,False,0,6,-6,40,7,10
2,00:10:49,0,True,6,3,3,35,0,10
2,00:04:05,3,False,5,13,-8,29,8,10
3,00:05:46,3,False,13,13,0,26,6,10
3,00:01:36,1,False,13,16,-3,35,10,10
3,00:00:30,3,False,13,16,-3,37,8,10
4,00:06:58,0,False,20,16,4,42,0,10
1,00:15:00,0,True,0,0,0,35,0,10
1,00:06:17,2,False,7,0,7,30,10,10
1,00:04:25,2,False,7,7,0,45,1,10
2,00:15:00,1,True,7,15,-8,48,10,10
2,00:08:00,2,True,9,15,-6,49,22,10
2,00:07:30,3,True,9,15,-6,44,27,10
2,00:06:20,0,True,10,15,-5,53,0,10
2,00:05:05,3,False,15,10,5,35,10,10
2,00:00:41,3,True,10,18,-8,24,21,10
3,00:13:52,0,False,18,10,8,29,0,10
3,00:09:38,1,False,18,10,8,47,10,10
3,00:05:26,3,False,18,18,0,23,16,10
4,00:11:22,2,True,18,21,-3,26,13,10
4,00:04:48,1,False,22,18,4,11,10,10
4,00:00:12,2,False,23,21,2,39,5,10
1,00:13:47,0,True,0,0,0,45,0,10
1,00:13:30,1,False,0,0,0,45,10,10
1,00:13:03,1,False,0,0,0,2,10,10
1,00:11:23,0,False,0,2,-2,49,0,10
1,00:11:18,0,False,0,2,-2,45,0,10
1,00:06:18,2,True,2,0,2,52,5,10
1,00:00:37,0,False,7,3,4,0,0,10
2,00:09:46,3,False,7,10,-3,50,9,10
2,00:05:01,0,False,7,10,-3,53,0,10
2,00:01:45,0,False,10,10,0,0,0,10
3,00:11:24,2,True,10,10,0,49,10,10
3,00:05:32,2,False,10,16,-6,46,6,10
3,00:04:01,3,True,16,10,6,39,12,10
3,00:02:39,1,True,16,10,6,43,10,10
4,00:13:35,0,False,11,24,-13,45,0,10
4,00:06:48,3,True,25,11,14,47,16,10
4,00:04:15,3,False,11,25,-14,11,7,10
4,00:02:57,0,False,11,26,-15,25,0,10
1,00:07:30,0,False,0,0,0,52,0,10
2,00:11:02,0,False,7,7,0,31,0,10
2,00:07:11,0,True,7,7,0,45,0,10
2,00:06:18,2,False,7,7,0,54,5,10
2,00:05:48,0,True,7,7,0,0,0,10
2,00:01:01,3,True,14,15,-1,51,3,10
3,00:15:00,0,True,14,15,-1,35,0,10
3,00:11:12,3,False,15,22,-7,48,4,10
3,00:02:37,0,True,23,23,0,35,0,10
3,00:02:37,0,False,23,23,0,45,0,10
3,00:01:46,1,False,23,23,0,1,10,10
4,00:12:02,2,False,23,23,0,34,9,10
4,00:11:29,1,False,23,23,0,20,10,10
4,00:08:38,0,False,23,26,-3,13,0,10
4,00:06:58,0,True,26,30,-4,35,0,10
1,00:04:14,0,False,3,7,-4,44,0,10
2,00:07:16,1,False,31,7,24,33,10,10
2,00:03:11,2,True,7,38,-31,20,5,10
2,00:00:35,0,False,38,13,25,35,0,10
3,00:14:34,2,True,13,38,-25,34,10,10
3,00:13:58,3,True,13,38,-25,29,15,10
3,00:05:22,0,True,15,41,-26,14,0,10
3,00:01:52,2,True,18,41,-23,27,4,10
4,00:13:09,2,False,49,18,31,1,6,10
1,00:15:00,0,False,0,0,0,35,0,10
1,00:12:34,1,False,0,0,0,41,10,10
1,00:03:42,2,False,0,7,-7,25,8,10
2,00:09:51,0,False,0,10,-10,48,0,10
2,00:07:09,3,True,10,0,10,42,6,10
2,00:05:46,3,False,0,10,-10,33,7,10
3,00:04:25,1,True,22,0,22,20,10,10
4,00:13:34,2,True,25,3,22,4,2,10
4,00:13:07,0,False,3,25,-22,9,0,10
4,00:08:12,0,True,25,11,14,50,0,10
4,00:03:14,3,False,11,25,-14,5,3,10
4,00:02:30,0,True,28,11,17,39,0,10
1,00:12:55,2,False,0,0,0,40,2,10
1,00:02:54,1,False,3,0,3,18,10,10
2,00:14:11,3,False,3,0,3,50,5,10
2,00:00:41,0,True,7,7,0,20,0,10
3,00:14:31,2,False,7,10,-3,49,5,10
3,00:13:22,0,False,9,10,-1,25,0,10
3,00:13:09,0,True,10,9,1,39,0,10
3,00:03:21,0,False,16,13,3,19,0,10
3,00:01:52,0,False,16,13,3,54,0,10
4,00:12:46,3,True,20,16,4,50,10,10
1,00:01:41,1,True,3,3,0,37,10,10
2,00:01:02,0,True,9,10,-1,38,0,10
3,00:10:41,0,True,17,10,7,7,0,10
3,00:10:08,0,True,17,10,7,0,0,10
3,00:03:00,0,True,21,11,10,49,0,10
4,00:07:27,0,True,21,18,3,54,0,10
4,00:06:54,2,True,21,18,3,30,23,10
4,00:06:29,3,True,21,18,3,36,17,10
4,00:03:58,2,True,21,18,3,36,10,10
4,00:01:17,0,False,21,28,-7,35,0,10
4,00:01:12,1,False,21,28,-7,25,10,10
5,00:00:00,0,False,34,34,0,0,0,10
2,00:13:45,2,False,0,20,-20,20,10,10
2,00:13:07,0,True,20,0,20,21,0,10
2,00:03:00,0,False,8,29,-21,38,0,10
2,00:00:28,2,True,36,8,28,34,2,10
4,00:04:47,3,True,46,17,29,17,15,10
4,00:01:30,3,False,17,46,-29,55,10,10
1,00:00:01,1,True,6,0,6,19,10,10
2,00:12:47,0,True,6,3,3,30,0,10
2,00:11:33,3,True,6,3,3,51,29,10
2,00:09:53,0,False,3,12,-9,35,0,10
2,00:06:33,2,True,12,3,9,2,2,10
2,00:05:41,1,True,12,3,9,0,1,10
4,00:06:06,3,True,25,20,5,45,5,10
1,00:15:00,0,False,0,0,0,35,0,10
1,00:12:00,1,True,0,0,0,9,10,10
2,00:09:22,2,False,7,6,1,45,6,10
2,00:08:47,3,False,7,6,1,31,14,10
2,00:04:42,2,False,7,6,1,38,13,10
2,00:04:20,2,False,7,6,1,33,18,10
2,00:03:02,0,False,7,6,1,50,0,10
3,00:14:11,2,True,6,7,-1,42,2,10
3,00:07:55,3,True,9,7,2,37,1,10
4,00:11:52,3,True,12,22,-10,41,3,10
4,00:10:06,0,False,22,12,10,46,0,10
4,00:03:52,0,False,22,18,4,10,0,10
4,00:03:06,0,False,22,18,4,0,0,10
4,00:00:38,2,False,29,26,3,48,10,10
5,00:00:00,1,True,29,29,0,35,10,10
1,00:13:40,3,False,0,0,0,37,2,10
1,00:13:05,1,True,0,0,0,9,10,10
1,00:05:48,1,True,0,0,0,54,10,10
1,00:00:08,0,True,0,7,-7,35,0,10
2,00:10:55,0,True,0,7,-7,40,0,10
2,00:05:54,0,False,7,14,-7,35,0,10
2,00:01:40,1,True,21,7,14,44,10,10
3,00:12:02,3,True,22,14,8,41,13,10
3,00:09:30,3,False,14,22,-8,32,14,10
3,00:03:38,2,False,17,22,-5,51,6,10
4,00:14:44,1,True,22,17,5,39,10,10
4,00:13:14,0,False,20,22,-2,41,0,10
4,00:10:40,3,False,20,22,-2,37,10,10
4,00:08:11,3,True,22,20,2,46,5,10
4,00:06:47,3,False,20,22,-2,43,7,10
4,00:02:32,1,False,20,22,-2,20,10,10
4,00:02:12,0,True,22,20,2,6,0,10
1,00:06:08,0,True,1,0,1,45,0,10
1,00:03:51,0,True,1,0,1,46,0,10
1,00:03:28,1,False,0,1,-1,30,20,10
2,00:13:58,0,False,0,4,-4,51,0,10
2,00:05:30,0,True,4,7,-3,13,0,10
2,00:02:46,2,False,7,4,3,28,4,10
2,00:02:34,3,False,7,4,3,31,1,10
3,00:15:00,0,False,10,7,3,35,0,10
3,00:14:42,1,False,10,7,3,11,10,10
3,00:01:13,1,False,10,14,-4,44,10,10
3,00:01:04,1,False,10,14,-4,39,15,10
3,00:00:10,2,True,14,10,4,53,10,10
4,00:09:55,3,False,13,14,-1,13,19,10
1,00:09:07,2,True,0,2,-2,27,10,10
2,00:12:36,3,True,0,5,-5,25,4,10
2,00:02:06,3,False,8,0,8,52,11,10
3,00:10:37,0,False,8,6,2,17,0,10
3,00:02:45,2,True,6,11,-5,35,10,10
4,00:07:16,3,True,12,17,-5,51,9,10
1,00:04:30,1,False,7,0,7,31,10,10
1,00:03:05,3,False,7,0,7,29,12,10
1,00:00:02,0,False,7,0,7,41,0,10
2,00:12:26,0,True,0,8,-8,47,0,10
2,00:11:40,3,True,0,8,-8,53,3,10
2,00:02:33,3,False,9,4,5,37,8,10
3,00:14:14,0,False,17,4,13,48,0,10
3,00:07:38,0,False,17,11,6,18,0,10
4,00:09:06,2,False,27,11,16,15,7,10
4,00:03:09,3,False,27,14,13,38,19,10
1,00:13:30,1,False,1,0,1,24,10,10
1,00:11:20,2,False,1,0,1,40,5,10
1,00:07:37,0,False,8,0,8,37,0,10
1,00:01:30,0,True,6,16,-10,0,0,10
2,00:02:51,3,True,16,16,0,50,4,10
3,00:10:27,3,True,16,16,0,38,10,10
3,00:04:03,1,False,16,16,0,0,10,10
3,00:01:10,0,True,23,16,7,41,0,10
4,00:12:31,0,False,22,23,-1,52,0,10
4,00:09:06,3,True,23,22,1,19,0,10
4,00:06:53,0,False,25,23,2,41,0,10
4,00:01:27,2,True,26,25,1,45,4,10
1,00:07:02,3,True,0,8,-8,16,16,10
1,00:05:50,2,True,0,8,-8,30,0,10
1,00:03:05,0,True,0,11,-11,54,0,10
2,00:08:20,2,False,19,8,11,18,5,10
2,00:07:40,0,True,8,19,-11,10,0,10
2,00:05:02,3,False,19,11,8,35,10,10
2,00:02:19,0,False,19,17,2,35,0,10
2,00:01:49,2,False,19,17,2,40,10,10
2,00:01:29,0,False,19,17,2,36,0,10
2,00:00:20,3,False,19,17,2,43,5,10
3,00:14:54,0,True,17,19,-2,51,0,10
4,00:12:27,2,False,23,20,3,39,16,10
4,00:12:00,3,True,20,23,-3,52,35,10
4,00:00:25,1,False,26,26,0,52,10,10
1,00:12:07,2,False,0,0,0,55,5,10
1,00:01:42,3,False,0,14,-14,31,11,10
2,00:10:22,1,True,21,7,14,40,10,10
2,00:08:41,3,True,21,7,14,19,20,10
2,00:08:32,3,True,21,7,14,14,25,10
3,00:03:35,0,True,21,18,3,35,0,10
4,00:14:17,0,False,18,21,-3,17,0,10
4,00:13:43,2,True,21,18,3,39,20,10
4,00:11:11,1,False,21,21,0,29,10,10
1,00:14:22,1,True,0,0,0,41,10,10
1,00:13:43,1,True,0,0,0,33,10,10
1,00:10:10,2,False,0,0,0,29,9,10
1,00:09:15,0,True,0,0,0,6,0,10
1,00:06:30,3,False,0,0,0,9,16,10
2,00:08:22,2,False,3,4,-1,54,10,10
2,00:07:59,2,False,3,4,-1,39,25,10
2,00:02:42,3,False,3,4,-1,43,7,10
2,00:01:40,3,False,3,4,-1,54,14,10
3,00:01:20,0,True,18,3,15,46,0,10
4,00:12:05,2,False,3,18,-15,44,10,10
4,00:08:26,0,True,25,3,22,0,0,10
4,00:05:27,0,True,25,3,22,2,0,10
4,00:04:11,2,False,3,32,-29,27,10,10
4,00:03:42,3,False,3,32,-29,22,15,10
4,00:01:23,2,True,32,3,29,47,10,10
1,00:03:16,2,True,3,7,-4,50,3,10
1,00:00:03,0,False,7,3,4,36,0,10
2,00:13:45,2,True,3,10,-7,41,4,10
2,00:10:36,0,True,3,10,-7,5,0,10
3,00:04:57,0,True,21,17,4,37,0,10
3,00:00:05,2,True,21,17,4,27,1,10
4,00:15:00,0,False,17,21,-4,3,0,10
4,00:13:42,0,False,20,21,-1,50,0,10
4,00:08:34,0,False,20,21,-1,13,0,10
4,00:03:29,2,True,21,28,-7,31,1,10
4,00:01:41,0,False,31,21,10,52,0,10
1,00:09:43,0,False,0,7,-7,46,0,10
1,00:07:14,0,False,3,7,-4,52,0,10
1,00:05:20,3,True,7,3,4,45,2,10
1,00:03:03,0,True,7,3,4,17,0,10
2,00:14:06,1,True,7,6,1,35,10,10
2,00:08:48,0,True,7,6,1,15,0,10
2,00:01:53,0,False,13,7,6,45,0,10
2,00:01:07,0,True,7,13,-6,47,0,10
2,00:00:33,3,False,13,7,6,36,18,10
3,00:13:05,0,False,14,10,4,33,0,10
3,00:05:26,0,True,10,15,-5,46,0,10
3,00:02:35,3,True,10,15,-5,25,10,10
4,00:05:12,2,True,13,18,-5,44,8,10
4,00:01:26,0,True,13,18,-5,42,0,10
2,00:13:04,0,True,3,7,-4,35,0,11
2,00:10:49,3,False,7,3,4,47,5,11
2,00:05:37,2,False,7,3,4,53,0,11
2,00:04:10,0,False,7,3,4,11,0,11
2,00:01:56,1,True,3,7,-4,16,10,11
3,00:12:12,0,False,14,3,11,9,0,11
4,00:12:28,1,False,24,6,18,6,10,11
1,00:13:16,0,True,0,0,0,28,0,11
1,00:13:07,0,True,0,0,0,12,0,11
1,00:05:33,2,True,7,3,4,18,17,11
2,00:10:27,0,True,7,13,-6,51,0,11
3,00:06:22,3,True,12,23,-11,48,10,11
4,00:14:37,0,False,26,12,14,35,0,11
4,00:02:09,1,False,33,26,7,43,10,11
1,00:12:44,3,False,0,0,0,31,5,11
1,00:12:33,0,False,0,0,0,31,0,11
3,00:09:08,1,False,9,21,-12,24,10,11
3,00:06:48,3,True,21,9,12,43,1,11
3,00:04:59,0,False,9,21,-12,2,0,11
2,00:03:30,3,True,7,11,-4,29,1,11
2,00:02:48,0,False,11,14,-3,35,0,11
3,00:10:21,0,True,14,11,3,34,0,11
3,00:00:39,0,True,21,14,7,35,0,11
2,00:11:27,0,False,3,7,-4,37,0,11
2,00:03:14,0,False,10,7,3,25,0,11
2,00:02:34,0,False,10,7,3,40,0,11
2,00:02:12,0,False,10,7,3,25,0,11
3,00:11:47,0,True,14,18,-4,2,0,11
4,00:14:05,1,True,24,18,6,47,15,11
1,00:12:51,3,False,0,0,0,42,10,11
1,00:05:41,0,True,3,0,3,26,0,11
1,00:02:17,3,True,3,0,3,15,9,11
4,00:15:00,0,False,23,17,6,47,0,11
1,00:14:08,2,True,0,0,0,27,12,11
1,00:12:19,0,True,0,0,0,37,0,11
1,00:10:29,2,False,0,7,-7,9,12,11
2,00:13:19,2,False,0,17,-17,24,6,11
2,00:03:35,3,True,17,7,10,13,18,11
2,00:01:07,0,True,17,7,10,30,0,11
3,00:10:48,0,True,20,7,13,31,0,11
3,00:00:09,3,True,30,7,23,44,19,11
4,00:05:29,0,False,13,37,-24,49,0,11
1,00:15:00,0,False,0,0,0,35,0,11
1,00:14:04,0,False,0,0,0,51,0,11
2,00:13:06,2,True,8,0,8,27,12,11
2,00:10:21,0,False,3,8,-5,21,0,11
2,00:07:37,0,False,3,8,-5,45,0,11
2,00:03:20,3,True,8,10,-2,22,5,11
2,00:01:39,1,True,8,10,-2,38,10,11
3,00:06:50,3,True,8,17,-9,29,5,11
4,00:09:20,2,False,20,9,11,44,5,11
1,00:03:41,0,True,2,0,2,5,0,11
2,00:12:55,1,True,2,7,-5,47,10,11
3,00:14:19,0,False,10,9,1,53,0,11
4,00:12:53,0,True,17,17,0,40,0,11
3,00:00:01,2,True,9,13,-4,47,19,11
1,00:06:46,1,False,0,3,-3,43,10,11
1,00:05:43,2,True,3,0,3,53,10,11
1,00:02:01,1,False,2,3,-1,54,10,11
1,00:01:49,1,True,3,2,1,54,5,11
2,00:09:39,3,True,10,5,5,50,10,11
2,00:00:42,1,True,17,5,12,45,10,11
4,00:15:00,0,False,8,34,-26,20,0,11
4,00:13:10,3,True,34,15,19,27,17,11
1,00:13:24,0,False,0,7,-7,35,0,11
1,00:02:30,2,False,1,10,-9,40,6,11
2,00:03:32,0,False,2,13,-11,53,0,11
2,00:00:57,0,False,5,13,-8,53,0,11
3,00:08:34,0,True,16,8,8,32,0,11
4,00:05:01,3,True,30,30,0,23,22,11
4,00:04:50,1,False,30,30,0,40,10,11
4,00:01:06,1,True,30,37,-7,53,10,11
4,00:00:38,3,False,37,30,7,15,12,11
1,00:11:51,3,True,0,0,0,35,15,11
1,00:06:18,2,False,0,7,-7,37,1,11
1,00:05:35,0,True,7,0,7,40,0,11
2,00:11:36,1,False,0,14,-14,13,10,11
2,00:07:34,1,False,0,14,-14,8,13,11
2,00:02:45,0,False,0,21,-21,35,0,11
2,00:02:19,0,False,0,21,-21,7,0,11
2,00:01:41,0,False,0,21,-21,52,0,11
3,00:12:51,3,False,0,35,-35,37,9,11
3,00:12:26,0,False,0,35,-35,25,0,11
3,00:09:12,3,False,0,38,-38,40,5,11
4,00:04:18,2,False,0,51,-51,51,4,11
1,00:06:54,1,False,3,7,-4,45,10,11
1,00:06:11,2,True,7,3,4,50,10,11
1,00:05:47,0,False,3,7,-4,36,0,11
3,00:11:48,0,True,10,12,-2,36,0,11
3,00:10:50,0,True,10,12,-2,17,0,11
4,00:12:56,0,False,13,24,-11,35,0,11
4,00:09:26,3,False,13,24,-11,40,15,11
4,00:02:11,3,True,25,13,12,42,8,11
4,00:01:56,2,False,13,25,-12,51,10,11
1,00:05:46,0,True,7,3,4,35,0,11
1,00:05:13,2,False,3,7,-4,53,10,11
1,00:03:12,0,False,3,7,-4,42,0,11
2,00:00:48,0,False,14,7,7,26,0,11
3,00:09:32,2,False,14,9,5,25,10,11
3,00:05:50,2,True,16,14,2,55,6,11
4,00:15:00,2,True,23,14,9,1,3,11
4,00:10:31,0,True,23,21,2,24,0,11
4,00:04:48,0,True,23,21,2,38,0,11
2,00:14:11,0,True,6,8,-2,20,0,11
2,00:09:19,0,True,12,8,4,5,0,11
2,00:08:07,1,False,8,13,-5,45,10,11
2,00:02:10,1,False,8,13,-5,49,10,11
3,00:08:58,1,True,13,15,-2,13,10,11
3,00:08:29,1,True,13,15,-2,5,5,11
3,00:02:15,2,True,16,22,-6,43,14,11
4,00:01:52,2,False,22,19,3,36,10,11
1,00:07:57,0,True,7,0,7,21,0,11
1,00:03:02,1,True,8,0,8,3,3,11
2,00:05:27,0,False,14,8,6,31,0,11
2,00:01:17,0,False,14,8,6,30,0,11
2,00:01:11,2,True,8,14,-6,40,10,11
2,00:00:07,0,False,14,8,6,18,0,11
3,00:15:00,0,True,8,17,-9,35,0,11
3,00:11:47,2,False,17,8,9,34,10,11
3,00:10:50,3,False,17,8,9,24,0,11
3,00:01:10,2,False,20,15,5,20,11,11
4,00:04:53,0,True,22,27,-5,28,0,11
1,00:13:32,3,True,0,0,0,36,1,11
1,00:05:40,2,False,0,7,-7,26,8,11
2,00:11:42,2,False,0,17,-17,46,1,11
3,00:12:31,3,False,3,24,-21,46,8,11
3,00:07:00,3,True,24,3,21,13,10,11
3,00:05:17,2,False,3,24,-21,48,12,11
4,00:15:00,1,False,4,24,-20,52,10,11
1,00:02:33,1,False,14,3,11,6,6,11
1,00:02:15,2,False,14,3,11,3,3,11
1,00:00:55,3,False,14,10,4,36,3,11
1,00:00:40,1,True,10,14,-4,31,10,11
1,00:00:25,1,True,10,14,-4,36,5,11
3,00:01:16,0,True,33,24,9,40,0,11
4,00:07:30,0,True,33,31,2,19,0,11
1,00:12:18,2,True,0,1,-1,35,10,11
1,00:11:15,0,False,1,0,1,16,0,11
1,00:06:19,2,True,0,11,-11,39,5,11
1,00:02:26,1,False,11,0,11,42,10,11
2,00:14:32,2,False,11,3,8,30,15,11
2,00:09:05,3,False,11,3,8,53,1,11
3,00:07:00,1,True,23,12,11,36,10,11
3,00:01:08,1,True,23,12,11,45,10,11
4,00:13:07,1,False,15,23,-8,21,10,11
4,00:12:04,0,False,15,23,-8,38,0,11
4,00:08:38,0,False,23,23,0,25,0,11
4,00:04:02,1,False,30,23,7,37,10,11
1,00:13:56,2,True,0,0,0,50,10,11
1,00:11:54,0,False,6,7,-1,5,0,11
1,00:10:13,2,False,7,7,0,46,5,11
1,00:07:27,1,False,7,8,-1,55,10,11
2,00:11:42,3,True,15,21,-6,39,0,11
2,00:05:17,0,True,22,24,-2,52,0,11
2,00:01:17,0,False,31,25,6,36,0,11
3,00:03:05,2,True,32,34,-2,49,1,11
4,00:11:41,0,False,34,32,2,21,0,11
4,00:00:09,1,True,39,34,5,13,10,11
1,00:06:23,3,False,0,5,-5,40,15,11
1,00:04:46,2,True,5,0,5,38,13,11
1,00:00:15,3,True,5,0,5,54,12,11
3,00:11:09,3,True,15,0,15,50,4,11
3,00:00:40,2,False,7,15,-8,39,7,11
4,00:01:42,3,True,36,14,22,31,3,11
4,00:01:16,3,True,36,14,22,21,25,11
2,00:14:24,0,True,16,0,16,18,0,11
2,00:07:40,1,False,6,16,-10,33,10,11
2,00:06:48,0,True,16,6,10,6,0,11
2,00:02:07,3,False,6,24,-18,22,23,11
4,00:13:46,0,True,38,21,17,37,0,11
1,00:12:21,2,False,0,0,0,40,4,11
2,00:14:05,2,False,0,17,-17,42,4,11
2,00:12:07,1,True,17,0,17,48,10,11
2,00:03:32,1,True,20,3,17,29,10,11
4,00:09:23,0,True,27,17,10,46,0,11
4,00:06:22,1,True,27,17,10,25,15,11
4,00:04:40,0,False,24,27,-3,46,0,11
5,00:00:00,1,True,27,27,0,35,10,11
1,00:05:47,1,False,7,0,7,47,10,11
1,00:05:16,1,True,0,7,-7,46,10,11
1,00:02:33,2,True,0,7,-7,14,5,11
2,00:13:52,3,False,14,0,14,53,10,11
2,00:02:23,3,False,15,1,14,22,2,11
3,00:05:47,0,False,36,4,32,50,0,11
4,00:14:25,2,True,6,36,-30,22,14,11
4,00:01:49,0,True,12,39,-27,45,0,11
1,00:14:46,1,False,0,0,0,35,10,11
1,00:02:56,3,False,0,3,-3,54,10,11
1,00:00:02,1,True,3,0,3,52,10,11
3,00:03:29,0,False,8,3,5,51,0,11
4,00:06:29,1,True,4,9,-5,1,1,11
4,00:01:56,0,True,11,16,-5,39,0,11
4,00:00:17,1,True,11,19,-8,35,10,11
1,00:13:13,2,True,0,0,0,42,0,11
1,00:01:45,2,False,0,7,-7,49,9,11
3,00:07:39,2,False,3,14,-11,24,6,11
4,00:05:14,2,False,9,17,-8,12,12,11
4,00:02:40,3,False,9,24,-15,48,9,11
1,00:08:00,0,True,0,7,-7,29,0,11
2,00:06:10,3,False,14,11,3,35,10,11
4,00:14:06,0,True,20,21,-1,34,0,11
4,00:06:23,2,False,21,28,-7,38,19,11
1,00:11:24,0,True,0,7,-7,35,0,11
1,00:08:28,1,True,0,9,-9,39,10,11
1,00:05:52,0,True,0,16,-16,13,0,11
1,00:04:43,0,True,0,16,-16,2,0,11
1,00:03:15,0,True,7,16,-9,35,0,11
2,00:14:45,1,False,16,7,9,39,10,11
2,00:07:46,0,True,7,16,-9,42,0,11
3,00:09:20,1,True,13,16,-3,27,10,11
3,00:07:47,0,False,22,13,9,5,0,11
4,00:13:38,0,False,23,13,10,45,0,11
4,00:12:53,1,True,13,23,-10,39,15,11
4,00:07:31,1,True,13,30,-17,52,10,11
4,00:04:20,1,True,20,30,-10,31,10,11
1,00:13:25,3,False,0,0,0,37,11,11
1,00:11:47,2,True,0,0,0,40,6,11
1,00:09:33,0,False,0,0,0,46,0,11
2,00:11:39,3,False,7,10,-3,49,10,11
2,00:06:11,0,False,7,10,-3,41,0,11
4,00:11:49,1,False,19,15,4,3,3,11
4,00:02:36,0,True,25,19,6,37,0,11
4,00:01:35,1,False,19,28,-9,35,10,11
1,00:03:45,2,True,4,0,4,42,5,11
1,00:00:47,1,False,7,4,3,37,10,11
2,00:07:58,1,True,11,7,4,14,10,11
2,00:02:35,2,True,11,14,-3,5,10,11
3,00:01:32,2,False,29,14,15,41,5,11
2,00:11:40,1,False,8,11,-3,17,10,11
2,00:05:49,0,False,14,18,-4,5,0,11
2,00:04:20,1,True,18,15,3,28,10,11
4,00:06:23,0,False,32,25,7,50,0,11
4,00:00:06,1,False,33,26,7,50,10,11
1,00:03:56,1,False,0,7,-7,42,10,11
2,00:08:22,0,True,7,6,1,44,0,11
2,00:05:03,0,False,6,7,-1,11,0,11
3,00:10:15,1,True,7,13,-6,1,1,11
4,00:13:24,0,True,7,19,-12,36,0,11
4,00:11:45,3,True,7,19,-12,50,3,11
4,00:02:16,3,True,14,19,-5,32,13,11
1,00:13:23,2,False,7,0,7,53,9,11
1,00:09:49,2,True,7,7,0,54,3,11
2,00:04:54,0,False,18,7,11,43,0,11
3,00:03:05,3,True,14,40,-26,21,15,11
1,00:08:45,3,True,7,0,7,24,30,11
1,00:08:22,1,False,0,7,-7,27,10,11
1,00:00:02,0,False,0,8,-8,39,0,11
2,00:12:00,2,True,9,6,3,33,15,11
2,00:08:46,0,False,6,9,-3,51,0,11
4,00:08:34,0,True,18,13,5,5,0,11
4,00:06:30,2,False,13,18,-5,12,12,11
2,00:15:00,2,False,0,3,-3,39,6,11
3,00:09:08,3,True,3,8,-5,47,8,11
3,00:08:04,0,True,3,8,-5,40,0,11
1,00:06:03,0,True,0,0,0,21,0,11
1,00:02:49,1,False,0,1,-1,54,10,11
3,00:12:20,1,False,17,4,13,25,10,11
3,00:00:12,0,True,4,27,-23,5,0,11
3,00:00:02,0,True,4,27,-23,1,0,11
4,00:02:49,1,False,35,11,24,25,10,11
2,00:04:26,2,False,14,6,8,46,4,11
3,00:14:56,1,False,21,6,15,30,10,11
2,00:12:08,2,True,1,3,-2,33,8,11
3,00:15:00,0,False,3,4,-1,35,0,11
3,00:11:08,3,False,4,4,0,49,6,11
3,00:02:27,0,False,4,4,0,52,0,11
4,00:03:46,3,True,14,12,2,45,1,11
4,00:00:25,0,False,12,17,-5,50,0,11
2,00:12:15,0,True,0,24,-24,45,0,11
2,00:06:42,1,True,3,24,-21,54,10,11
3,00:04:19,1,True,28,24,4,25,10,11
3,00:00:03,0,True,35,24,11,23,0,11
4,00:13:31,3,True,35,24,11,39,11,11
4,00:13:06,0,True,35,24,11,55,0,11
4,00:11:18,0,False,24,35,-11,39,0,11
4,00:06:28,2,False,27,35,-8,47,8,11
4,00:06:17,2,False,27,35,-8,42,3,11
1,00:14:13,2,True,0,0,0,33,4,11
2,00:15:00,2,True,0,3,-3,54,6,11
2,00:09:28,0,True,3,3,0,25,0,11
2,00:00:49,3,False,10,10,0,25,1,11
3,00:13:59,0,False,10,10,0,30,0,11
4,00:11:09,2,False,13,24,-11,34,10,11
1,00:00:56,1,True,0,3,-3,55,10,11
2,00:06:28,0,False,3,2,1,45,0,11
2,00:01:18,2,False,6,2,4,33,10,11
3,00:10:29,2,False,6,9,-3,13,3,11
3,00:04:00,1,True,12,13,-1,38,10,11
4,00:01:07,0,False,21,15,6,47,0,11
4,00:00:59,3,True,15,21,-6,42,15,11
1,00:09:26,3,True,0,0,0,50,10,11
1,00:04:35,3,False,0,0,0,55,1,11
1,00:02:01,2,False,0,0,0,40,4,11
2,00:13:16,0,True,3,0,3,52,0,11
2,00:01:42,2,False,0,13,-13,24,4,11
3,00:02:58,1,True,16,0,16,35,10,11
4,00:13:28,3,False,0,23,-23,15,23,11
4,00:06:23,2,False,0,30,-30,28,9,11
4,00:02:26,2,True,37,0,37,53,1,11
2,00:14:26,3,True,10,3,7,54,17,11
2,00:09:09,1,False,3,13,-10,30,10,11
4,00:13:42,1,False,13,26,-13,35,10,11
4,00:10:20,2,True,26,27,-1,30,8,11
4,00:02:44,1,True,29,27,2,49,10,11
1,00:13:33,1,False,0,0,0,20,10,11
1,00:11:52,2,False,0,0,0,32,5,11
1,00:11:12,2,False,0,0,0,41,0,11
1,00:07:48,0,False,1,0,1,39,0,11
1,00:00:52,2,True,0,8,-8,48,10,11
2,00:00:21,0,False,14,14,0,35,0,11
3,00:06:03,1,False,24,14,10,37,10,11
4,00:02:31,0,False,37,17,20,54,0,11
4,00:02:07,1,False,37,17,20,17,10,11
4,00:01:52,0,True,17,37,-20,2,0,11
4,00:01:42,1,False,37,17,20,1,1,11
1,00:03:28,3,True,10,0,10,33,1,11
2,00:15:00,3,False,3,10,-7,45,2,11
4,00:01:36,1,False,32,20,12,25,10,11
1,00:07:36,1,True,0,3,-3,49,10,11
2,00:00:24,2,False,6,14,-8,49,3,11
3,00:09:44,3,True,14,6,8,13,1,11
3,00:07:23,0,True,14,9,5,51,0,11
4,00:03:27,1,False,12,24,-12,19,10,11
1,00:02:16,0,True,1,1,0,43,0,11
1,00:01:00,2,False,1,1,0,38,20,11
2,00:11:30,2,True,8,1,7,40,5,11
2,00:07:27,1,False,1,15,-14,30,10,11
2,00:02:15,2,True,15,1,14,48,10,11
3,00:13:10,0,True,15,1,14,29,0,11
4,00:13:12,0,True,22,11,11,38,0,11
4,00:02:03,3,False,27,22,5,36,19,11
1,00:11:59,1,True,0,0,0,54,10,11
2,00:14:24,0,False,3,3,0,23,0,11
2,00:03:55,1,False,10,6,4,52,10,11
3,00:13:37,0,False,17,6,11,45,0,11
4,00:07:30,2,True,15,27,-12,20,4,11
4,00:03:45,0,True,22,27,-5,40,0,11
4,00:01:48,0,True,22,30,-8,35,0,11
1,00:08:04,1,False,7,0,7,20,10,11
1,00:06:40,0,True,0,7,-7,51,0,11
3,00:05:57,0,True,16,22,-6,41,0,11
3,00:00:54,1,False,22,16,6,24,10,11
3,00:00:11,2,False,22,16,6,42,10,11
4,00:09:40,3,False,23,19,4,45,1,11
4,00:08:50,2,True,19,23,-4,51,2,11
4,00:05:10,1,False,30,19,11,44,10,11
2,00:09:27,3,True,3,9,-6,48,0,11
2,00:08:31,0,False,9,3,6,47,0,11
2,00:04:43,2,False,9,10,-1,14,10,11
2,00:03:59,1,False,9,17,-8,30,10,11
2,00:02:03,0,False,9,17,-8,0,0,11
4,00:06:00,0,True,26,17,9,43,0,11
1,00:05:26,1,False,0,3,-3,38,10,11
2,00:14:46,0,False,0,3,-3,25,0,11
2,00:12:34,0,False,0,3,-3,40,0,11
2,00:08:52,0,True,3,7,-4,33,0,11
2,00:05:56,0,False,7,3,4,25,0,11
2,00:01:57,1,True,3,15,-12,23,10,11
3,00:13:44,0,True,3,16,-13,24,0,11
3,00:03:57,0,True,10,23,-13,27,0,11
4,00:08:46,3,False,25,10,15,25,19,11
1,00:06:06,0,False,14,0,14,39,0,11
2,00:14:44,2,True,0,21,-21,20,4,11
3,00:13:19,3,False,31,3,28,32,9,11
3,00:10:50,3,False,31,3,28,38,6,11
3,00:08:12,1,False,31,3,28,20,10,11
3,00:07:51,0,True,3,31,-28,28,0,11
1,00:14:11,3,True,0,0,0,32,10,11
1,00:08:00,0,True,7,0,7,40,0,11
1,00:02:41,0,False,0,13,-13,37,0,11
2,00:06:46,2,False,7,16,-9,33,10,11
2,00:01:40,0,False,7,23,-16,14,0,11
4,00:08:09,0,True,35,20,15,25,0,11
4,00:04:53,1,True,35,27,8,26,10,11
4,00:03:10,1,False,27,35,-8,1,1,11
1,00:14:53,1,True,0,0,0,37,10,11
1,00:01:30,0,True,0,14,-14,32,0,11
2,00:11:11,0,False,14,3,11,8,0,11
2,00:10:55,1,True,3,14,-11,1,1,11
3,00:07:01,1,False,31,3,28,55,10,11
3,00:03:10,0,True,3,32,-29,23,0,11
3,00:00:19,3,True,3,32,-29,49,5,11
4,00:06:35,3,True,10,40,-30,52,10,11
4,00:05:41,0,False,40,10,30,54,0,11
4,00:02:47,1,True,24,40,-16,28,10,11
1,00:05:00,0,False,3,0,3,18,0,11
1,00:04:17,0,True,0,10,-10,35,0,11
1,00:02:21,3,False,10,0,10,48,10,11
1,00:01:58,0,True,0,10,-10,12,0,11
2,00:15:00,3,False,10,0,10,47,8,11
2,00:10:04,0,True,0,10,-10,25,0,11
2,00:09:13,0,True,0,10,-10,12,0,11
2,00:02:05,1,True,7,17,-10,45,10,11
2,00:00:24,3,True,7,17,-10,44,5,11
3,00:13:43,0,False,17,7,10,21,0,11
3,00:07:50,0,True,7,17,-10,43,0,11
3,00:03:17,0,False,17,7,10,30,0,11
3,00:02:38,2,True,7,17,-10,13,10,11
4,00:04:22,1,False,34,11,23,49,10,11
1,00:13:42,2,True,0,0,0,55,5,11
2,00:08:21,2,True,18,3,15,24,6,11
3,00:10:44,2,False,4,25,-21,44,3,11
3,00:04:40,1,True,28,4,24,34,10,11
1,00:13:08,2,True,0,0,0,35,5,11
2,00:12:42,3,False,4,7,-3,25,13,11
3,00:14:13,0,False,7,8,-1,26,0,11
3,00:05:06,0,False,11,9,2,25,0,11
3,00:00:37,0,True,11,11,0,26,0,11
4,00:07:34,3,False,14,14,0,48,10,11
4,00:06:24,3,True,14,14,0,35,6,11
4,00:01:02,0,False,21,21,0,35,0,11
4,00:00:01,3,False,21,21,0,29,1,11
1,00:11:46,0,False,0,3,-3,35,0,11
1,00:04:13,2,False,0,3,-3,2,2,11
2,00:15:00,0,False,0,13,-13,32,0,11
2,00:14:45,1,True,13,0,13,19,10,11
3,00:01:05,3,True,26,18,8,28,1,11
4,00:14:14,0,False,18,26,-8,38,0,11
4,00:07:04,0,True,26,26,0,11,0,11
1,00:11:32,2,False,0,7,-7,40,3,11
2,00:09:27,3,True,14,7,7,50,9,11
2,00:07:51,0,False,9,14,-5,25,0,11
2,00:07:44,1,True,14,9,5,39,10,11
2,00:05:30,3,True,14,16,-2,34,4,11
2,00:03:30,0,True,14,16,-2,13,0,11
4,00:15:00,2,True,21,19,2,50,12,11
4,00:12:26,0,False,19,24,-5,35,0,11
4,00:08:56,3,True,24,19,5,17,5,11
4,00:01:37,3,True,26,22,4,53,3,11
1,00:13:08,2,True,0,0,0,29,8,11
2,00:15:00,2,False,3,0,3,25,8,11
2,00:03:08,3,True,14,3,11,41,21,11
2,00:01:22,2,True,14,3,11,24,9,11
3,00:06:26,2,True,14,4,10,4,18,11
4,00:13:33,1,True,14,9,5,47,10,11
4,00:13:05,0,True,14,9,5,40,0,11
4,00:03:31,1,False,9,14,-5,18,10,11
1,00:08:15,0,False,3,7,-4,30,0,11
1,00:04:49,2,False,3,7,-4,29,4,11
2,00:11:28,0,True,7,9,-2,11,0,11
2,00:02:18,2,False,9,14,-5,47,8,11
2,00:01:55,1,True,14,9,5,9,9,11
2,00:01:28,0,False,16,14,2,38,0,11
1,00:13:50,3,False,0,0,0,45,4,11
1,00:06:42,0,False,3,0,3,29,0,11
2,00:15:00,2,True,0,10,-10,48,1,11
2,00:14:26,0,False,10,0,10,50,0,11
2,00:09:52,0,True,0,10,-10,45,0,11
3,00:14:52,0,False,17,17,0,35,0,11
3,00:12:01,0,True,17,17,0,16,0,11
3,00:09:43,0,True,20,17,3,35,0,11
3,00:06:58,0,False,17,20,-3,10,0,11
3,00:01:17,0,True,23,24,-1,39,0,11
4,00:12:55,2,True,23,24,-1,35,7,11
4,00:12:16,0,True,23,24,-1,54,0,11
1,00:10:27,3,True,0,0,0,0,2,11
1,00:05:40,0,False,5,0,5,39,0,11
2,00:12:32,2,True,0,12,-12,36,5,11
2,00:02:38,3,False,15,7,8,42,1,11
2,00:00:30,1,True,7,18,-11,46,10,11
2,00:00:16,1,True,7,18,-11,22,10,11
3,00:06:14,2,True,21,28,-7,37,8,11
4,00:10:42,0,True,27,28,-1,36,0,11
4,00:01:48,2,True,36,38,-2,47,5,11
4,00:00:53,3,True,36,38,-2,45,13,11
1,00:01:36,0,False,4,7,-3,40,0,11
2,00:15:00,0,False,4,7,-3,21,0,11
3,00:13:32,3,True,14,21,-7,46,10,11
3,00:07:02,0,False,21,14,7,12,0,11
4,00:13:12,1,True,14,22,-8,35,10,11
1,00:12:24,3,False,0,0,0,46,5,11
1,00:04:41,1,True,2,1,1,48,10,11
1,00:04:23,0,True,2,1,1,49,0,11
1,00:03:51,1,False,1,2,-1,39,10,11
2,00:06:14,2,False,1,16,-15,48,9,11
2,00:04:46,3,True,16,1,15,47,5,11
2,00:03:25,3,True,16,1,15,21,14,11
2,00:01:46,1,True,16,1,15,51,10,11
4,00:12:21,0,True,24,11,13,18,0,11
4,00:12:08,1,False,11,24,-13,36,10,11
4,00:09:27,2,True,24,11,13,36,7,11
4,00:06:42,2,True,24,18,6,43,10,11
1,00:08:13,2,False,0,7,-7,47,7,11
2,00:14:07,3,False,0,17,-17,51,3,11
2,00:10:15,3,False,0,17,-17,41,3,11
2,00:06:11,3,True,24,0,24,46,7,11
2,00:04:24,0,False,0,24,-24,47,0,11
2,00:02:05,0,True,24,3,21,49,0,11
3,00:04:34,1,False,7,24,-17,40,10,11
4,00:00:24,0,True,37,14,23,41,0,11
1,00:00:01,0,False,3,3,0,44,0,11
2,00:12:55,1,True,3,6,-3,53,10,11
4,00:13:39,2,True,24,22,2,19,6,11
1,00:02:03,3,True,0,3,-3,33,12,11
2,00:06:30,1,False,10,3,7,25,20,11
2,00:06:17,0,True,3,10,-7,30,0,11
2,00:00:31,0,True,3,20,-17,43,0,11
3,00:12:15,3,False,20,10,10,38,10,11
3,00:02:10,0,True,10,20,-10,29,0,11
3,00:01:15,2,False,20,10,10,47,7,11
4,00:01:40,2,False,24,13,11,30,5,11
1,00:14:56,1,True,0,0,0,31,10,11
2,00:12:39,0,False,10,3,7,30,0,11
2,00:05:42,2,True,3,17,-14,51,11,11
2,00:02:22,2,False,20,3,17,45,7,11
3,00:01:41,3,False,23,10,13,54,5,11
4,00:03:08,1,False,23,17,6,36,10,11
4,00:01:57,2,False,23,20,3,34,11,11
1,00:13:06,2,True,0,0,0,36,6,11
1,00:05:55,3,False,7,0,7,20,26,11
1,00:00:02,1,False,7,10,-3,39,10,11
2,00:10:27,0,False,7,20,-13,53,0,11
3,00:10:13,0,False,7,31,-24,1,0,11
4,00:10:06,3,False,14,32,-18,45,4,11
4,00:08:58,0,True,32,14,18,43,0,11
1,00:05:04,0,True,7,0,7,32,0,11
1,00:04:39,1,False,0,7,-7,22,10,11
1,00:01:26,3,False,0,14,-14,37,12,11
1,00:01:06,0,False,0,14,-14,16,0,11
2,00:09:00,0,False,3,21,-18,35,0,11
3,00:12:20,0,True,31,3,28,40,0,11
3,00:07:19,0,True,34,3,31,40,0,11
3,00:05:56,3,False,3,34,-31,48,10,11
3,00:00:05,3,False,3,34,-31,48,4,11
4,00:06:51,3,True,36,5,31,49,9,11
1,00:03:52,0,True,10,0,10,45,0,11
1,00:03:04,1,True,10,0,10,40,10,11
2,00:15:00,2,False,7,10,-3,44,1,11
2,00:10:49,0,True,13,7,6,43,0,11
2,00:09:49,2,True,13,7,6,45,10,11
2,00:05:33,1,False,10,13,-3,20,20,11
2,00:01:18,3,True,21,10,11,40,10,11
2,00:00:44,1,True,21,10,11,46,10,11
2,00:00:22,1,True,21,17,4,37,10,11
3,00:08:53,2,False,17,21,-4,42,6,11
3,00:01:15,1,True,27,17,10,35,15,11
4,00:10:36,0,True,27,20,7,28,0,11
1,00:06:39,3,True,0,10,-10,39,17,11
2,00:11:19,3,False,12,1,11,32,9,11
2,00:00:39,1,False,15,8,7,20,10,11
3,00:07:44,0,True,22,15,7,41,0,11
1,00:04:05,1,True,0,14,-14,46,10,11
2,00:05:24,3,True,0,16,-16,34,6,11
2,00:02:22,1,True,0,16,-16,23,10,11
2,00:02:13,1,True,0,16,-16,55,10,11
2,00:02:03,2,False,16,0,16,40,0,11
4,00:01:25,0,False,24,27,-3,40,0,11
1,00:11:21,1,True,0,3,-3,33,10,11
1,00:10:15,2,False,3,0,3,50,6,11
1,00:04:52,0,True,0,3,-3,29,0,11
3,00:13:08,0,True,13,15,-2,42,0,11
3,00:07:45,0,True,19,15,4,5,0,11
4,00:05:53,1,True,22,18,4,50,10,11
4,00:04:09,0,False,25,22,3,28,0,11
1,00:10:46,0,True,7,0,7,33,0,11
1,00:08:11,0,False,0,7,-7,55,0,11
2,00:10:58,1,True,10,7,3,3,5,11
2,00:04:53,1,True,11,14,-3,47,10,11
3,00:04:08,3,True,17,15,2,31,8,11
4,00:11:26,0,False,15,19,-4,50,0,11
4,00:07:36,3,False,15,20,-5,52,8,11
4,00:04:04,1,False,15,20,-5,39,10,11
4,00:02:47,0,False,21,20,1,5,0,11
4,00:01:33,0,False,23,20,3,48,0,11
1,00:06:36,0,False,3,0,3,23,0,11
1,00:03:36,1,False,3,0,3,23,10,11
4,00:14:42,3,False,7,17,-10,35,10,11
4,00:08:03,0,True,20,7,13,22,0,11
4,00:01:33,1,False,7,23,-16,52,10,11
1,00:06:58,3,True,3,0,3,40,13,11
2,00:08:42,2,True,6,3,3,8,10,11
2,00:01:08,2,True,6,10,-4,9,5,11
3,00:10:02,1,False,20,6,14,40,10,11
4,00:09:18,0,False,30,7,23,55,0,11
1,00:12:14,3,True,0,0,0,49,10,11
1,00:11:49,1,True,0,0,0,2,10,11
1,00:00:31,3,False,10,3,7,35,10,11
2,00:07:51,1,True,3,10,-7,41,10,11
3,00:12:42,2,False,13,10,3,42,8,11
3,00:09:13,0,True,10,13,-3,29,0,11
4,00:05:12,0,True,23,23,0,4,0,11
1,00:09:41,0,True,0,0,0,55,0,11
1,00:07:14,3,True,0,1,-1,41,9,11
1,00:01:40,1,True,0,2,-2,29,25,11
1,00:00:28,2,True,0,2,-2,24,4,11
2,00:12:07,0,False,2,0,2,25,0,11
3,00:06:36,1,False,2,6,-4,54,10,11
2,00:00:36,0,False,17,13,4,49,0,11
2,00:00:09,1,False,17,13,4,5,5,11
3,00:11:01,1,True,16,17,-1,1,1,11
4,00:02:10,1,True,26,25,1,51,10,11
1,00:14:32,2,True,0,0,0,41,10,11
2,00:04:21,1,True,6,15,-9,35,10,11
4,00:00:32,0,False,35,13,22,53,0,11
1,00:03:04,0,False,3,7,-4,31,0,11
1,00:01:26,3,True,7,3,4,10,1,11
2,00:09:51,1,False,10,14,-4,21,10,11
2,00:01:43,3,True,24,10,14,34,1,11
3,00:15:00,0,True,24,17,7,22,0,11
3,00:10:34,0,True,24,24,0,35,0,11
3,00:01:46,1,True,24,24,0,21,10,11
4,00:03:37,0,False,27,24,3,48,0,11
4,00:01:14,1,True,24,30,-6,35,10,11
1,00:08:59,1,False,3,0,3,33,10,11
4,00:07:47,0,True,31,16,15,0,0,11
4,00:02:47,0,False,16,45,-29,42,0,11
4,00:00:59,1,False,23,45,-22,24,10,11
1,00:12:35,1,False,0,0,0,23,10,11
1,00:10:59,3,False,0,0,0,53,12,11
1,00:05:43,2,True,3,0,3,41,2,11
1,00:03:55,0,False,0,3,-3,8,0,11
2,00:14:09,0,False,7,3,4,29,0,11
2,00:08:45,1,False,14,3,11,33,10,11
2,00:05:32,3,False,14,10,4,34,1,11
3,00:09:55,3,True,13,14,-1,30,18,11
3,00:01:50,0,False,14,13,1,17,0,11
4,00:11:29,1,True,13,17,-4,52,10,11
4,00:08:36,0,True,16,17,-1,30,0,11
4,00:08:11,0,False,17,16,1,35,0,11
4,00:02:48,2,False,24,16,8,31,15,11
2,00:00:43,0,True,7,4,3,35,0,11
3,00:07:01,1,False,4,10,-6,53,15,11
3,00:04:22,3,True,11,4,7,44,14,11
4,00:04:18,0,True,11,4,7,55,0,11
4,00:02:20,3,True,11,11,0,36,12,11
1,00:06:21,0,False,0,0,0,25,0,11
1,00:06:01,1,True,0,0,0,1,1,11
1,00:01:43,0,True,0,7,-7,22,0,11
2,00:14:06,3,False,7,7,0,20,10,11
2,00:11:52,2,False,7,7,0,37,9,11
2,00:01:47,1,True,7,10,-3,38,10,11
2,00:01:22,0,True,7,17,-10,35,0,11
2,00:01:15,1,False,17,7,10,48,10,11
3,00:11:20,3,True,7,20,-13,35,10,11
3,00:09:48,1,False,20,7,13,33,10,11
3,00:08:28,0,True,13,20,-7,5,0,11
3,00:08:03,1,False,20,14,6,28,10,11
3,00:06:26,3,False,20,14,6,51,21,11
3,00:03:11,0,False,20,14,6,55,0,11
4,00:14:14,3,True,21,20,1,21,0,11
4,00:09:20,0,False,23,21,2,50,0,11
1,00:07:08,0,False,0,7,-7,43,0,11
1,00:00:02,0,False,7,10,-3,35,0,11
2,00:11:50,0,True,10,7,3,32,0,11
3,00:11:23,0,False,14,10,4,17,0,11
1,00:10:06,2,False,0,7,-7,43,10,11
2,00:13:11,0,False,0,14,-14,46,0,11
3,00:06:46,0,True,17,10,7,44,0,11
4,00:12:03,0,True,17,17,0,31,0,11
4,00:08:48,0,False,17,17,0,34,0,11
1,00:13:54,3,True,0,0,0,37,6,11
1,00:07:43,1,False,3,0,3,37,10,11
1,00:00:01,2,True,14,3,11,1,2,11
2,00:11:59,0,True,14,6,8,29,0,11
2,00:02:39,3,False,6,21,-15,45,11,11
3,00:12:04,2,True,21,13,8,29,6,11
3,00:08:49,1,False,13,28,-15,45,10,11
4,00:12:15,0,True,35,13,22,45,0,11
4,00:09:22,3,True,35,16,19,35,10,11
4,00:08:27,2,False,16,35,-19,45,10,11
1,00:14:29,2,False,0,0,0,35,10,11
1,00:13:14,1,True,0,0,0,28,10,11
2,00:15:00,1,True,4,7,-3,42,10,11
3,00:13:40,1,False,22,7,15,39,10,11
3,00:01:30,3,False,23,10,13,38,15,11
4,00:02:36,3,False,26,10,16,50,6,11
1,00:14:31,0,True,0,0,0,23,0,11
1,00:06:01,2,True,0,0,0,8,7,11
2,00:13:54,0,True,7,0,7,53,0,11
2,00:10:55,3,False,0,7,-7,43,12,11
2,00:04:24,3,True,14,1,13,43,2,11
3,00:05:06,3,True,14,16,-2,18,4,11
3,00:03:16,3,True,14,16,-2,31,2,11
4,00:15:00,2,False,16,14,2,34,1,11
4,00:02:21,3,False,16,14,2,32,18,11
1,00:14:12,0,False,0,0,0,23,0,11
1,00:08:01,1,False,0,14,-14,44,10,11
1,00:06:22,3,False,0,14,-14,47,1,11
1,00:04:13,2,True,14,0,14,53,10,11
2,00:02:43,1,False,10,21,-11,32,10,11
3,00:03:53,3,False,13,24,-11,52,11,11
3,00:01:06,2,False,13,31,-18,47,10,11
1,00:13:15,2,False,0,0,0,52,5,11
2,00:07:52,3,True,17,0,17,41,10,11
2,00:04:14,0,True,17,0,17,49,0,11
2,00:01:35,3,True,24,7,17,32,7,11
3,00:11:26,0,True,24,7,17,19,0,11
3,00:07:43,0,False,7,31,-24,0,0,11
3,00:03:08,1,False,14,38,-24,54,10,11
3,00:00:55,3,True,38,14,24,15,6,11
4,00:15:00,0,False,14,38,-24,23,0,11
4,00:06:51,2,False,14,45,-31,28,7,11
1,00:11:50,0,False,0,1,-1,24,0,11
1,00:10:55,0,False,0,1,-1,48,0,11
1,00:05:50,0,False,0,1,-1,10,0,11
2,00:00:24,3,True,11,0,11,10,13,11
2,00:00:07,3,False,0,11,-11,52,10,11
3,00:06:36,3,False,0,14,-14,40,7,11
3,00:02:13,3,False,0,15,-15,54,1,11
4,00:10:28,1,True,22,1,21,25,10,11
4,00:06:37,0,False,1,29,-28,38,0,11
4,00:00:42,3,False,1,29,-28,29,10,11
4,00:00:33,1,True,29,1,28,39,10,11
4,00:00:13,0,False,1,29,-28,11,0,11
1,00:03:32,1,True,7,7,0,49,10,11
1,00:02:34,0,True,7,7,0,5,0,11
2,00:15:00,1,True,14,7,7,46,10,11
2,00:10:11,1,False,10,14,-4,52,10,11
2,00:09:21,1,True,14,10,4,46,10,11
2,00:04:34,1,True,14,13,1,43,10,11
3,00:15:00,0,True,17,13,4,12,0,11
3,00:01:29,2,True,17,13,4,29,10,11
1,00:08:57,2,True,3,0,3,51,10,11
1,00:08:28,1,False,0,3,-3,33,10,11
1,00:03:49,2,True,12,0,12,44,15,11
1,00:02:25,1,False,0,12,-12,18,20,11
2,00:06:29,0,False,1,21,-20,39,0,11
2,00:06:00,0,True,21,1,20,53,0,11
2,00:00:50,2,False,1,24,-23,35,10,11
3,00:12:40,1,False,1,24,-23,43,10,11
4,00:11:45,0,True,31,3,28,27,0,11
4,00:07:52,3,True,31,3,28,4,4,11
1,00:11:17,1,True,0,6,-6,5,5,11
2,00:10:18,0,False,21,7,14,33,0,11
2,00:09:58,1,True,7,21,-14,43,10,11
2,00:06:58,0,True,7,21,-14,16,0,11
2,00:06:07,0,False,21,14,7,35,0,11
3,00:12:11,1,False,21,17,4,15,10,11
3,00:02:36,0,False,22,20,2,49,0,11
4,00:14:42,1,False,25,20,5,32,10,11
4,00:10:29,0,False,28,26,2,35,0,11
4,00:08:53,1,True,26,28,-2,22,10,11
4,00:03:47,1,False,28,26,2,36,10,11
4,00:02:33,0,False,28,33,-5,35,0,11
1,00:12:13,3,False,0,0,0,33,12,11
2,00:11:45,0,True,14,0,14,33,0,11
2,00:10:08,3,False,0,14,-14,47,17,11
2,00:07:55,3,True,14,0,14,51,18,11
3,00:13:43,3,False,0,20,-20,44,5,11
3,00:01:50,3,True,20,3,17,32,2,11
3,00:00:20,3,True,20,3,17,38,0,11
4,00:13:37,1,True,20,3,17,25,10,11
4,00:08:27,0,False,3,21,-18,48,0,11
4,00:02:02,2,False,3,24,-21,38,18,11
4,00:01:45,1,True,24,3,21,51,10,11
4,00:01:38,0,False,3,24,-21,23,0,11
1,00:09:09,3,False,0,0,0,6,1,11
1,00:06:39,3,False,0,7,-7,34,5,11
1,00:01:53,0,False,7,7,0,29,0,11
2,00:14:03,2,False,7,7,0,21,5,11
2,00:08:18,3,False,7,7,0,6,6,11
2,00:04:33,1,True,10,7,3,37,10,11
3,00:10:01,0,False,17,10,7,35,0,11
3,00:06:13,3,False,17,13,4,35,10,11
4,00:14:04,0,True,13,17,-4,52,0,11
4,00:08:31,0,True,21,24,-3,45,0,11
4,00:00:39,1,False,24,28,-4,42,10,11
1,00:08:33,2,False,0,7,-7,50,10,11
1,00:06:49,2,True,7,0,7,35,5,11
2,00:02:04,0,True,17,1,16,21,0,11
3,00:12:06,2,True,17,1,16,31,10,11
4,00:02:56,0,False,15,41,-26,47,0,11
1,00:13:18,2,True,0,0,0,30,10,11
1,00:11:23,0,False,3,0,3,33,0,11
1,00:08:11,2,False,3,7,-4,53,12,11
1,00:06:48,0,False,3,7,-4,17,0,11
1,00:04:34,3,True,7,10,-3,40,2,11
2,00:13:42,3,False,10,10,0,38,7,11
2,00:11:18,0,True,10,10,0,47,0,11
2,00:09:21,1,True,10,10,0,29,10,11
2,00:08:18,3,True,10,10,0,45,10,11
2,00:04:00,0,False,16,10,6,30,0,11
2,00:00:13,0,False,16,13,3,23,0,11
3,00:10:54,0,False,19,20,-1,35,0,11
3,00:00:53,3,False,22,23,-1,12,20,11
4,00:01:53,0,True,33,28,5,53,0,11
1,00:09:29,1,False,0,0,0,36,10,11
2,00:10:54,2,False,0,1,-1,34,10,11
2,00:03:43,0,True,1,7,-6,17,0,11
2,00:01:27,1,False,7,1,6,42,10,11
3,00:13:38,2,False,7,2,5,41,5,11
3,00:10:29,1,True,10,7,3,48,10,11
3,00:01:22,0,False,8,11,-3,35,0,11
4,00:10:57,0,True,18,8,10,22,0,11
4,00:04:49,3,True,25,11,14,35,10,11
1,00:07:59,2,False,3,3,0,45,7,11
1,00:06:43,0,True,3,3,0,38,0,11
1,00:02:23,3,True,6,3,3,41,6,11
2,00:12:59,2,False,10,6,4,53,2,11
2,00:12:04,2,False,10,6,4,48,8,11
2,00:04:12,0,True,6,17,-11,47,0,11
3,00:13:04,0,False,17,9,8,35,0,11
3,00:12:01,2,True,9,17,-8,20,2,11
3,00:06:34,1,False,24,12,12,46,10,11
3,00:05:46,0,False,24,12,12,46,0,11
3,00:01:08,0,False,31,15,16,32,0,11
4,00:13:45,2,False,31,15,16,51,7,11
4,00:13:00,0,False,31,15,16,50,0,11
4,00:11:33,0,False,31,15,16,20,0,11
1,00:06:59,3,False,1,0,1,40,7,11
2,00:12:02,0,True,0,11,-11,3,0,11
2,00:09:25,2,True,3,11,-8,43,5,11
3,00:13:59,0,True,13,14,-1,44,0,11
3,00:08:11,3,False,14,13,1,50,12,11
3,00:06:10,2,False,14,13,1,45,10,11
3,00:02:08,2,True,13,16,-3,54,6,11
4,00:07:18,0,False,19,13,6,33,0,11
2,00:08:45,0,False,7,0,7,5,0,11
3,00:08:26,1,True,3,13,-10,10,10,11
3,00:05:05,2,True,3,13,-10,27,9,11
3,00:01:16,1,True,3,13,-10,52,10,11
4,00:10:41,0,False,13,3,10,13,0,11
1,00:10:59,0,False,0,0,0,38,0,11
1,00:08:24,3,True,0,3,-3,39,4,11
1,00:05:41,0,True,0,3,-3,36,0,11
2,00:13:28,0,False,4,3,1,20,0,11
2,00:11:01,2,False,4,3,1,45,14,11
2,00:06:33,0,False,7,6,1,25,0,11
2,00:01:19,0,True,6,7,-1,49,0,11
3,00:03:41,2,False,7,9,-2,22,15,11
1,00:05:50,2,True,0,1,-1,16,15,11
1,00:05:10,3,True,0,1,-1,15,10,11
2,00:09:01,2,False,4,0,4,21,7,11
2,00:06:09,1,True,7,4,3,41,10,11
3,00:11:38,1,True,7,4,3,15,10,11
3,00:08:31,1,False,4,7,-3,24,10,11
3,00:02:48,1,True,7,7,0,35,10,11
4,00:12:28,2,False,7,7,0,31,11,11
4,00:06:44,0,True,10,7,3,35,0,11
4,00:01:22,0,True,10,7,3,54,0,11
1,00:06:02,0,False,0,10,-10,50,0,11
1,00:02:59,3,True,10,3,7,29,16,11
2,00:12:19,3,False,3,10,-7,23,23,11
2,00:10:06,3,True,10,3,7,41,23,11
3,00:10:50,0,False,3,20,-17,30,0,11
2,00:15:00,0,True,3,10,-7,36,0,11
2,00:13:00,0,True,10,10,0,0,0,11
2,00:08:43,3,False,10,10,0,54,0,11
4,00:14:10,0,True,20,23,-3,28,0,11
4,00:13:39,0,True,20,23,-3,38,0,11
4,00:12:13,3,True,20,23,-3,53,1,11
4,00:08:29,2,True,20,26,-6,40,5,11
4,00:06:51,3,False,26,20,6,46,2,11
1,00:06:28,2,False,3,0,3,42,7,11
1,00:01:31,3,True,0,6,-6,22,16,11
2,00:13:01,1,False,6,0,6,46,10,11
2,00:12:00,0,True,0,6,-6,39,0,11
2,00:07:09,3,False,9,0,9,25,18,11
2,00:03:14,1,False,9,3,6,26,10,11
3,00:06:46,1,True,6,12,-6,37,10,11
4,00:02:42,2,False,23,6,17,35,9,11
1,00:13:14,0,True,7,0,7,34,0,11
1,00:11:03,2,True,7,0,7,50,10,11
1,00:04:12,3,False,7,14,-7,44,5,11
2,00:14:01,2,True,14,7,7,17,10,11
2,00:12:47,0,False,14,14,0,28,0,11
2,00:10:21,1,False,14,14,0,37,10,11
2,00:02:34,2,False,17,14,3,16,2,11
2,00:01:50,1,False,17,17,0,47,10,11
3,00:11:20,2,False,17,20,-3,46,9,11
4,00:13:05,0,False,20,23,-3,32,0,11
4,00:07:39,3,False,23,23,0,46,2,11
4,00:06:52,1,True,23,23,0,26,10,11
1,00:06:45,1,True,14,0,14,26,10,11
2,00:13:03,3,True,14,6,8,41,1,11
2,00:05:55,1,False,6,14,-8,34,10,11
2,00:00:56,2,False,6,28,-22,55,10,11
3,00:03:45,3,True,31,6,25,37,3,11
4,00:01:27,2,True,37,9,28,26,8,11
4,00:01:21,3,True,37,9,28,26,8,11
2,00:09:18,3,True,6,6,0,39,19,11
2,00:03:53,2,True,6,6,0,48,6,11
2,00:02:17,2,True,6,6,0,20,9,11
3,00:00:53,2,False,20,13,7,44,10,11
4,00:08:03,2,False,20,29,-9,45,0,11
1,00:14:14,1,True,0,0,0,47,10,11
1,00:06:50,1,False,0,4,-4,32,10,11
1,00:02:50,3,True,4,0,4,18,18,11
1,00:02:40,1,False,0,4,-4,38,10,11
2,00:11:59,0,True,5,3,2,35,0,11
2,00:00:57,2,True,5,3,2,43,10,11
3,00:07:14,3,True,5,17,-12,54,8,11
4,00:14:25,3,False,17,5,12,51,6,11
1,00:05:55,1,True,0,7,-7,49,10,11
2,00:11:04,0,True,7,7,0,35,0,11
2,00:01:35,3,False,10,21,-11,48,5,11
3,00:12:11,0,False,10,21,-11,17,0,11
3,00:05:40,1,True,21,10,11,12,10,11
3,00:04:30,2,True,21,10,11,16,1,11
1,00:09:39,2,True,0,7,-7,15,15,11
1,00:01:16,0,False,24,0,24,28,0,11
2,00:10:22,0,False,24,0,24,24,0,11
2,00:08:35,3,False,24,0,24,42,12,11
2,00:01:15,3,False,32,7,25,48,10,11
2,00:00:36,3,True,7,32,-25,27,2,11
3,00:08:50,0,False,32,7,25,51,0,11
4,00:14:47,3,False,35,7,28,40,10,11
4,00:01:26,3,False,38,14,24,24,11,11
1,00:12:41,0,False,0,0,0,47,0,11
2,00:08:21,0,True,3,3,0,40,0,11
2,00:06:15,0,True,3,3,0,10,0,11
4,00:12:56,3,False,13,10,3,47,12,11
4,00:07:04,0,False,16,11,5,26,0,11
4,00:05:00,0,False,16,17,-1,35,0,11
4,00:02:16,0,True,17,22,-5,35,0,11
1,00:04:47,3,True,1,10,-9,37,5,11
2,00:15:00,3,False,10,5,5,37,2,11
2,00:13:48,2,True,5,10,-5,32,15,11
2,00:11:00,0,True,8,10,-2,42,0,11
2,00:03:24,2,True,8,20,-12,47,1,11
3,00:06:37,1,False,30,8,22,25,15,11
3,00:05:15,0,True,11,30,-19,22,0,11
4,00:00:55,0,True,17,33,-16,50,0,11
1,00:00:52,3,False,3,10,-7,15,20,11
2,00:10:26,2,False,6,17,-11,28,12,11
2,00:06:17,0,False,13,17,-4,24,0,11
3,00:06:52,2,True,20,19,1,18,5,11
3,00:05:48,0,True,20,19,1,14,0,11
3,00:04:40,1,False,19,27,-8,34,10,11
3,00:02:18,0,False,19,27,-8,18,0,11
4,00:01:52,0,False,29,33,-4,38,0,11
1,00:12:33,3,True,0,0,0,40,3,11
1,00:04:17,3,True,7,0,7,27,25,11
2,00:01:46,0,False,0,21,-21,26,0,11
2,00:00:48,0,False,7,28,-21,35,0,11
3,00:05:28,1,True,31,7,24,37,15,11
3,00:04:21,0,False,14,31,-17,15,0,11
4,00:09:06,2,False,17,35,-18,39,11,11
1,00:11:03,2,False,0,0,0,46,11,11
1,00:06:26,1,False,7,0,7,44,10,11
1,00:02:46,3,True,0,7,-7,28,2,11
2,00:09:33,2,False,7,7,0,45,7,11
2,00:05:52,2,True,7,7,0,17,24,11
2,00:00:43,1,False,14,14,0,44,10,11
3,00:10:26,1,True,21,14,7,20,10,11
3,00:07:49,1,True,21,21,0,11,10,11
4,00:10:20,0,True,28,21,7,28,0,11
4,00:00:23,3,False,21,38,-17,42,0,11
1,00:13:34,2,True,0,0,0,53,10,11
1,00:12:16,2,False,0,0,0,38,10,11
1,00:09:43,3,True,1,0,1,51,10,11
1,00:00:02,0,False,0,4,-4,48,0,11
2,00:14:18,1,True,4,1,3,35,10,11
3,00:14:17,0,True,8,4,4,42,0,11
3,00:13:10,2,False,4,8,-4,52,15,11
3,00:06:19,1,False,4,8,-4,45,10,11
4,00:06:03,0,False,7,8,-1,19,0,11
1,00:11:38,0,True,0,0,0,18,0,11
1,00:09:52,1,False,0,0,0,51,10,11
1,00:09:26,2,True,0,0,0,43,1,11
3,00:02:10,2,True,10,20,-10,48,11,11
4,00:09:27,0,False,23,17,6,40,0,11
1,00:08:30,3,True,0,0,0,21,7,11
1,00:07:18,1,False,0,0,0,52,10,11
1,00:04:06,1,True,0,0,0,10,10,11
2,00:02:37,3,False,4,4,0,35,13,11
3,00:10:22,0,True,5,4,1,51,0,11
4,00:14:04,1,False,4,12,-8,30,10,11
4,00:08:33,3,False,4,12,-8,53,8,11
1,00:09:49,3,True,0,0,0,41,10,11
2,00:14:07,0,True,0,10,-10,39,0,11
2,00:08:49,1,True,3,10,-7,53,10,11
3,00:00:07,0,True,10,13,-3,33,0,11
4,00:01:56,0,False,32,17,15,5,0,11
4,00:01:38,0,False,33,17,16,24,0,11
2,00:11:01,1,True,1,0,1,5,10,11
2,00:00:34,0,False,3,1,2,31,0,11
3,00:12:30,3,False,6,8,-2,39,6,11
3,00:01:55,2,True,8,6,2,1,1,11
4,00:02:52,0,True,14,16,-2,48,0,11
4,00:01:55,2,False,16,21,-5,25,10,11
1,00:12:39,0,False,0,0,0,38,0,11
1,00:07:27,0,False,0,0,0,42,0,11
1,00:02:19,1,True,0,7,-7,49,10,11
2,00:09:48,0,False,7,14,-7,44,0,11
2,00:07:06,0,True,17,7,10,35,0,11
2,00:03:31,3,True,24,7,17,30,4,11
2,00:01:03,0,True,30,7,23,5,0,11
2,00:00:25,2,True,31,7,24,46,10,11
4,00:06:10,3,False,24,34,-10,45,4,11
2,00:12:24,3,True,7,8,-1,35,10,11
2,00:11:08,0,True,7,8,-1,21,0,11
2,00:03:50,0,True,7,8,-1,13,0,11
2,00:02:19,2,True,7,8,-1,49,0,11
3,00:11:54,0,True,7,8,-1,5,0,11
4,00:06:56,3,True,7,11,-4,24,1,11
4,00:02:36,1,True,7,25,-18,35,10,11
4,00:01:16,0,False,32,7,25,51,0,11
4,00:01:11,0,True,7,32,-25,44,0,11
1,00:05:40,1,True,10,0,10,30,10,11
1,00:02:36,1,False,0,10,-10,22,10,11
2,00:14:46,0,False,3,10,-7,15,0,11
2,00:12:42,0,True,10,3,7,49,0,11
2,00:03:31,2,True,13,3,10,20,7,11
2,00:01:10,0,True,13,6,7,29,0,11
3,00:05:25,3,True,16,12,4,34,10,11
3,00:00:37,1,True,16,12,4,42,10,11
4,00:01:42,0,True,16,20,-4,30,0,11
1,00:12:55,2,True,0,0,0,45,10,11
1,00:06:48,0,False,3,0,3,49,0,11
1,00:06:26,0,True,0,3,-3,54,0,11
1,00:02:45,3,False,3,0,3,1,1,11
1,00:00:24,3,False,3,7,-4,38,2,11
2,00:02:30,2,True,8,3,5,51,5,11
4,00:13:44,3,False,3,13,-10,54,10,11
4,00:05:53,1,True,13,10,3,30,10,11
1,00:13:01,2,True,0,0,0,51,5,11
1,00:04:50,3,True,0,7,-7,36,10,11
2,00:15:00,2,False,7,0,7,44,11,11
2,00:02:06,2,False,7,11,-4,32,1,11
3,00:06:35,2,True,21,7,14,39,4,11
3,00:05:53,1,True,21,7,14,23,10,11
4,00:09:58,2,True,21,24,-3,51,10,11
4,00:04:42,0,True,28,27,1,50,0,11
1,00:06:41,3,False,1,10,-9,37,15,11
2,00:11:36,3,True,10,3,7,53,1,11
2,00:01:13,3,False,3,13,-10,23,0,11
2,00:01:06,1,False,3,13,-10,27,10,11
2,00:00:50,0,False,3,13,-10,30,0,11
1,00:00:22,1,False,7,8,-1,9,10,11
2,00:07:44,3,False,7,15,-8,23,10,11
2,00:05:11,2,True,15,7,8,53,16,11
3,00:13:38,0,False,10,15,-5,48,0,11
4,00:12:10,0,True,18,10,8,18,0,11
4,00:00:51,2,True,28,13,15,34,7,11
1,00:15:00,0,True,0,0,0,35,0,11
1,00:12:43,1,False,0,3,-3,42,10,11
2,00:11:08,3,False,3,0,3,30,14,11
2,00:08:02,0,False,3,7,-4,35,0,11
2,00:06:30,1,True,7,3,4,49,10,11
4,00:05:45,0,True,13,34,-21,36,0,11
1,00:15:00,0,False,0,0,0,35,0,11
1,00:03:30,1,True,7,10,-3,26,10,11
1,00:01:19,2,True,7,10,-3,22,17,11
2,00:11:26,3,True,7,17,-10,55,13,11
2,00:10:22,2,False,17,7,10,8,9,11
3,00:05:40,0,True,10,24,-14,4,0,11
4,00:10:23,3,False,24,31,-7,37,17,11
4,00:04:04,0,True,31,24,7,15,0,11
4,00:00:26,2,True,38,24,14,29,20,11
4,00:00:12,0,True,38,31,7,35,0,11
2,00:02:18,1,True,8,13,-5,46,10,11
2,00:00:33,0,False,27,8,19,24,0,11
3,00:08:11,2,False,27,15,12,49,7,11
4,00:03:54,0,False,30,17,13,42,0,11
1,00:01:36,0,False,0,2,-2,54,0,11
2,00:15:00,0,False,0,5,-5,35,0,11
2,00:09:41,3,False,3,5,-2,51,0,11
2,00:09:21,1,False,3,5,-2,45,10,11
2,00:03:15,0,True,6,3,3,34,0,11
2,00:01:25,3,True,6,3,3,46,10,11
3,00:08:09,2,False,6,9,-3,46,9,11
4,00:13:53,1,False,16,12,4,23,10,11
4,00:11:30,3,False,16,19,-3,36,10,11
1,00:09:31,3,True,3,7,-4,30,5,11
2,00:11:35,1,True,3,15,-12,50,10,11
2,00:03:17,3,True,3,29,-26,30,9,11
2,00:00:54,2,False,29,3,26,25,10,11
3,00:08:46,0,True,16,32,-16,5,0,11
3,00:08:23,0,True,16,32,-16,2,0,11
3,00:05:50,0,True,18,32,-14,19,0,11
4,00:05:03,0,True,31,33,-2,5,0,11
4,00:04:47,0,True,31,33,-2,2,0,11
2,00:15:00,2,False,3,3,0,29,10,11
2,00:04:31,0,True,6,3,3,8,0,11
2,00:01:27,2,False,3,8,-5,21,15,11
3,00:15:00,0,True,15,3,12,35,0,11
3,00:13:36,0,True,15,3,12,7,0,11
3,00:10:21,3,True,15,3,12,37,11,11
2,00:06:45,0,False,0,13,-13,48,0,11
2,00:04:57,2,True,13,0,13,25,10,11
2,00:04:29,0,False,0,13,-13,6,0,11
3,00:02:51,1,False,3,20,-17,27,10,11
4,00:14:28,3,False,3,20,-17,44,10,11
4,00:01:58,3,False,3,27,-24,37,4,11
1,00:14:53,0,False,0,0,0,29,0,11
1,00:13:20,0,True,0,0,0,33,0,11
1,00:04:33,1,False,4,0,4,25,10,11
1,00:01:16,3,True,0,4,-4,36,6,11
1,00:00:35,0,True,0,4,-4,35,0,11
2,00:09:05,0,True,1,18,-17,35,0,11
3,00:10:38,3,False,21,9,12,39,0,11
3,00:10:16,0,True,9,21,-12,55,0,11
4,00:13:27,0,False,28,9,19,5,0,11
4,00:13:06,1,True,9,28,-19,15,10,11
4,00:02:23,1,False,33,16,17,1,1,11
1,00:01:27,1,True,0,0,0,54,10,11
2,00:04:30,0,False,1,3,-2,42,0,11
2,00:03:55,0,False,1,3,-2,7,0,11
3,00:15:00,0,True,3,15,-12,35,0,11
3,00:14:31,1,False,15,3,12,30,10,11
4,00:06:47,3,True,17,15,2,18,17,11
4,00:01:27,0,True,25,16,9,38,0,11
2,00:06:00,1,False,1,8,-7,45,10,11
3,00:13:29,0,False,8,15,-7,46,0,11
4,00:09:31,0,True,25,15,10,35,0,11
4,00:09:14,2,False,15,25,-10,34,0,11
1,00:02:48,1,False,7,3,4,31,10,11
2,00:12:45,0,True,3,8,-5,15,0,11
3,00:09:50,2,True,17,22,-5,35,4,11
3,00:01:43,0,True,17,29,-12,36,0,11
4,00:06:41,3,True,24,29,-5,23,10,11
4,00:01:16,0,True,24,32,-8,32,0,11
5,00:00:00,2,False,32,35,-3,48,23,11
1,00:06:21,0,True,0,0,0,36,0,11
1,00:03:32,0,True,0,0,0,2,0,11
1,00:01:42,0,True,0,0,0,1,0,11
2,00:12:18,2,False,0,0,0,28,8,11
2,00:07:29,0,True,0,7,-7,23,0,11
4,00:03:26,0,False,15,7,8,40,0,11
1,00:01:15,1,True,10,0,10,46,10,11
2,00:14:30,3,True,10,0,10,51,16,11
2,00:02:52,1,False,0,14,-14,35,10,11
3,00:11:24,2,False,0,14,-14,45,10,11
3,00:10:14,0,True,17,0,17,35,0,11
3,00:07:00,3,True,17,0,17,34,9,11
4,00:12:24,0,False,0,17,-17,12,0,11
4,00:09:35,0,True,17,0,17,28,0,11
1,00:13:14,0,False,0,0,0,47,0,11
1,00:02:00,3,False,3,0,3,47,6,11
2,00:06:50,2,False,10,2,8,37,1,11
2,00:06:31,0,True,2,10,-8,33,0,11
2,00:04:22,0,True,5,10,-5,30,0,11
4,00:08:38,3,False,16,5,11,17,3,11
4,00:04:33,0,True,11,16,-5,53,0,11
4,00:02:00,0,False,16,11,5,30,0,11
4,00:01:45,2,True,11,16,-5,51,2,11
1,00:03:15,3,True,0,7,-7,53,11,11
2,00:14:05,3,False,7,0,7,45,7,11
2,00:13:50,1,True,0,7,-7,11,10,11
2,00:07:28,1,True,0,7,-7,23,15,11
2,00:02:04,0,False,7,3,4,47,0,11
1,00:10:55,2,False,0,7,-7,45,15,11
1,00:08:03,3,True,7,7,0,30,7,11
2,00:13:56,3,True,7,10,-3,50,6,11
2,00:03:00,0,True,14,17,-3,51,0,11
2,00:00:59,2,True,21,17,4,48,10,11
3,00:10:41,1,False,17,31,-14,35,10,11
3,00:09:07,0,False,17,31,-14,8,0,11
3,00:02:57,1,False,20,31,-11,2,2,11
4,00:04:42,0,False,20,42,-22,34,0,11
1,00:10:39,0,True,0,0,0,47,0,11
2,00:12:31,3,True,0,2,-2,18,7,11
2,00:01:17,0,False,9,0,9,50,0,11
2,00:00:01,3,True,0,9,-9,21,5,11
3,00:08:51,1,True,0,10,-10,27,10,11
3,00:00:02,0,True,8,24,-16,13,0,11
4,00:14:03,3,False,24,16,8,47,7,11
4,00:10:10,0,True,16,24,-8,21,0,11
4,00:02:25,1,True,24,24,0,23,10,11
4,00:00:37,0,False,24,24,0,1,0,11
1,00:10:40,2,False,0,0,0,31,0,11
1,00:08:23,0,True,7,0,7,46,0,11
1,00:01:46,0,True,17,7,10,15,0,11
2,00:14:14,1,True,17,7,10,31,10,11
2,00:10:21,0,True,20,7,13,35,0,11
3,00:09:46,1,True,20,21,-1,47,20,11
3,00:03:59,1,True,23,21,2,45,10,11
3,00:01:47,0,True,23,21,2,0,0,11
3,00:01:16,0,True,23,21,2,28,0,11
4,00:13:25,3,False,21,26,-5,26,19,11
4,00:12:57,1,False,21,26,-5,48,10,11
4,00:06:32,0,True,29,24,5,47,0,11
4,00:03:39,3,False,24,30,-6,42,3,11
4,00:02:48,0,False,24,30,-6,49,0,11
4,00:01:21,1,False,24,33,-9,35,10,11
4,00:00:41,0,False,24,33,-9,41,0,11
4,00:00:25,0,False,30,33,-3,5,0,11
1,00:13:17,0,True,0,0,0,40,0,11
1,00:04:14,2,False,0,0,0,42,9,11
1,00:02:54,0,True,0,0,0,38,0,11
2,00:09:15,3,False,10,3,7,54,1,11
2,00:06:14,2,False,10,3,7,13,11,11
2,00:05:14,0,True,6,10,-4,35,0,11
3,00:06:31,2,True,12,10,2,11,6,11
4,00:13:42,3,False,17,12,5,28,8,11
4,00:13:10,0,False,17,12,5,29,0,11
4,00:02:49,0,True,16,17,-1,10,0,11
2,00:06:43,2,False,13,0,13,50,11,11
2,00:06:15,2,False,13,0,13,45,6,11
2,00:05:52,0,True,0,13,-13,29,0,11
2,00:05:25,1,False,13,0,13,19,10,11
2,00:02:42,0,False,13,7,6,33,0,11
3,00:14:14,0,False,20,10,10,52,0,11
3,00:05:20,1,False,23,13,10,35,10,11
3,00:02:07,3,True,13,30,-17,30,8,11
3,00:00:17,0,True,13,30,-17,28,0,11
4,00:14:06,0,True,19,30,-11,5,0,11
4,00:13:48,0,True,20,30,-10,20,0,11
4,00:13:26,0,True,20,30,-10,19,0,11
4,00:06:54,1,False,30,20,10,54,10,11
4,00:01:14,0,True,33,33,0,5,0,11
4,00:00:38,1,False,33,34,-1,19,10,11
1,00:00:20,0,False,0,3,-3,0,0,11
2,00:10:24,0,False,0,3,-3,25,0,11
2,00:07:27,0,True,3,0,3,15,0,11
2,00:00:39,3,False,3,17,-14,50,10,11
4,00:14:09,0,True,27,3,24,23,0,11
4,00:03:35,0,True,34,3,31,11,0,11
1,00:11:34,3,True,0,0,0,52,6,11
2,00:10:32,0,True,0,7,-7,22,0,11
3,00:13:10,2,False,7,14,-7,21,2,11
3,00:02:02,2,False,7,31,-24,42,1,11
4,00:02:12,1,False,9,37,-28,48,10,11
1,00:14:56,1,False,0,0,0,39,10,11
1,00:10:05,2,False,0,0,0,44,3,11
1,00:00:01,0,False,0,10,-10,49,0,11
2,00:10:22,1,False,0,11,-11,51,10,11
2,00:08:23,2,False,0,14,-14,45,1,11
2,00:03:51,2,False,0,21,-21,50,8,11
2,00:03:00,2,False,0,21,-21,19,8,11
2,00:02:45,0,True,21,0,21,19,0,11
2,00:00:12,0,True,30,0,30,41,0,11
3,00:13:56,2,True,37,0,37,46,10,11
3,00:06:50,3,True,40,3,37,35,10,11
3,00:00:22,1,True,40,6,34,46,10,11
4,00:13:38,1,False,6,41,-35,30,10,11
4,00:07:40,2,True,41,9,32,50,11,11
4,00:01:48,0,True,41,9,32,38,0,11
1,00:10:06,2,False,0,0,0,19,8,11
2,00:15:00,2,True,4,0,4,46,10,11
2,00:02:39,3,True,4,1,3,18,10,11
3,00:14:22,0,True,7,1,6,36,0,11
3,00:02:37,0,True,7,3,4,40,0,11
4,00:03:05,3,False,6,16,-10,33,2,11
1,00:09:19,0,True,0,0,0,41,0,11
1,00:07:14,2,False,0,3,-3,35,13,11
1,00:02:39,1,True,3,3,0,49,10,11
2,00:06:13,3,False,10,6,4,54,4,11
2,00:02:35,3,False,10,6,4,36,13,11
2,00:02:13,3,True,6,10,-4,30,17,11
2,00:00:23,3,True,6,10,-4,40,14,11
3,00:13:39,0,False,10,6,4,48,0,11
4,00:09:52,0,True,6,20,-14,31,0,11
4,00:05:07,0,True,9,20,-11,52,0,11
4,00:00:24,0,False,20,12,8,16,0,11
3,00:11:00,2,True,7,16,-9,45,2,11
3,00:10:36,0,False,16,7,9,25,0,11
3,00:08:22,0,False,23,7,16,43,0,11
4,00:15:00,0,False,23,16,7,35,0,11
4,00:07:58,1,False,26,16,10,38,10,11
4,00:06:01,1,True,23,26,-3,18,10,11
1,00:05:03,3,False,0,3,-3,31,24,11
1,00:02:13,0,False,0,3,-3,38,0,11
2,00:08:35,0,False,3,3,0,33,0,11
2,00:05:02,0,False,4,3,1,51,0,11
2,00:00:52,1,False,4,10,-6,36,10,11
3,00:14:00,2,True,13,11,2,47,7,11
4,00:02:14,0,True,13,24,-11,46,0,11
1,00:06:30,0,False,0,7,-7,9,0,11
1,00:03:19,2,True,7,7,0,42,18,11
1,00:02:51,2,True,7,7,0,50,13,11
1,00:01:47,0,True,7,7,0,44,0,11
2,00:15:00,0,True,7,7,0,24,0,11
2,00:08:56,3,False,7,7,0,10,5,11
2,00:05:25,2,True,7,7,0,35,1,11
2,00:02:10,1,True,7,10,-3,48,10,11
3,00:13:10,0,False,13,7,6,43,0,11
3,00:12:29,0,False,13,7,6,8,0,11
3,00:05:47,0,True,7,23,-16,48,0,11
3,00:05:22,1,False,23,7,16,48,10,11
1,00:09:45,3,False,0,1,-1,35,10,11
2,00:13:37,0,True,8,3,5,33,0,11
2,00:04:56,0,True,8,10,-2,51,0,11
2,00:00:21,0,True,8,20,-12,36,0,11
4,00:13:51,3,False,27,15,12,37,1,11
4,00:13:36,0,True,15,27,-12,34,0,11
1,00:07:01,0,False,0,5,-5,49,0,11
1,00:02:54,1,False,0,8,-8,54,10,11
1,00:02:10,0,True,8,0,8,33,0,11
2,00:07:46,0,True,15,0,15,43,0,11
2,00:06:42,1,True,15,7,8,38,10,11
2,00:03:10,0,False,7,15,-8,19,0,11
4,00:06:06,3,False,21,18,3,6,1,11
1,00:15:00,0,True,0,0,0,35,0,11
1,00:07:22,0,False,0,4,-4,27,0,11
2,00:14:41,1,True,4,7,-3,39,10,11
2,00:09:14,1,False,7,4,3,44,10,11
2,00:05:58,0,False,7,7,0,52,0,11
3,00:12:00,2,True,14,13,1,49,5,11
4,00:10:06,0,False,13,17,-4,40,0,11
1,00:02:25,2,False,0,1,-1,40,10,11
2,00:05:51,1,False,14,15,-1,27,10,11
3,00:11:52,0,False,14,15,-1,18,0,11
3,00:02:10,1,True,22,24,-2,53,10,11
3,00:01:50,1,True,22,24,-2,38,10,11
4,00:13:15,1,True,22,24,-2,33,10,11
4,00:04:03,0,False,34,25,9,20,0,11
1,00:09:25,3,False,0,7,-7,34,7,11
1,00:07:32,3,True,7,0,7,29,2,11
1,00:04:12,1,False,0,7,-7,43,10,11
2,00:08:17,1,False,3,10,-7,23,10,11
3,00:03:45,0,True,11,9,2,35,0,11
3,00:00:35,3,True,11,9,2,35,8,11
4,00:01:44,0,True,11,18,-7,31,0,11
1,00:13:06,2,True,0,0,0,38,10,11
1,00:09:25,2,True,3,0,3,32,8,11
1,00:00:32,3,True,10,3,7,31,10,11
2,00:02:23,0,True,20,3,17,54,0,11
2,00:01:07,3,False,3,20,-17,15,7,11
4,00:13:40,2,True,30,3,27,27,3,11
4,00:02:53,3,False,3,37,-34,48,9,11
3,00:09:07,0,False,11,7,4,10,0,11
4,00:02:49,0,True,17,14,3,32,0,11
2,00:08:20,2,True,17,0,17,38,11,11
2,00:00:11,1,False,0,20,-20,40,10,11
3,00:06:50,2,False,1,20,-19,3,13,11
3,00:01:38,3,True,20,2,18,40,5,11
4,00:00:47,1,False,5,23,-18,17,10,11
1,00:12:30,2,True,0,0,0,15,7,11
1,00:06:00,3,False,3,3,0,44,0,11
2,00:13:13,2,True,3,10,-7,40,1,11
2,00:03:26,0,False,10,6,4,13,0,11
2,00:02:42,2,True,6,10,-4,1,1,11
1,00:02:12,2,False,0,4,-4,47,10,11
2,00:15:00,2,False,0,4,-4,21,5,11
2,00:07:30,0,False,0,11,-11,29,0,11
3,00:12:58,0,True,11,6,5,52,0,11
1,00:05:00,2,False,1,0,1,33,10,11
2,00:15:00,2,False,1,0,1,28,6,11
2,00:14:36,2,False,1,0,1,28,6,11
2,00:12:38,0,False,1,7,-6,35,0,11
2,00:04:08,2,True,7,4,3,35,28,11
3,00:14:06,0,False,4,16,-12,28,0,11
3,00:07:42,2,True,23,4,19,29,6,11
3,00:06:26,2,True,23,4,19,20,8,11
3,00:04:03,3,True,23,7,16,37,8,11
4,00:06:38,3,True,24,7,17,17,10,11
4,00:04:36,3,False,10,24,-14,50,10,11
1,00:09:39,2,True,0,0,0,32,12,11
1,00:07:57,1,True,0,0,0,32,10,11
2,00:06:15,0,True,1,0,1,20,0,11
2,00:05:21,0,True,8,0,8,37,0,11
2,00:01:24,2,False,3,8,-5,32,10,11
3,00:13:06,2,True,15,3,12,47,8,11
3,00:01:12,2,False,3,36,-33,29,10,11
4,00:12:19,1,True,43,3,40,7,10,11
4,00:11:51,0,False,3,43,-40,7,0,11
2,00:14:45,0,False,1,7,-6,19,0,11
2,00:14:20,1,True,7,1,6,43,10,11
2,00:03:34,0,True,22,1,21,43,0,11
3,00:12:45,0,False,4,29,-25,48,0,11
3,00:07:57,0,False,4,36,-32,25,0,11
4,00:11:29,1,False,18,36,-18,13,10,11
4,00:02:12,0,True,43,18,25,40,0,11
1,00:08:22,3,False,0,0,0,29,30,11
2,00:14:43,0,True,7,0,7,11,0,11
2,00:14:26,1,False,0,7,-7,1,1,11
4,00:07:21,1,True,20,10,10,12,10,11
1,00:06:31,3,True,3,0,3,29,19,11
1,00:02:31,0,False,0,6,-6,55,0,11
2,00:05:12,2,False,0,17,-17,38,18,11
2,00:03:03,2,False,0,17,-17,23,12,11
3,00:07:47,2,False,7,17,-10,36,9,11
4,00:13:17,3,False,10,18,-8,52,3,11
1,00:06:36,0,False,7,0,7,31,0,11
2,00:11:55,2,False,7,3,4,18,8,11
2,00:07:31,0,False,7,10,-3,52,0,11
2,00:05:48,2,True,10,7,3,29,8,11
3,00:12:21,3,False,14,20,-6,40,20,11
3,00:09:00,1,False,14,20,-6,44,10,11
4,00:02:28,1,False,24,37,-13,47,10,11
2,00:11:18,0,True,7,0,7,53,0,11
2,00:08:58,0,True,10,0,10,6,0,11
2,00:06:40,0,True,10,0,10,41,0,11
2,00:03:30,1,False,0,13,-13,47,10,11
2,00:02:25,0,False,0,20,-20,35,0,11
2,00:02:03,3,True,20,0,20,29,5,11
2,00:01:35,3,False,0,20,-20,53,5,11
3,00:13:45,0,True,27,0,27,29,0,11
4,00:13:26,0,False,6,34,-28,25,0,11
4,00:12:59,0,True,34,7,27,35,0,11
4,00:12:49,1,False,7,34,-27,42,10,11
4,00:05:44,3,True,37,7,30,14,2,11
1,00:11:34,0,False,0,0,0,42,0,11
1,00:08:34,3,False,0,0,0,26,6,11
1,00:08:06,1,True,0,0,0,26,10,11
1,00:07:16,2,True,0,0,0,49,10,11
1,00:05:16,1,False,0,6,-6,24,10,11
1,00:03:05,0,False,0,6,-6,24,0,11
2,00:13:39,0,True,6,3,3,44,0,11
2,00:08:43,3,True,6,6,0,50,24,11
2,00:07:52,0,False,6,6,0,45,0,11
2,00:05:11,3,False,6,6,0,48,4,11
3,00:08:15,0,False,13,7,6,31,0,11
3,00:05:46,0,True,7,20,-13,5,0,11
3,00:04:05,3,False,20,14,6,21,10,11
3,00:03:06,2,True,14,20,-6,34,6,11
4,00:15:00,3,True,14,27,-13,37,2,11
4,00:10:13,0,False,27,14,13,17,0,11
4,00:09:21,1,True,14,27,-13,1,1,11
4,00:06:35,0,True,14,34,-20,19,0,11
4,00:04:23,2,False,34,20,14,22,14,11
1,00:09:33,2,False,0,0,0,26,1,11
1,00:06:45,0,False,0,3,-3,11,0,11
1,00:05:51,0,False,0,3,-3,2,0,11
1,00:01:49,0,True,3,3,0,30,0,11
2,00:05:12,0,False,3,6,-3,47,0,11
2,00:01:15,3,False,6,6,0,17,5,11
3,00:09:30,3,False,6,9,-3,36,0,11
4,00:08:50,2,True,20,6,14,48,10,11
1,00:13:44,2,True,0,0,0,38,3,11
1,00:11:59,1,False,0,0,0,35,10,11
1,00:12:22,2,False,0,0,0,32,10,11
2,00:09:00,2,True,0,4,-4,35,10,11
2,00:07:57,0,True,0,4,-4,22,0,11
2,00:01:16,0,True,3,12,-9,35,0,11
3,00:07:12,0,False,12,3,9,28,0,11
3,00:01:43,2,True,3,19,-16,48,10,11
3,00:01:00,0,True,3,19,-16,21,0,11
4,00:15:00,2,False,19,3,16,12,13,11
4,00:13:30,3,False,19,3,16,53,12,11
4,00:12:10,0,False,19,3,16,40,0,11
1,00:09:28,0,True,7,0,7,45,0,11
1,00:03:43,0,True,7,3,4,34,0,11
2,00:13:45,2,False,3,7,-4,44,1,11
2,00:06:45,0,False,13,7,6,13,0,11
2,00:04:40,0,False,20,7,13,27,0,11
2,00:01:58,3,False,20,7,13,43,1,11
3,00:15:00,0,False,22,7,15,35,0,11
3,00:12:30,2,True,7,22,-15,19,6,11
4,00:05:00,0,False,30,10,20,28,0,11
4,00:00:17,0,False,30,10,20,44,0,11
1,00:10:12,3,False,7,0,7,1,1,11
1,00:08:47,0,True,6,7,-1,25,0,11
1,00:00:55,1,False,10,7,3,27,10,11
1,00:00:05,0,True,7,10,-3,51,0,11
2,00:12:27,1,True,7,13,-6,38,10,11
2,00:10:40,0,True,7,13,-6,35,0,11
2,00:06:38,1,True,7,13,-6,13,13,11
2,00:03:00,3,False,20,7,13,29,10,11
4,00:10:15,2,True,13,26,-13,54,6,11
4,00:09:54,2,False,26,13,13,51,1,11
1,00:08:58,1,True,6,0,6,9,10,11
2,00:14:44,0,True,6,3,3,29,0,11
2,00:10:23,0,True,13,10,3,49,0,11
2,00:05:51,0,False,10,19,-9,35,0,11
2,00:04:47,0,False,10,19,-9,41,0,11
1,00:12:12,0,True,0,0,0,10,0,11
1,00:09:24,0,False,0,6,-6,41,0,11
1,00:00:54,3,True,6,0,6,21,15,11
2,00:13:38,0,True,6,0,6,53,0,11
2,00:12:36,1,False,0,6,-6,46,10,11
2,00:08:25,1,False,5,6,-1,40,10,11
3,00:08:04,0,False,13,13,0,26,0,11
3,00:07:05,3,True,13,13,0,29,9,11
4,00:12:10,2,True,16,13,3,25,2,11
4,00:05:25,0,False,20,16,4,35,0,11
4,00:04:13,3,True,16,20,-4,50,10,11
1,00:05:56,0,True,0,7,-7,35,0,11
2,00:06:30,0,True,10,15,-5,40,0,11
2,00:02:55,1,False,15,10,5,39,10,11
3,00:12:07,2,False,18,10,8,40,4,11
4,00:05:03,0,True,18,22,-4,1,0,11
4,00:00:44,0,False,23,21,2,33,0,11
1,00:07:26,3,False,0,2,-2,49,2,11
1,00:06:48,0,True,2,0,2,48,0,11
2,00:12:01,0,False,7,10,-3,6,0,11
2,00:10:54,1,True,10,7,3,26,10,11
2,00:06:23,0,True,10,7,3,24,0,11
2,00:06:02,0,True,10,7,3,20,0,11
3,00:12:42,0,True,10,10,0,51,0,11
3,00:07:15,0,True,16,10,6,3,0,11
3,00:06:54,0,True,16,10,6,1,0,11
4,00:14:18,1,False,11,16,-5,17,10,11
4,00:12:37,3,False,11,24,-13,14,6,11
4,00:10:22,0,False,11,25,-14,49,0,11
4,00:03:30,1,False,11,26,-15,50,10,11
1,00:14:20,0,False,0,0,0,20,0,11
1,00:07:52,1,False,0,0,0,26,10,11
1,00:04:28,1,False,0,0,0,44,10,11
1,00:02:05,0,False,0,0,0,12,0,11
2,00:01:15,0,True,14,15,-1,41,0,11
3,00:14:06,0,True,20,15,5,3,0,11
3,00:10:29,0,True,22,15,7,54,0,11
3,00:07:01,0,True,22,15,7,0,0,11
1,00:10:07,0,False,3,1,2,39,0,11
1,00:05:28,0,False,3,7,-4,51,0,11
1,00:03:42,2,True,7,3,4,22,20,11
2,00:14:55,0,False,17,7,10,37,0,11
2,00:12:03,0,False,17,7,10,21,0,11
2,00:11:34,0,False,17,7,10,16,0,11
2,00:09:27,0,True,7,31,-24,35,0,11
2,00:06:23,0,True,7,31,-24,52,0,11
2,00:06:05,0,True,7,31,-24,52,0,11
2,00:05:28,0,False,31,7,24,53,0,11
2,00:04:28,1,True,7,31,-24,35,10,11
2,00:01:01,0,True,7,38,-31,49,0,11
2,00:00:42,0,True,7,38,-31,38,0,11
3,00:09:23,3,True,13,41,-28,35,10,11
3,00:05:49,0,True,15,41,-26,29,0,11
3,00:04:08,0,True,18,41,-23,53,0,11
4,00:12:27,0,True,24,49,-25,8,0,11
4,00:04:52,0,True,26,52,-26,46,0,11
1,00:02:12,0,True,7,0,7,38,0,11
1,00:01:09,0,False,0,7,-7,11,0,11
2,00:10:58,0,True,7,0,7,21,0,11
2,00:01:44,0,True,16,0,16,44,0,11
4,00:14:18,0,False,3,25,-22,12,0,11
4,00:10:31,0,False,9,25,-16,3,0,11
4,00:01:38,3,False,11,28,-17,40,6,11
4,00:01:22,0,True,29,11,18,50,0,11
1,00:08:23,0,False,0,0,0,32,0,11
1,00:03:08,0,True,0,3,-3,8,0,11
3,00:10:30,0,False,9,10,-1,46,0,11
3,00:05:56,0,True,13,9,4,38,0,11
3,00:05:36,1,False,9,13,-4,40,10,11
3,00:00:07,0,True,13,16,-3,51,0,11
4,00:07:25,0,True,27,16,11,16,0,11
4,00:04:15,3,True,27,16,11,47,5,11
1,00:03:23,0,True,3,3,0,53,0,11
2,00:12:39,3,False,10,3,7,37,2,11
2,00:12:07,3,True,3,10,-7,30,7,11
2,00:03:04,0,True,9,10,-1,45,0,11
2,00:02:36,0,False,10,9,1,53,0,11
2,00:00:08,0,True,15,10,5,3,0,11
2,00:00:08,0,True,15,10,5,1,0,11
4,00:11:30,0,False,11,21,-10,47,0,11
4,00:01:29,0,True,21,21,0,1,0,11
4,00:00:23,0,False,21,28,-7,35,0,11
5,00:00:00,0,True,28,28,0,1,0,11
5,00:00:00,0,True,34,28,6,3,0,11
5,00:00:00,2,True,34,28,6,20,5,11
5,00:00:00,0,False,34,34,0,23,0,11
1,00:05:49,0,True,7,0,7,35,0,11
1,00:04:56,0,True,7,0,7,19,0,11
1,00:02:45,3,False,0,14,-14,35,10,11
1,00:01:50,0,False,0,14,-14,50,0,11
1,00:00:29,0,True,14,0,14,25,0,11
2,00:10:01,0,True,26,0,26,29,0,11
2,00:04:40,0,False,0,29,-29,28,0,11
2,00:03:54,2,True,29,0,29,33,10,11
3,00:13:15,0,True,36,11,25,43,0,11
3,00:12:44,2,True,36,11,25,52,10,11
3,00:11:20,0,False,11,36,-25,28,0,11
3,00:07:56,1,True,36,14,22,35,10,11
4,00:07:09,0,True,46,17,29,35,0,11
1,00:08:56,1,True,0,0,0,27,10,11
1,00:05:59,0,True,3,0,3,35,0,11
2,00:06:11,0,False,3,12,-9,7,0,11
2,00:06:07,0,False,3,12,-9,1,0,11
2,00:05:41,0,False,3,12,-9,6,0,11
2,00:03:30,3,True,12,10,2,23,12,11
2,00:02:50,3,False,10,12,-2,37,4,11
2,00:11:31,0,True,3,7,-4,10,0,11
2,00:05:56,0,True,6,7,-1,31,0,11
2,00:04:17,0,True,6,7,-1,28,0,11
3,00:12:59,2,False,7,6,1,53,10,11
4,00:15:00,0,False,15,12,3,21,0,11
4,00:13:59,0,False,15,12,3,2,0,11
4,00:10:29,0,False,22,12,10,36,0,11
4,00:03:01,0,False,22,18,4,30,0,11
4,00:02:40,0,False,22,18,4,12,0,11
4,00:01:59,0,False,29,18,11,49,0,11
5,00:00:00,0,False,29,29,0,40,0,11
1,00:04:07,1,False,0,0,0,32,10,11
2,00:13:15,3,False,7,0,7,45,12,11
2,00:09:00,2,False,7,0,7,31,10,11
3,00:12:23,0,True,22,14,8,12,0,11
3,00:10:55,0,True,22,14,8,34,0,11
3,00:08:35,0,True,22,14,8,21,0,11
3,00:05:05,2,True,22,17,5,41,4,11
3,00:01:56,0,False,17,22,-5,20,0,11
4,00:15:00,0,False,17,22,-5,43,0,11
4,00:09:36,0,False,20,22,-2,34,0,11
1,00:15:00,0,True,0,0,0,35,0,11
1,00:09:14,0,True,1,0,1,54,0,11
1,00:05:43,0,False,0,1,-1,41,0,11
1,00:04:14,0,True,1,0,1,25,0,11
2,00:13:18,0,False,0,4,-4,34,0,11
2,00:01:27,2,False,7,7,0,41,4,11
3,00:14:22,0,True,7,10,-3,7,0,11
3,00:13:22,2,False,10,7,3,23,8,11
3,00:09:52,2,True,7,10,-3,54,1,11
1,00:06:15,2,True,0,2,-2,51,10,11
1,00:02:32,3,False,5,0,5,26,10,11
2,00:07:55,0,True,0,5,-5,32,0,11
3,00:13:50,0,True,3,8,-5,45,0,11
3,00:04:50,0,False,11,6,5,4,0,11
3,00:02:36,2,True,6,11,-5,30,15,11
4,00:06:11,0,True,12,17,-5,41,0,11
1,00:13:46,3,True,0,0,0,25,11,11
1,00:11:08,0,False,0,0,0,16,0,11
1,00:08:02,0,False,7,0,7,44,0,11
2,00:10:16,3,False,8,0,8,47,1,11
2,00:04:55,1,False,9,3,6,45,10,11
2,00:01:51,0,False,9,4,5,48,0,11
3,00:15:00,0,False,9,4,5,35,0,11
3,00:06:07,0,False,17,11,6,21,0,11
3,00:02:29,3,False,20,11,9,43,5,11
3,00:00:02,0,False,20,11,9,29,0,11
4,00:15:00,2,True,11,20,-9,2,2,11
1,00:08:55,0,False,8,0,8,53,0,11
1,00:05:49,0,False,8,0,8,21,0,11
2,00:09:13,3,False,16,16,0,46,10,11
3,00:05:10,0,True,16,16,0,45,0,11
4,00:10:32,3,False,22,23,-1,40,28,11
4,00:08:48,3,True,23,22,1,14,5,11
1,00:06:41,3,True,0,8,-8,11,21,11
2,00:13:40,0,False,11,8,3,48,0,11
2,00:02:26,0,True,17,19,-2,3,0,11
2,00:00:40,0,True,17,19,-2,42,0,11
3,00:07:47,1,True,17,22,-5,50,10,11
1,00:00:01,0,True,14,0,14,24,0,11
2,00:13:19,2,False,0,21,-21,22,16,11
2,00:07:22,0,False,7,21,-14,10,0,11
2,00:03:19,3,False,7,21,-14,25,10,11
2,00:02:53,0,False,7,21,-14,35,0,11
2,00:01:03,0,False,7,21,-14,17,0,11
3,00:12:49,0,False,7,21,-14,40,0,11
4,00:15:00,0,False,18,21,-3,53,0,11
4,00:10:25,3,False,21,21,0,28,11,11
4,00:08:28,0,True,21,21,0,48,0,11
4,00:05:22,0,True,24,21,3,50,0,11
4,00:02:17,0,True,27,27,0,48,0,11
1,00:03:30,0,False,0,1,-1,15,0,11
2,00:12:27,0,True,1,3,-2,47,0,11
2,00:11:28,0,True,1,3,-2,32,0,11
2,00:00:30,1,True,4,3,1,19,10,11
3,00:10:50,3,True,4,3,1,43,6,11
4,00:11:38,3,False,3,18,-15,27,17,11
4,00:07:52,1,False,3,25,-22,45,10,11
4,00:02:48,0,True,32,3,29,4,0,11
1,00:12:21,0,False,0,0,0,52,0,11
1,00:10:29,0,True,0,0,0,39,0,11
1,00:06:02,0,True,3,7,-4,35,0,11
2,00:05:19,0,False,11,6,5,33,0,11
2,00:04:05,0,False,11,6,5,45,0,11
2,00:01:15,0,False,14,6,8,35,0,11
2,00:00:09,1,False,14,14,0,53,10,11
3,00:03:30,0,True,21,17,4,46,0,11
3,00:01:24,0,False,17,21,-4,4,0,11
4,00:06:13,0,False,28,21,7,21,0,11
4,00:05:00,3,True,21,28,-7,40,3,11
1,00:13:07,2,True,0,0,0,40,1,11
1,00:12:28,2,False,0,0,0,53,11,11
1,00:11:55,1,False,0,0,0,35,10,11
1,00:10:23,0,False,0,7,-7,35,0,11
1,00:09:18,0,False,0,7,-7,47,0,11
1,00:07:37,1,True,7,3,4,37,10,11
1,00:06:52,0,False,3,7,-4,43,0,11
2,00:04:23,0,True,7,6,1,8,0,11
2,00:04:01,1,False,6,7,-1,18,10,11
2,00:03:15,0,True,7,6,1,45,0,11
2,00:00:22,1,True,7,13,-6,52,10,11
2,00:00:03,0,False,13,10,3,35,0,11
3,00:13:56,1,False,14,10,4,55,10,11
3,00:09:34,3,True,10,15,-5,54,3,11
3,00:06:57,3,False,15,10,5,19,8,11
3,00:04:42,0,True,10,15,-5,6,0,11
4,00:00:50,3,True,13,18,-5,41,11,11
1,00:12:47,3,True,0,0,0,54,10,7
1,00:12:07,3,False,0,0,0,12,10,7
1,00:09:38,3,False,0,0,0,20,1,7
2,00:12:11,3,True,3,7,-4,34,6,7
2,00:07:27,3,False,7,3,4,51,11,7
2,00:03:16,3,True,3,7,-4,21,10,7
2,00:02:27,3,True,3,7,-4,50,5,7
2,00:01:14,3,True,3,14,-11,50,5,7
4,00:08:54,3,False,24,6,18,50,5,7
4,00:04:14,3,False,24,6,18,44,3,7
4,00:01:10,3,True,6,24,-18,44,22,7
1,00:09:48,3,True,7,0,7,40,20,7
1,00:03:50,3,True,7,3,4,44,4,7
2,00:12:40,3,True,7,6,1,47,10,7
2,00:07:40,3,True,7,16,-9,34,9,7
2,00:06:16,3,False,16,7,9,46,7,7
2,00:02:05,3,False,16,7,9,43,10,7
2,00:00:55,3,False,16,10,6,44,1,7
3,00:11:36,3,False,23,10,13,49,10,7
3,00:08:34,3,True,12,23,-11,35,15,7
3,00:07:06,3,True,12,23,-11,45,10,7
3,00:06:01,3,True,12,23,-11,14,5,7
3,00:01:24,3,False,26,12,14,55,8,7
4,00:02:30,3,True,26,33,-7,48,10,7
4,00:00:59,3,True,26,33,-7,53,25,7
1,00:14:02,3,True,0,0,0,50,8,7
1,00:07:05,3,True,7,0,7,49,4,7
1,00:03:45,3,True,7,0,7,28,13,7
1,00:02:32,3,False,0,7,-7,50,3,7
1,00:00:10,3,True,7,0,7,46,16,7
2,00:12:21,3,True,7,0,7,46,3,7
2,00:05:40,3,False,7,14,-7,48,5,7
2,00:02:30,3,True,14,7,7,47,10,7
3,00:13:38,3,False,9,14,-5,38,4,7
1,00:11:10,3,True,0,0,0,55,16,7
1,00:07:17,3,True,0,3,-3,40,1,7
1,00:05:05,3,True,0,3,-3,42,15,7
1,00:01:40,3,False,3,7,-4,43,8,7
2,00:08:36,3,True,7,11,-4,33,12,7
2,00:04:57,3,False,11,7,4,52,19,7
2,00:01:28,3,True,14,11,3,30,1,7
2,00:00:51,3,False,11,14,-3,45,2,7
3,00:14:04,3,False,11,14,-3,40,7,7
3,00:11:26,2,True,14,11,3,39,11,7
3,00:09:10,3,False,11,14,-3,38,21,7
4,00:13:54,3,True,21,14,7,44,15,7
4,00:12:48,3,True,21,14,7,27,5,7
4,00:09:19,3,True,21,17,4,35,10,7
4,00:06:17,3,False,17,21,-4,40,4,7
1,00:13:55,3,False,0,0,0,21,5,7
1,00:12:34,3,True,0,0,0,55,5,7
1,00:10:02,3,False,0,0,0,31,12,7
1,00:08:44,3,True,0,0,0,43,6,7
1,00:07:06,3,False,0,0,0,55,3,7
2,00:12:05,3,True,7,3,4,28,17,7
2,00:07:08,3,False,10,7,3,47,8,7
2,00:04:24,3,True,7,10,-3,44,2,7
3,00:08:09,3,False,18,21,-3,28,22,7
3,00:03:40,3,False,18,24,-6,46,10,7
4,00:08:56,3,True,31,25,6,48,10,7
4,00:00:59,3,False,25,48,-23,36,13,7
1,00:13:53,3,True,0,0,0,37,7,7
1,00:11:55,3,True,0,0,0,48,10,7
1,00:08:31,3,False,0,0,0,37,4,7
1,00:03:24,3,True,3,0,3,50,10,7
2,00:09:55,3,False,7,10,-3,33,13,7
2,00:00:26,3,True,17,14,3,26,26,7
3,00:13:56,3,False,17,17,0,43,8,7
3,00:12:41,3,True,17,17,0,27,4,7
3,00:08:58,3,True,17,17,0,46,8,7
3,00:07:41,3,True,17,17,0,12,1,7
3,00:03:32,3,True,17,20,-3,29,16,7
3,00:00:11,3,True,17,23,-6,32,13,7
4,00:09:44,3,False,26,20,6,28,17,7
4,00:06:31,3,True,20,26,-6,55,23,7
4,00:05:03,3,False,26,20,6,18,16,7
1,00:10:03,3,False,0,7,-7,14,7,7
1,00:06:33,3,False,0,10,-10,38,19,7
1,00:04:50,3,True,10,0,10,22,17,7
1,00:01:48,3,False,0,17,-17,29,7,7
2,00:14:22,3,False,0,17,-17,51,5,7
2,00:12:10,3,False,0,17,-17,30,20,7
2,00:10:45,3,True,17,0,17,45,20,7
2,00:07:08,3,True,17,0,17,45,1,7
2,00:02:10,3,False,7,17,-10,48,9,7
2,00:01:36,3,True,17,7,10,35,17,7
2,00:00:14,3,False,7,17,-10,53,10,7
3,00:07:54,3,False,7,23,-16,43,2,7
4,00:13:39,3,False,7,30,-23,40,5,7
4,00:01:17,3,True,37,34,3,40,8,7
1,00:11:23,3,False,0,1,-1,29,16,7
1,00:06:35,3,False,0,1,-1,24,13,7
1,00:01:12,3,True,8,0,8,23,3,7
2,00:01:50,3,False,10,8,2,37,17,7
2,00:01:11,3,True,8,17,-9,24,3,7
2,00:00:47,3,False,17,8,9,48,5,7
2,00:00:30,3,True,8,17,-9,26,10,7
3,00:08:03,3,False,17,8,9,54,6,7
3,00:04:42,3,False,17,8,9,46,6,7
4,00:12:22,3,True,8,20,-12,17,10,7
4,00:11:33,3,False,20,8,12,36,20,7
4,00:07:52,3,False,20,9,11,50,5,7
4,00:05:01,3,True,9,20,-11,40,8,7
4,00:00:17,3,True,9,20,-11,27,10,7
1,00:14:24,3,False,0,0,0,38,7,7
1,00:13:31,3,True,0,0,0,37,10,7
1,00:12:20,3,False,0,0,0,38,2,7
1,00:11:18,3,True,0,0,0,36,6,7
1,00:08:57,3,False,0,0,0,31,8,7
1,00:07:00,3,False,0,0,0,43,8,7
1,00:04:45,2,True,2,0,2,47,10,7
2,00:14:41,3,True,2,7,-5,43,10,7
2,00:13:15,3,False,7,2,5,20,18,7
2,00:09:42,3,False,7,9,-2,32,5,7
2,00:08:35,3,True,9,7,2,37,5,7
2,00:02:27,3,False,10,9,1,16,10,7
2,00:01:27,3,False,10,9,1,47,10,7
2,00:01:03,3,True,9,10,-1,25,5,7
2,00:00:23,3,False,10,9,1,39,5,7
3,00:08:02,3,True,10,17,-7,18,10,7
3,00:02:03,3,False,17,17,0,46,5,7
3,00:00:30,3,True,17,17,0,39,11,7
4,00:08:45,3,True,17,17,0,39,27,7
4,00:01:58,3,False,20,24,-4,34,7,7
1,00:13:32,3,True,0,0,0,24,39,7
1,00:07:17,3,False,7,0,7,26,13,7
1,00:04:45,3,False,7,0,7,52,4,7
2,00:15:00,3,False,7,0,7,35,25,7
2,00:12:24,3,False,7,0,7,28,5,7
2,00:03:44,3,True,8,10,-2,50,18,7
2,00:01:19,3,False,10,9,1,43,2,7
3,00:13:46,3,False,10,9,1,35,3,7
3,00:12:22,3,True,9,10,-1,37,2,7
3,00:06:11,3,False,13,9,4,50,3,7
3,00:03:55,3,True,9,13,-4,41,10,7
4,00:04:52,3,True,12,19,-7,35,10,7
1,00:13:52,3,False,0,0,0,45,6,7
1,00:07:53,3,False,0,3,-3,32,7,7
1,00:03:23,3,True,3,0,3,44,12,7
2,00:10:58,3,False,5,10,-5,32,10,7
2,00:08:29,3,False,5,10,-5,25,3,7
2,00:02:27,3,True,17,5,12,18,1,7
2,00:01:31,3,True,17,5,12,50,2,7
2,00:00:50,3,True,17,5,12,19,8,7
3,00:06:51,3,False,8,34,-26,40,2,7
3,00:05:59,3,True,34,8,26,30,10,7
3,00:04:27,3,False,8,34,-26,44,5,7
4,00:05:58,3,False,22,34,-12,11,13,7
4,00:00:37,3,True,37,29,8,37,6,7
1,00:10:09,3,True,7,1,6,35,10,7
1,00:08:31,3,False,1,7,-6,32,16,7
2,00:11:44,3,False,2,13,-11,44,1,7
2,00:09:18,3,True,13,2,11,24,11,7
2,00:07:41,3,False,2,13,-11,35,30,7
2,00:06:35,3,True,13,2,11,49,4,7
2,00:01:44,3,True,13,5,8,42,10,7
2,00:01:25,3,False,5,13,-8,35,10,7
3,00:13:36,3,False,5,16,-11,39,15,7
3,00:09:46,3,True,16,8,8,39,6,7
3,00:02:46,3,True,23,21,2,35,10,7
4,00:13:39,3,False,28,30,-2,54,2,7
4,00:12:01,3,True,30,28,2,30,13,7
1,00:13:25,3,False,0,0,0,45,4,7
1,00:03:35,3,False,0,7,-7,46,5,7
1,00:00:00,3,False,0,7,-7,30,15,7
2,00:13:41,3,False,0,14,-14,25,11,7
2,00:12:16,3,False,0,14,-14,48,4,7
2,00:06:19,3,False,0,14,-14,10,6,7
2,00:02:10,3,True,21,0,21,50,10,7
3,00:02:03,3,False,0,44,-44,38,7,7
3,00:00:40,3,True,44,0,44,40,14,7
4,00:11:18,3,True,44,0,44,18,2,7
4,00:08:55,3,True,44,0,44,13,4,7
4,00:01:30,3,False,0,52,-52,45,10,7
1,00:03:46,3,True,7,3,4,4,7,7
2,00:13:31,3,True,7,6,1,33,12,7
2,00:09:45,3,True,7,9,-2,28,17,7
2,00:08:22,3,False,9,7,2,46,5,7
2,00:07:02,3,True,7,9,-2,31,11,7
2,00:05:18,3,False,9,7,2,34,19,7
3,00:13:58,3,False,12,10,2,38,6,7
3,00:07:02,3,True,17,13,4,35,10,7
3,00:05:52,3,False,13,17,-4,48,12,7
3,00:02:39,3,True,17,13,4,55,12,7
4,00:11:59,3,True,24,13,11,50,8,7
4,00:05:26,3,True,25,13,12,50,15,7
4,00:04:02,3,True,25,13,12,8,15,7
1,00:10:44,3,False,0,7,-7,38,6,7
1,00:08:35,3,True,7,0,7,43,4,7
2,00:15:00,3,True,7,10,-3,41,11,7
2,00:13:52,3,False,10,7,3,25,6,7
2,00:12:04,3,True,7,10,-3,27,24,7
2,00:11:23,3,False,10,7,3,45,10,7
2,00:10:06,3,True,7,10,-3,23,6,7
2,00:05:35,3,False,11,7,4,43,6,7
2,00:03:50,3,True,7,11,-4,28,10,7
2,00:01:03,3,True,7,14,-7,54,5,7
2,00:00:17,3,True,7,14,-7,26,25,7
3,00:13:06,3,True,7,14,-7,55,7,7
3,00:06:43,3,False,14,16,-2,22,24,7
4,00:08:48,3,False,21,23,-2,37,21,7
4,00:02:08,3,True,23,24,-1,30,15,7
1,00:04:42,3,False,8,3,5,50,3,7
1,00:03:16,3,False,8,3,5,8,3,7
2,00:15:00,3,False,8,6,2,47,10,7
2,00:06:30,3,False,8,13,-5,50,10,7
2,00:03:52,3,True,13,8,5,48,11,7
3,00:14:02,3,True,13,15,-2,31,4,7
4,00:12:22,3,False,22,19,3,43,1,7
4,00:11:02,3,True,19,22,-3,35,8,7
4,00:06:04,3,True,19,22,-3,17,2,7
1,00:14:00,3,False,0,0,0,40,5,7
1,00:04:35,3,False,0,8,-8,51,9,7
2,00:14:45,3,True,8,7,1,55,11,7
2,00:08:26,3,True,8,14,-6,36,6,7
2,00:02:32,3,True,8,14,-6,43,18,7
2,00:01:49,3,False,14,8,6,33,5,7
3,00:02:04,3,False,20,15,5,52,10,7
4,00:15:00,3,False,20,15,5,51,2,7
4,00:12:33,3,True,15,20,-5,37,15,7
4,00:07:35,3,False,27,22,5,44,11,7
4,00:02:21,3,False,27,22,5,2,13,7
4,00:01:25,3,False,27,22,5,54,4,7
1,00:07:55,3,False,0,7,-7,15,18,7
2,00:13:13,3,True,17,0,17,37,8,7
2,00:10:26,3,False,0,17,-17,48,13,7
2,00:05:05,3,False,0,17,-17,43,18,7
2,00:03:52,3,True,17,0,17,17,10,7
2,00:00:34,3,False,3,24,-21,31,5,7
2,00:00:09,3,True,24,3,21,53,3,7
3,00:10:54,3,True,24,3,21,24,1,7
4,00:08:35,3,True,25,7,18,41,4,7
4,00:06:54,3,False,7,25,-18,44,13,7
4,00:05:59,3,True,25,7,18,18,4,7
1,00:14:16,3,False,0,0,0,41,10,7
1,00:10:10,3,True,0,7,-7,38,3,7
1,00:05:06,3,False,14,3,11,48,18,7
1,00:04:00,3,True,3,14,-11,35,1,7
2,00:12:48,3,True,11,14,-3,54,5,7
3,00:11:53,3,False,23,20,3,31,8,7
3,00:10:31,3,False,23,27,-4,26,19,7
4,00:15:00,3,False,24,33,-9,53,7,7
4,00:12:47,3,True,33,24,9,53,10,7
4,00:11:20,3,True,33,24,9,3,11,7
4,00:08:47,3,True,33,31,2,41,2,7
4,00:03:19,3,True,33,34,-1,39,6,7
1,00:03:57,3,False,11,0,11,50,8,7
1,00:02:38,3,False,11,0,11,7,13,7
2,00:11:21,3,True,3,11,-8,20,10,7
2,00:10:11,3,False,11,3,8,25,23,7
3,00:13:02,3,False,12,20,-8,32,5,7
3,00:07:13,3,False,12,23,-11,20,25,7
3,00:03:15,3,False,12,23,-11,52,15,7
4,00:13:30,3,True,23,15,8,30,15,7
4,00:05:31,3,True,23,30,-7,37,20,7
1,00:03:16,3,True,8,14,-6,39,10,7
2,00:06:34,3,False,24,22,2,34,5,7
4,00:12:46,3,True,32,34,-2,46,3,7
4,00:10:17,3,True,32,34,-2,55,5,7
4,00:08:11,3,False,34,32,2,40,10,7
4,00:00:39,3,True,39,34,5,42,7,7
1,00:14:05,3,False,0,0,0,42,5,7
1,00:03:28,3,True,5,0,5,30,9,7
2,00:01:34,3,True,15,0,15,49,4,7
3,00:13:15,3,False,0,15,-15,26,11,7
3,00:12:07,3,True,15,0,15,42,10,7
3,00:08:28,3,False,0,15,-15,35,14,7
3,00:01:35,3,True,15,7,8,46,5,7
1,00:06:24,3,True,7,0,7,50,4,7
1,00:00:25,3,False,0,16,-16,46,3,7
2,00:04:49,3,False,6,23,-17,23,4,7
2,00:00:51,3,False,6,31,-25,53,10,7
3,00:08:24,3,True,31,21,10,40,5,7
3,00:06:52,3,False,21,31,-10,38,1,7
3,00:00:02,3,False,21,38,-17,55,16,7
4,00:14:15,3,True,38,21,17,37,6,7
1,00:06:50,3,True,7,0,7,54,2,7
1,00:05:15,3,True,7,0,7,40,5,7
1,00:01:38,3,False,0,14,-14,24,2,7
2,00:02:17,3,True,20,4,16,44,1,7
3,00:12:45,3,False,11,27,-16,40,7,7
3,00:11:12,3,True,27,11,16,40,8,7
3,00:08:28,3,False,11,27,-16,55,19,7
3,00:01:00,3,True,27,14,13,25,20,7
4,00:09:59,3,True,27,17,10,20,4,7
4,00:02:02,3,False,24,27,-3,23,10,7
4,00:01:24,3,False,24,27,-3,52,2,7
1,00:06:35,3,True,0,7,-7,52,3,7
2,00:15:00,3,True,0,14,-14,23,3,7
2,00:12:12,3,True,0,14,-14,24,5,7
2,00:06:50,3,False,15,1,14,38,7,7
2,00:03:29,3,False,15,1,14,48,12,7
2,00:01:23,3,True,1,15,-14,29,18,7
2,00:00:46,3,True,1,15,-14,52,9,7
3,00:13:42,3,True,1,22,-21,12,8,7
3,00:06:31,3,False,36,4,32,27,4,7
4,00:09:32,3,False,39,6,33,33,23,7
4,00:02:52,3,False,39,12,27,24,3,7
4,00:01:00,3,False,39,15,24,39,6,7
1,00:12:01,3,True,0,0,0,46,9,7
2,00:11:13,3,True,3,7,-4,35,4,7
2,00:04:09,3,False,8,3,5,32,15,7
2,00:00:14,3,True,3,8,-5,37,16,7
3,00:13:31,3,True,3,8,-5,29,12,7
3,00:10:00,3,True,3,8,-5,48,13,7
3,00:08:53,3,False,8,3,5,23,10,7
3,00:07:28,3,True,3,8,-5,43,13,7
3,00:05:55,3,False,8,3,5,40,1,7
3,00:04:58,3,True,3,8,-5,15,18,7
3,00:00:33,3,False,8,4,4,31,14,7
4,00:14:33,3,True,4,8,-4,34,15,7
4,00:09:22,3,False,9,4,5,20,10,7
4,00:04:33,3,True,4,16,-12,33,17,7
4,00:03:33,3,False,16,4,12,45,6,7
4,00:01:28,3,False,16,11,5,53,11,7
1,00:13:55,3,False,0,0,0,38,8,7
1,00:08:21,3,False,0,0,0,21,4,7
1,00:04:54,3,False,0,7,-7,42,1,7
2,00:11:40,3,False,0,10,-10,34,6,7
2,00:01:02,3,False,3,14,-11,47,10,7
2,00:00:38,3,True,14,3,11,21,10,7
2,00:00:03,3,True,14,3,11,50,4,7
3,00:13:40,3,True,14,3,11,22,15,7
3,00:12:13,3,False,3,14,-11,43,15,7
3,00:03:35,3,False,3,17,-14,50,9,7
1,00:03:27,3,True,3,7,-4,9,10,7
2,00:12:31,3,False,14,3,11,49,3,7
2,00:11:03,3,False,14,3,11,14,2,7
3,00:10:39,3,False,21,17,4,36,1,7
3,00:03:12,3,False,21,20,1,48,7,7
4,00:11:45,3,False,21,28,-7,39,4,7
2,00:11:42,3,True,7,16,-9,24,8,7
2,00:03:30,3,False,16,10,6,52,7,7
2,00:02:44,3,False,16,10,6,16,8,7
3,00:05:57,3,True,13,23,-10,38,10,7
3,00:04:42,3,False,23,13,10,42,2,7
4,00:15:00,3,True,13,23,-10,41,10,7
4,00:04:32,3,False,30,20,10,50,5,7
4,00:01:59,3,False,30,20,10,48,6,7
2,00:09:28,3,False,7,10,-3,38,13,7
2,00:01:54,3,True,10,10,0,43,5,7
2,00:00:48,3,False,10,10,0,32,13,7
3,00:09:09,3,True,13,16,-3,31,21,7
3,00:01:37,3,False,19,13,6,49,9,7
4,00:09:25,3,False,19,22,-3,25,12,7
4,00:05:11,3,False,19,25,-6,30,15,7
1,00:09:24,3,False,0,3,-3,51,8,7
2,00:13:42,3,False,7,11,-4,44,13,7
2,00:12:06,3,True,11,7,4,35,7,7
2,00:06:18,3,True,11,14,-3,29,3,7
2,00:01:34,3,False,14,11,3,39,10,7
2,00:01:11,3,True,11,14,-3,32,12,7
3,00:08:50,3,True,14,22,-8,47,8,7
3,00:04:01,3,False,29,14,15,52,6,7
4,00:08:29,3,False,32,21,11,40,5,7
4,00:07:39,3,True,21,32,-11,29,10,7
1,00:14:07,3,True,0,0,0,19,18,7
1,00:13:01,3,True,0,0,0,53,10,7
2,00:13:33,3,True,11,8,3,42,3,7
2,00:03:00,3,True,18,15,3,53,5,7
4,00:15:00,3,False,25,25,0,43,7,7
4,00:12:07,3,False,25,25,0,29,17,7
4,00:03:47,3,False,32,26,6,40,5,7
4,00:02:15,3,True,26,32,-6,33,14,7
1,00:14:10,3,False,0,0,0,39,10,7
1,00:04:21,3,True,7,0,7,40,10,7
2,00:15:00,3,True,7,3,4,43,2,7
2,00:09:03,3,True,7,6,1,39,6,7
2,00:00:59,3,False,13,7,6,52,16,7
3,00:13:51,3,True,7,13,-6,42,5,7
4,00:14:46,3,True,7,19,-12,52,4,7
4,00:02:47,3,False,19,14,5,33,9,7
1,00:05:46,3,True,7,15,-8,44,11,7
1,00:00:58,3,False,15,7,8,21,11,7
1,00:00:01,3,True,7,15,-8,55,10,7
2,00:10:31,3,True,7,15,-8,29,7,7
2,00:02:53,3,True,7,25,-18,24,11,7
2,00:00:48,3,False,33,14,19,43,4,7
3,00:13:50,3,False,33,14,19,44,5,7
3,00:09:09,3,True,14,40,-26,34,10,7
3,00:07:54,3,False,40,14,26,40,11,7
4,00:14:51,3,True,14,47,-33,8,15,7
4,00:12:21,3,True,14,47,-33,43,18,7
4,00:09:00,3,True,14,50,-36,36,9,7
4,00:03:07,3,True,17,50,-33,9,6,7
1,00:10:17,3,False,0,7,-7,39,15,7
2,00:11:00,3,True,9,6,3,36,12,7
2,00:05:19,3,True,9,6,3,38,16,7
3,00:11:15,3,False,13,14,-1,28,17,7
3,00:09:39,3,True,14,13,1,55,10,7
3,00:08:37,3,False,13,14,-1,19,10,7
3,00:01:20,3,False,13,17,-4,47,10,7
4,00:02:19,3,True,25,20,5,45,10,7
4,00:01:45,3,False,20,25,-5,26,20,7
1,00:14:01,3,True,0,0,0,50,11,7
1,00:12:32,3,False,0,0,0,32,1,7
1,00:11:13,3,True,0,0,0,35,6,7
1,00:01:31,3,False,0,3,-3,47,6,7
2,00:12:14,3,True,3,0,3,53,15,7
2,00:09:10,3,True,3,0,3,52,14,7
2,00:05:18,3,True,3,0,3,50,12,7
3,00:01:59,3,True,3,15,-12,53,7,7
4,00:14:00,3,True,3,15,-12,41,12,7
4,00:09:57,3,True,3,15,-12,49,3,7
4,00:03:26,3,False,17,3,14,35,10,7
4,00:01:26,3,False,17,3,14,25,7,7
1,00:10:06,3,False,0,0,0,50,13,7
1,00:03:04,3,False,0,1,-1,29,16,7
2,00:08:53,3,True,1,14,-13,47,14,7
2,00:05:11,3,False,14,1,13,49,13,7
2,00:03:35,3,True,1,14,-13,40,4,7
3,00:13:50,3,False,17,4,13,31,7,7
3,00:12:45,3,True,4,17,-13,49,8,7
4,00:10:51,3,False,34,11,23,30,1,7
4,00:02:12,3,False,35,11,24,52,5,7
2,00:13:23,3,False,7,6,1,41,2,7
2,00:11:50,3,True,6,7,-1,41,4,7
2,00:09:46,3,False,7,6,1,44,3,7
2,00:06:18,3,True,6,14,-8,28,10,7
2,00:02:50,3,True,6,14,-8,28,3,7
2,00:00:50,3,True,6,21,-15,28,2,7
3,00:02:50,3,True,6,31,-25,36,9,7
1,00:11:52,3,False,0,0,0,51,6,7
2,00:09:35,3,True,1,3,-2,40,8,7
2,00:07:45,3,False,3,1,2,28,22,7
2,00:02:50,3,True,1,3,-2,55,8,7
2,00:02:09,3,False,3,1,2,32,7,7
2,00:01:15,3,True,1,3,-2,45,16,7
2,00:00:36,3,False,3,1,2,18,15,7
3,00:08:22,3,False,4,4,0,19,7,7
4,00:05:13,3,False,12,14,-2,43,10,7
4,00:02:02,3,False,12,17,-5,39,6,7
4,00:01:35,3,True,17,12,5,41,6,7
1,00:13:55,3,False,0,0,0,37,9,7
1,00:12:43,3,True,0,0,0,38,7,7
1,00:05:03,3,True,0,10,-10,43,2,7
1,00:01:44,3,True,0,17,-17,13,15,7
2,00:02:10,3,False,24,10,14,30,2,7
3,00:13:32,3,True,19,24,-5,43,13,7
3,00:08:02,3,False,24,22,2,51,10,7
4,00:03:18,3,False,27,38,-11,30,10,7
4,00:02:32,3,True,38,27,11,46,6,7
1,00:04:04,3,True,0,3,-3,28,19,7
1,00:02:52,3,False,3,0,3,43,6,7
2,00:12:00,3,False,3,3,0,30,15,7
2,00:01:29,3,False,10,10,0,45,2,7
3,00:09:37,3,False,10,17,-7,25,16,7
4,00:11:43,3,True,24,13,11,53,2,7
4,00:05:24,3,True,24,14,10,54,4,7
1,00:09:02,2,True,0,3,-3,53,8,7
1,00:07:49,3,False,3,0,3,26,9,7
1,00:04:38,3,False,3,0,3,40,6,7
1,00:03:43,3,False,3,0,3,9,10,7
1,00:02:38,3,False,3,0,3,49,8,7
1,00:01:10,3,False,3,0,3,32,9,7
2,00:13:43,3,False,3,1,2,27,18,7
2,00:11:39,3,False,3,1,2,51,9,7
2,00:00:41,3,False,6,2,4,17,17,7
3,00:14:16,3,False,6,9,-3,28,10,7
3,00:01:20,3,True,12,21,-9,47,10,7
3,00:00:01,2,False,21,12,9,20,3,7
4,00:12:50,2,False,21,12,9,26,9,7
4,00:08:20,3,True,15,21,-6,54,8,7
4,00:05:42,3,True,15,21,-6,30,6,7
4,00:04:18,3,False,21,15,6,35,18,7
4,00:02:59,3,True,15,21,-6,41,6,7
4,00:01:47,3,False,21,15,6,47,10,7
1,00:13:24,3,False,0,0,0,21,10,7
1,00:08:23,3,False,0,0,0,35,1,7
2,00:02:39,3,False,0,13,-13,39,18,7
2,00:01:58,3,True,13,0,13,46,10,7
2,00:01:05,3,False,0,13,-13,34,5,7
3,00:13:27,3,False,0,16,-16,32,1,7
3,00:11:56,3,False,0,16,-16,22,11,7
3,00:10:17,3,True,16,0,16,54,22,7
3,00:09:06,3,True,16,0,16,24,5,7
3,00:04:31,3,False,0,16,-16,55,20,7
4,00:10:03,3,False,0,30,-30,36,10,7
4,00:03:33,3,False,0,37,-37,46,4,7
1,00:13:59,3,True,0,0,0,50,3,7
1,00:05:57,3,True,3,3,0,39,17,7
2,00:11:57,3,True,10,3,7,40,7,7
2,00:03:26,3,False,6,13,-7,27,3,7
3,00:12:16,3,False,6,20,-14,42,32,7
3,00:10:21,3,True,20,6,14,34,4,7
3,00:09:02,3,True,20,13,7,26,8,7
3,00:07:43,3,False,13,20,-7,51,9,7
3,00:02:42,3,False,13,23,-10,41,4,7
4,00:07:53,3,False,27,26,1,45,10,7
1,00:06:40,3,False,1,0,1,54,3,7
2,00:13:33,3,False,8,7,1,21,28,7
2,00:10:09,3,False,8,14,-6,42,6,7
2,00:09:05,3,True,14,8,6,30,10,7
2,00:06:24,3,True,14,11,3,43,2,7
2,00:00:53,3,True,14,14,0,30,15,7
4,00:00:52,3,True,24,37,-13,44,9,7
1,00:10:42,3,False,0,3,-3,17,6,7
1,00:06:23,3,False,0,10,-10,50,9,7
1,00:05:16,3,True,10,0,10,9,21,7
1,00:00:43,3,True,10,3,7,45,7,7
2,00:03:17,3,True,17,19,-2,27,19,7
2,00:01:50,3,True,17,26,-9,38,1,7
2,00:01:09,3,False,26,17,9,32,11,7
3,00:13:59,3,False,26,17,9,28,19,7
3,00:09:27,3,True,17,29,-12,50,10,7
3,00:06:23,3,False,29,17,12,53,10,7
4,00:04:06,3,True,20,32,-12,47,15,7
1,00:12:35,3,False,0,0,0,46,20,7
2,00:01:58,3,True,14,6,8,54,16,7
2,00:00:55,3,True,14,6,8,28,6,7
3,00:13:41,3,True,14,6,8,37,9,7
4,00:03:58,3,False,12,24,-12,50,5,7
1,00:14:08,3,False,0,0,0,36,10,7
1,00:07:44,3,True,1,0,1,45,3,7
1,00:06:35,3,True,1,0,1,12,10,7
2,00:02:41,3,False,1,15,-14,35,10,7
2,00:00:15,3,True,15,1,14,52,10,7
3,00:14:20,3,True,15,1,14,39,10,7
3,00:04:02,3,False,4,22,-18,53,10,7
3,00:02:24,3,False,4,22,-18,19,4,7
4,00:08:46,3,True,22,19,3,39,17,7
4,00:02:45,3,True,22,27,-5,22,10,7
2,00:15:00,3,False,3,3,0,47,18,7
2,00:05:14,3,True,6,10,-4,46,4,7
2,00:00:15,3,False,17,6,11,46,4,7
3,00:09:19,3,True,8,17,-9,34,10,7
4,00:11:15,3,True,15,27,-12,44,8,7
4,00:08:22,3,False,27,15,12,55,3,7
4,00:00:26,3,False,30,28,2,23,13,7
1,00:08:19,3,False,7,0,7,47,11,7
1,00:02:45,3,True,0,8,-8,38,7,7
2,00:12:08,3,True,3,8,-5,43,10,7
2,00:05:26,3,True,3,15,-12,46,4,7
2,00:03:07,3,False,15,3,12,54,20,7
3,00:04:34,3,False,22,16,6,50,4,7
3,00:01:09,3,True,16,22,-6,54,13,7
4,00:05:21,3,True,19,30,-11,30,3,7
1,00:10:05,3,False,0,3,-3,42,4,7
1,00:08:33,3,True,3,0,3,34,1,7
2,00:01:09,3,False,16,17,-1,48,3,7
2,00:00:32,3,False,16,17,-1,26,7,7
3,00:13:49,3,True,17,16,1,45,6,7
3,00:11:43,3,False,16,17,-1,40,10,7
3,00:08:33,3,True,17,16,1,39,17,7
3,00:00:59,3,False,17,17,0,12,13,7
4,00:13:35,3,False,17,17,0,10,6,7
4,00:12:06,3,False,17,17,0,47,4,7
1,00:10:44,3,True,0,0,0,53,7,7
1,00:09:10,3,False,0,0,0,20,12,7
1,00:04:12,3,False,0,3,-3,53,10,7
1,00:00:50,3,True,3,0,3,50,12,7
2,00:13:13,3,True,3,0,3,40,14,7
2,00:01:07,3,True,3,15,-12,48,11,7
3,00:07:29,3,False,23,10,13,54,14,7
3,00:06:23,3,False,23,10,13,31,3,7
3,00:05:00,3,True,10,23,-13,41,11,7
4,00:14:25,3,False,25,10,15,49,10,7
4,00:13:20,3,True,10,25,-15,34,10,7
4,00:11:38,3,False,25,10,15,34,14,7
1,00:09:33,3,True,0,7,-7,41,10,7
1,00:01:00,3,True,0,21,-21,43,10,7
3,00:02:41,3,True,3,32,-29,48,10,7
3,00:01:07,3,False,32,3,29,37,1,7
4,00:13:02,3,False,32,10,22,26,6,7
4,00:02:49,3,True,13,35,-22,33,12,7
1,00:10:54,3,False,0,7,-7,25,9,7
1,00:03:03,3,False,0,13,-13,40,14,7
2,00:08:06,3,False,7,16,-9,47,2,7
2,00:06:06,3,False,7,16,-9,38,5,7
2,00:01:50,3,False,7,23,-16,46,10,7
3,00:11:05,3,True,26,10,16,35,10,7
3,00:06:32,3,True,26,17,9,45,6,7
3,00:04:53,3,False,17,26,-9,49,10,7
3,00:03:25,3,True,26,17,9,9,20,7
4,00:14:45,3,True,26,20,6,51,8,7
4,00:12:56,3,False,20,26,-6,25,8,7
4,00:11:46,3,True,26,20,6,55,6,7
2,00:08:23,3,True,3,21,-18,46,10,7
2,00:07:13,3,False,21,3,18,31,9,7
2,00:05:55,3,True,3,21,-18,48,2,7
2,00:01:07,3,True,3,31,-28,41,10,7
2,00:00:29,3,False,31,3,28,32,3,7
3,00:13:31,3,False,31,3,28,38,10,7
3,00:11:55,3,False,31,3,28,54,4,7
3,00:10:25,3,False,31,3,28,30,5,7
4,00:13:32,3,True,3,39,-36,25,10,7
1,00:09:25,3,False,3,0,3,54,8,7
2,00:05:51,3,True,7,10,-3,53,10,7
2,00:04:17,3,True,7,10,-3,37,2,7
3,00:10:15,3,False,17,7,10,55,14,7
3,00:04:36,3,True,7,17,-10,22,1,7
4,00:14:05,3,False,24,8,16,35,10,7
4,00:02:12,3,True,18,34,-16,54,12,7
1,00:08:39,3,False,0,3,-3,38,7,7
2,00:13:33,3,False,3,17,-14,49,13,7
2,00:09:13,3,False,3,18,-15,54,10,7
2,00:06:57,3,False,3,18,-15,46,6,7
2,00:01:02,3,False,4,25,-21,38,10,7
2,00:00:29,3,False,4,25,-21,54,3,7
3,00:00:43,3,True,35,11,24,32,1,7
4,00:15:00,3,False,11,35,-24,43,17,7
4,00:11:22,3,False,11,38,-27,40,5,7
4,00:10:04,3,True,38,11,27,44,3,7
4,00:08:58,3,False,11,38,-27,27,10,7
4,00:07:44,3,True,38,11,27,39,4,7
4,00:04:51,3,False,11,38,-27,43,8,7
1,00:11:27,3,True,0,0,0,51,7,7
1,00:04:56,3,False,3,7,-4,39,11,7
2,00:02:54,3,True,8,7,1,55,10,7
2,00:02:00,3,False,7,8,-1,43,10,7
3,00:03:55,3,True,9,11,-2,39,11,7
4,00:00:41,3,False,21,21,0,34,10,7
1,00:06:30,3,False,0,3,-3,15,10,7
2,00:00:27,3,False,11,19,-8,16,10,7
3,00:14:08,3,False,11,19,-8,30,10,7
3,00:12:16,3,False,11,19,-8,52,10,7
3,00:10:58,3,False,11,19,-8,10,3,7
3,00:03:46,3,True,26,18,8,17,8,7
3,00:02:23,3,False,18,26,-8,54,12,7
4,00:03:54,3,True,33,26,7,50,8,7
4,00:02:03,3,True,33,26,7,32,19,7
1,00:09:57,3,False,0,7,-7,55,5,7
1,00:07:21,3,False,0,7,-7,26,18,7
2,00:13:48,3,False,7,14,-7,55,11,7
2,00:11:53,3,True,14,7,7,21,3,7
2,00:02:21,3,False,16,21,-5,38,6,7
2,00:01:24,3,False,16,21,-5,47,4,7
2,00:00:28,3,False,16,21,-5,32,4,7
3,00:12:59,3,False,16,21,-5,42,11,7
3,00:11:32,3,True,21,16,5,26,15,7
3,00:10:32,3,False,16,21,-5,49,10,7
3,00:07:53,3,True,21,16,5,35,5,7
3,00:06:53,3,False,16,21,-5,38,10,7
3,00:02:18,3,True,21,19,2,55,4,7
3,00:01:02,3,False,19,21,-2,29,6,7
4,00:10:15,3,True,24,19,5,49,22,7
1,00:11:12,3,True,0,0,0,47,1,7
1,00:05:50,3,True,0,3,-3,29,16,7
1,00:04:55,3,False,3,0,3,31,25,7
2,00:08:16,3,False,3,14,-11,29,6,7
2,00:05:55,3,False,3,14,-11,40,5,7
2,00:00:01,1,True,14,3,11,53,10,7
3,00:11:43,3,True,14,4,10,32,13,7
3,00:10:16,3,False,4,14,-10,47,9,7
3,00:08:43,3,True,14,4,10,27,2,7
3,00:07:32,3,False,4,14,-10,43,7,7
3,00:05:54,3,True,14,4,10,9,13,7
3,00:00:10,3,False,9,14,-5,50,2,7
4,00:05:17,3,False,9,14,-5,47,6,7
1,00:06:07,3,False,3,7,-4,47,3,7
1,00:00:49,3,True,7,6,1,43,2,7
2,00:06:56,3,True,14,9,5,47,3,7
3,00:13:48,3,False,16,17,-1,42,9,7
3,00:08:39,3,False,16,24,-8,20,15,7
3,00:06:41,3,False,16,24,-8,42,10,7
3,00:01:21,3,False,16,33,-17,54,11,7
4,00:09:34,3,True,33,17,16,32,13,7
1,00:09:43,3,True,0,3,-3,36,9,7
1,00:07:20,3,False,3,0,3,40,8,7
1,00:02:20,3,False,3,0,3,40,7,7
2,00:12:06,3,False,10,0,10,29,8,7
2,00:01:52,3,False,10,14,-4,33,10,7
4,00:14:41,3,False,24,23,1,53,6,7
4,00:06:47,3,True,26,31,-5,45,7,7
4,00:05:48,3,False,31,26,5,36,7,7
4,00:01:25,3,True,27,31,-4,54,8,7
1,00:13:52,3,False,0,0,0,25,20,7
1,00:02:25,3,True,0,12,-12,20,19,7
1,00:01:18,3,True,0,12,-12,50,8,7
2,00:15:00,3,True,0,12,-12,16,10,7
2,00:01:08,3,True,7,15,-8,25,12,7
3,00:01:27,3,False,28,24,4,45,7,7
4,00:05:17,3,False,38,33,5,30,15,7
4,00:03:08,3,False,38,36,2,33,12,7
4,00:02:14,3,False,38,36,2,22,5,7
1,00:06:52,3,True,7,0,7,51,2,7
1,00:04:40,3,True,7,2,5,53,8,7
2,00:11:11,3,True,7,7,0,27,8,7
2,00:05:45,3,True,7,14,-7,50,9,7
2,00:04:03,3,False,14,7,7,27,7,7
2,00:00:22,3,False,21,14,7,46,4,7
3,00:12:14,3,False,21,14,7,18,2,7
3,00:10:41,3,False,21,14,7,51,9,7
3,00:07:39,3,False,21,14,7,45,11,7
3,00:04:08,3,True,14,21,-7,37,24,7
4,00:09:26,3,True,14,29,-15,38,3,7
4,00:08:02,3,False,29,14,15,44,9,7
2,00:11:47,3,True,9,1,8,40,10,7
2,00:02:15,3,False,1,16,-15,35,6,7
3,00:09:27,3,False,8,23,-15,39,4,7
4,00:12:48,3,False,11,24,-13,43,6,7
4,00:04:11,3,False,18,24,-6,48,14,7
1,00:10:28,3,False,0,7,-7,40,5,7
3,00:14:09,3,True,24,6,18,29,17,7
3,00:08:07,3,False,7,24,-17,44,18,7
3,00:05:25,3,False,7,24,-17,30,9,7
3,00:03:43,3,False,7,24,-17,43,7,7
4,00:12:05,3,True,27,7,20,16,3,7
4,00:10:05,3,True,27,14,13,48,1,7
4,00:05:56,3,False,14,27,-13,21,16,7
1,00:08:33,3,True,3,3,0,26,19,7
1,00:05:51,3,True,3,3,0,35,1,7
1,00:04:20,3,False,3,3,0,33,4,7
1,00:02:45,3,True,3,3,0,28,16,7
2,00:08:28,3,False,6,10,-4,40,6,7
2,00:02:24,3,True,10,9,1,40,5,7
4,00:14:34,3,False,22,24,-2,44,10,7
1,00:13:04,3,True,0,0,0,45,6,7
1,00:10:03,3,True,0,0,0,30,9,7
1,00:08:13,3,False,0,0,0,43,8,7
1,00:06:10,3,True,0,0,0,45,2,7
1,00:04:57,3,True,0,0,0,16,4,7
2,00:15:00,3,False,3,0,3,35,10,7
2,00:08:19,3,True,3,10,-7,36,10,7
3,00:10:46,3,False,20,10,10,20,6,7
3,00:09:15,3,False,20,10,10,50,4,7
3,00:04:50,3,False,20,10,10,55,7,7
3,00:02:35,3,True,10,20,-10,43,10,7
1,00:02:32,3,True,3,3,0,25,10,7
2,00:15:00,3,True,3,10,-7,34,7,7
2,00:10:15,3,True,3,17,-14,37,2,7
2,00:08:52,3,False,17,3,14,30,13,7
3,00:07:30,3,False,23,10,13,46,11,7
3,00:05:54,3,True,10,23,-13,33,10,7
3,00:04:34,3,False,23,10,13,36,3,7
4,00:07:42,3,False,23,17,6,50,13,7
4,00:06:32,3,False,23,17,6,22,2,7
1,00:13:51,3,False,0,0,0,43,4,7
1,00:07:33,3,True,0,7,-7,38,10,7
2,00:05:55,3,False,7,27,-20,47,5,7
2,00:03:55,3,True,27,7,20,45,6,7
2,00:01:53,3,False,7,28,-21,38,8,7
3,00:05:56,3,True,31,14,17,26,7,7
3,00:04:22,3,True,31,14,17,47,6,7
3,00:00:28,3,True,31,14,17,55,13,7
4,00:14:23,3,False,14,31,-17,34,2,7
4,00:01:19,3,False,14,35,-21,35,10,7
4,00:00:39,3,True,35,14,21,48,7,7
1,00:11:21,3,False,0,0,0,25,28,7
1,00:10:18,3,False,0,0,0,50,4,7
1,00:08:38,3,False,0,0,0,29,4,7
1,00:05:30,3,False,0,7,-7,18,26,7
1,00:00:04,3,True,14,0,14,31,10,7
2,00:07:47,3,True,21,3,18,48,8,7
2,00:05:08,3,True,21,3,18,41,10,7
2,00:03:50,3,False,3,21,-18,43,2,7
2,00:02:27,3,False,3,24,-21,38,7,7
3,00:02:31,3,True,34,3,31,40,7,7
4,00:10:12,3,True,34,5,29,52,4,7
4,00:01:23,3,True,36,5,31,25,6,7
1,00:13:16,3,True,0,0,0,52,3,7
1,00:11:45,3,True,0,0,0,52,10,7
1,00:07:59,3,False,0,7,-7,24,10,7
3,00:14:00,3,False,17,21,-4,48,11,7
3,00:09:37,3,False,17,21,-4,25,6,7
3,00:04:54,3,False,17,24,-7,35,10,7
4,00:13:18,3,True,27,20,7,50,8,7
1,00:13:25,3,True,0,7,-7,35,10,7
1,00:12:02,3,False,7,0,7,55,10,7
1,00:10:43,3,True,0,7,-7,24,4,7
1,00:04:52,3,False,10,0,10,28,2,7
2,00:12:13,3,True,1,12,-11,35,4,7
2,00:09:00,3,True,1,12,-11,45,6,7
2,00:07:07,3,False,12,1,11,52,6,7
2,00:05:53,3,True,1,12,-11,39,10,7
3,00:12:00,3,False,15,22,-7,35,9,7
3,00:10:25,3,True,22,15,7,50,10,7
3,00:09:23,3,False,15,22,-7,24,12,7
3,00:00:35,3,True,29,15,14,45,15,7
1,00:11:24,3,False,0,0,0,53,8,7
1,00:03:05,3,True,0,14,-14,49,3,7
2,00:02:33,3,True,0,16,-16,48,6,7
3,00:13:52,3,False,16,3,13,43,9,7
3,00:04:00,3,False,23,10,13,47,3,7
3,00:00:04,3,False,23,10,13,47,4,7
4,00:00:43,3,False,24,27,-3,47,5,7
1,00:07:18,3,False,3,0,3,40,6,7
1,00:01:59,3,False,3,3,0,42,3,7
1,00:00:36,3,True,3,3,0,30,6,7
2,00:14:41,3,False,3,3,0,14,25,7
2,00:09:34,3,True,10,3,7,48,7,7
2,00:06:24,3,True,10,6,4,35,10,7
2,00:04:59,3,False,6,10,-4,55,19,7
2,00:02:40,3,True,10,6,4,27,9,7
4,00:14:40,3,True,19,18,1,44,22,7
4,00:13:04,3,False,18,19,-1,26,5,7
4,00:09:20,3,False,18,22,-4,44,1,7
4,00:07:59,3,True,22,18,4,31,6,7
1,00:14:04,3,True,0,0,0,37,17,7
1,00:00:45,3,False,0,10,-10,37,8,7
2,00:14:12,3,True,10,0,10,51,12,7
2,00:02:07,3,True,11,15,-4,32,13,7
2,00:01:13,3,False,15,11,4,49,3,7
2,00:00:28,3,True,11,15,-4,20,14,7
3,00:13:22,3,False,15,11,4,48,4,7
3,00:05:02,3,False,15,17,-2,36,8,7
3,00:02:55,3,False,15,17,-2,17,10,7
3,00:01:35,3,False,15,17,-2,53,11,7
4,00:13:30,3,False,15,19,-4,52,3,7
4,00:11:51,3,True,19,15,4,34,10,7
1,00:07:02,3,True,0,3,-3,53,8,7
2,00:12:14,3,False,4,7,-3,43,10,7
2,00:11:11,3,False,4,7,-3,15,7,7
2,00:06:48,3,False,4,10,-6,50,6,7
2,00:02:09,3,False,4,17,-13,47,8,7
2,00:00:57,3,True,17,4,13,33,12,7
2,00:00:19,3,False,4,17,-13,23,28,7
3,00:13:41,3,True,17,4,13,35,13,7
3,00:12:39,3,False,4,17,-13,45,5,7
3,00:10:42,3,True,17,4,13,44,5,7
3,00:07:43,2,False,4,17,-13,54,11,7
3,00:05:35,3,True,17,4,13,26,10,7
3,00:01:06,3,False,7,17,-10,50,2,7
4,00:09:39,3,False,7,20,-13,32,13,7
4,00:05:24,3,False,7,23,-16,40,5,7
4,00:04:07,3,True,23,7,16,37,5,7
4,00:03:00,3,False,7,23,-16,46,4,7
1,00:13:56,3,True,0,0,0,30,7,7
1,00:11:00,3,False,0,0,0,52,5,7
1,00:05:39,3,True,3,0,3,24,10,7
1,00:00:01,3,True,3,3,0,41,6,7
2,00:03:34,3,False,10,6,4,51,12,7
2,00:02:13,3,True,6,10,-4,14,10,7
3,00:11:16,3,True,6,20,-14,52,10,7
3,00:07:08,3,True,6,27,-21,42,2,7
3,00:05:40,3,False,27,6,21,32,4,7
4,00:10:41,3,False,30,7,23,37,8,7
4,00:05:45,3,False,30,7,23,13,2,7
4,00:02:57,3,True,7,37,-30,45,4,7
4,00:01:05,3,True,7,37,-30,43,8,7
1,00:14:09,3,False,0,0,0,47,6,7
1,00:13:09,3,True,0,0,0,13,10,7
1,00:09:41,3,True,0,0,0,30,7,7
2,00:12:59,3,True,3,10,-7,36,5,7
2,00:08:55,3,True,3,10,-7,52,2,7
2,00:02:09,3,True,10,13,-3,43,2,7
2,00:01:31,3,False,13,10,3,24,3,7
2,00:00:01,3,False,13,10,3,52,6,7
3,00:03:17,3,True,13,16,-3,38,7,7
4,00:01:06,3,True,26,23,3,33,5,7
1,00:12:26,3,False,0,0,0,53,17,7
2,00:10:55,3,True,0,2,-2,40,5,7
2,00:01:32,3,True,0,2,-2,45,6,7
3,00:10:01,3,True,3,2,1,51,10,7
3,00:08:51,3,False,2,3,-1,20,9,7
4,00:15:00,3,False,9,6,3,15,8,7
4,00:13:29,3,True,6,9,-3,48,5,7
4,00:12:29,3,False,9,6,3,51,3,7
4,00:11:29,3,True,6,9,-3,23,10,7
4,00:07:54,3,True,6,10,-4,46,10,7
4,00:05:58,3,True,6,10,-4,50,10,7
1,00:11:47,3,False,0,0,0,48,4,7
1,00:06:07,3,True,0,0,0,54,4,7
3,00:09:10,3,True,16,24,-8,35,6,7
3,00:05:19,3,True,16,24,-8,51,21,7
4,00:10:29,3,False,25,23,2,55,5,7
4,00:03:07,3,True,26,25,1,48,6,7
1,00:10:46,3,True,0,0,0,44,9,7
1,00:08:18,3,False,0,0,0,38,9,7
2,00:01:47,3,True,6,22,-16,47,10,7
2,00:01:10,3,False,22,6,16,35,4,7
3,00:12:00,3,False,22,6,16,32,8,7
3,00:04:46,3,True,13,22,-9,42,10,7
3,00:02:14,3,False,22,13,9,38,1,7
3,00:00:52,3,True,13,22,-9,43,6,7
4,00:06:14,3,True,13,25,-12,46,10,7
1,00:06:39,3,False,3,7,-4,26,18,7
1,00:05:12,3,True,7,3,4,46,5,7
2,00:12:15,3,False,10,14,-4,24,10,7
2,00:10:15,3,True,14,10,4,48,6,7
2,00:08:14,3,False,10,14,-4,30,1,7
3,00:09:31,3,True,24,24,0,55,3,7
3,00:05:44,3,False,24,24,0,31,6,7
3,00:04:39,3,True,24,24,0,44,5,7
4,00:13:42,3,True,24,27,-3,55,10,7
4,00:07:13,3,True,24,27,-3,40,2,7
1,00:14:00,3,False,0,0,0,49,1,7
1,00:12:54,3,True,0,0,0,18,17,7
1,00:04:45,3,False,3,7,-4,48,10,7
1,00:01:55,3,True,7,3,4,31,11,7
1,00:00:53,3,False,3,7,-4,42,10,7
2,00:06:15,3,False,3,17,-14,14,4,7
3,00:13:39,3,False,6,31,-25,36,5,7
3,00:12:01,3,False,6,31,-25,53,5,7
3,00:09:58,3,False,6,31,-25,40,10,7
3,00:08:38,3,True,31,6,25,44,2,7
3,00:01:35,3,True,31,13,18,45,10,7
4,00:13:52,3,True,31,16,15,44,1,7
4,00:11:24,3,False,16,31,-15,45,4,7
1,00:00:39,3,False,7,3,4,42,10,7
2,00:04:33,3,False,14,10,4,36,12,7
2,00:02:38,3,False,14,13,1,35,2,7
2,00:00:54,3,False,14,13,1,36,7,7
3,00:12:26,3,True,13,14,-1,35,12,7
3,00:08:44,3,False,14,13,1,35,5,7
3,00:07:50,3,True,13,14,-1,27,10,7
3,00:04:44,3,True,13,14,-1,12,10,7
3,00:03:31,3,True,13,14,-1,52,10,7
3,00:02:13,3,True,13,14,-1,17,9,7
4,00:14:44,3,True,13,17,-4,29,10,7
4,00:13:01,3,False,17,13,4,36,14,7
1,00:11:55,3,True,0,0,0,46,13,7
1,00:09:52,3,True,0,0,0,27,2,7
1,00:08:45,3,False,0,0,0,46,5,7
2,00:15:00,3,True,7,3,4,55,1,7
2,00:11:31,3,False,3,7,-4,49,5,7
2,00:10:39,3,False,3,7,-4,20,10,7
2,00:09:53,3,False,3,7,-4,52,10,7
2,00:08:03,3,False,3,7,-4,35,1,7
3,00:10:02,3,False,4,10,-6,45,16,7
3,00:08:55,3,False,4,10,-6,24,4,7
3,00:04:06,3,False,4,11,-7,36,9,7
3,00:00:03,3,False,4,11,-7,20,15,7
4,00:14:11,3,True,11,4,7,44,15,7
4,00:13:00,3,False,4,11,-7,28,10,7
4,00:11:37,3,True,11,4,7,40,26,7
4,00:06:54,3,True,11,4,7,40,7,7
4,00:01:40,3,True,11,11,0,51,7,7
1,00:14:06,3,False,0,0,0,40,3,7
1,00:13:06,3,True,0,0,0,41,4,7
2,00:12:55,3,True,7,7,0,37,10,7
2,00:11:24,3,False,7,7,0,43,3,7
2,00:09:33,2,True,7,7,0,35,13,7
2,00:02:41,3,True,7,10,-3,39,10,7
4,00:08:23,3,False,23,21,2,50,10,7
4,00:07:17,3,False,23,21,2,13,16,7
4,00:04:00,3,False,23,28,-5,40,10,7
4,00:02:41,3,True,28,23,5,24,12,7
4,00:01:52,3,False,23,28,-5,33,9,7
4,00:00:31,3,True,28,23,5,47,5,7
1,00:13:49,3,False,0,0,0,37,9,7
1,00:12:05,3,False,0,7,-7,39,9,7
1,00:08:09,3,False,0,7,-7,37,0,7
1,00:02:33,3,False,0,10,-10,42,1,7
1,00:01:07,3,True,10,0,10,15,10,7
2,00:07:58,3,True,10,14,-4,23,9,7
2,00:04:57,3,True,10,14,-4,48,10,7
2,00:01:21,3,True,10,14,-4,41,4,7
2,00:00:40,3,False,14,10,4,29,4,7
3,00:13:29,3,False,14,10,4,50,18,7
3,00:09:10,3,True,10,21,-11,31,2,7
3,00:06:21,3,True,10,21,-11,40,4,7
4,00:14:00,3,False,21,17,4,44,17,7
4,00:12:01,3,True,17,21,-4,43,5,7
4,00:10:00,3,False,21,17,4,33,18,7
4,00:06:29,3,True,17,21,-4,38,12,7
4,00:02:33,3,True,17,21,-4,45,3,7
1,00:06:40,3,True,7,0,7,46,3,7
1,00:03:58,3,False,0,7,-7,20,15,7
3,00:08:57,3,True,17,10,7,31,1,7
4,00:03:42,3,True,17,20,-3,37,10,7
4,00:01:19,3,False,20,20,0,38,18,7
1,00:05:02,3,False,3,7,-4,28,17,7
2,00:08:01,3,True,21,6,15,49,10,7
2,00:05:45,3,False,6,21,-15,27,10,7
2,00:01:38,3,True,21,6,15,38,10,7
3,00:13:01,3,False,13,21,-8,54,10,7
3,00:06:31,3,True,28,13,15,49,21,7
3,00:00:42,3,False,13,35,-22,36,3,7
4,00:13:18,3,True,35,13,22,28,15,7
4,00:07:24,3,False,16,35,-19,50,5,7
4,00:02:13,3,False,23,38,-15,29,16,7
4,00:00:44,3,False,23,41,-18,26,19,7
1,00:13:40,3,False,0,0,0,48,5,7
1,00:11:12,3,False,0,0,0,47,10,7
1,00:10:01,3,False,0,0,0,23,1,7
1,00:06:00,3,False,0,1,-1,43,2,7
1,00:04:44,3,True,1,0,1,29,5,7
2,00:03:28,3,False,15,4,11,45,9,7
2,00:02:38,3,False,15,4,11,22,6,7
3,00:13:57,3,True,7,22,-15,36,14,7
3,00:04:53,3,False,23,10,13,41,5,7
3,00:03:28,3,True,10,23,-13,32,7,7
4,00:09:13,3,False,26,10,16,44,13,7
4,00:07:56,3,True,10,26,-16,44,7,7
4,00:06:00,3,False,26,10,16,45,9,7
4,00:00:32,3,False,26,10,16,55,9,7
1,00:13:28,3,True,0,0,0,32,11,7
1,00:11:15,3,False,0,0,0,22,19,7
1,00:07:04,3,True,0,0,0,47,25,7
1,00:02:02,3,True,0,0,0,54,9,7
1,00:01:08,3,False,0,0,0,13,10,7
2,00:12:04,3,True,7,0,7,30,13,7
3,00:11:07,3,True,14,9,5,47,21,7
3,00:04:43,3,False,16,14,2,50,9,7
4,00:12:41,3,False,16,14,2,25,10,7
4,00:11:40,3,True,14,16,-2,53,10,7
4,00:09:01,3,True,14,16,-2,27,8,7
4,00:06:51,3,False,16,14,2,54,6,7
4,00:05:37,3,True,14,16,-2,33,1,7
1,00:12:59,3,False,0,0,0,48,9,7
1,00:11:36,3,True,0,0,0,29,18,7
1,00:08:21,3,False,0,7,-7,45,10,7
1,00:05:20,3,False,0,14,-14,51,10,7
2,00:08:02,3,True,18,3,15,41,4,7
3,00:06:25,3,False,13,24,-11,20,4,7
3,00:00:32,3,False,13,31,-18,52,5,7
4,00:09:51,3,False,13,37,-24,43,2,7
4,00:06:15,3,False,13,37,-24,43,8,7
4,00:04:30,3,False,13,37,-24,16,19,7
4,00:01:58,3,False,13,37,-24,14,7,7
4,00:01:06,3,True,37,13,24,50,16,7
1,00:08:10,3,True,7,0,7,22,3,7
1,00:02:33,3,False,0,14,-14,18,20,7
2,00:13:04,3,False,0,17,-17,48,7,7
2,00:08:43,3,False,0,17,-17,28,8,7
2,00:05:56,3,False,0,17,-17,47,5,7
2,00:00:46,3,False,7,24,-17,38,12,7
3,00:14:06,3,False,7,24,-17,32,5,7
4,00:05:42,3,False,14,45,-31,34,26,7
4,00:03:33,3,True,45,14,31,33,2,7
2,00:12:36,3,True,11,0,11,45,10,7
2,00:10:30,3,False,0,11,-11,25,19,7
2,00:08:14,3,False,0,11,-11,41,6,7
2,00:07:15,3,False,0,11,-11,8,10,7
2,00:06:04,3,True,11,0,11,42,14,7
2,00:02:08,3,True,11,0,11,51,18,7
3,00:07:52,3,True,14,0,14,39,11,7
4,00:11:46,3,False,1,22,-21,27,10,7
4,00:05:00,3,False,1,29,-28,22,20,7
4,00:02:42,3,False,1,29,-28,46,6,7
4,00:02:10,3,False,1,29,-28,18,10,7
4,00:01:31,3,False,1,29,-28,40,4,7
1,00:04:55,3,True,7,7,0,43,8,7
2,00:10:34,3,True,14,10,4,26,11,7
2,00:06:24,3,True,14,13,1,36,2,7
2,00:04:54,3,False,13,14,-1,37,6,7
3,00:13:45,3,False,13,17,-4,41,5,7
3,00:11:12,3,True,17,13,4,48,9,7
3,00:05:21,3,False,13,17,-4,25,10,7
4,00:12:30,3,True,17,20,-3,39,3,7
4,00:08:02,3,True,17,27,-10,38,19,7
4,00:05:59,3,False,27,17,10,41,20,7
4,00:02:46,3,False,27,20,7,43,2,7
4,00:00:38,3,False,27,20,7,40,3,7
1,00:10:10,3,False,0,3,-3,28,17,7
2,00:11:56,3,False,0,19,-19,37,1,7
2,00:04:08,3,False,1,21,-20,43,10,7
2,00:01:56,3,False,1,21,-20,22,13,7
2,00:00:26,3,True,24,1,23,54,5,7
3,00:13:36,3,False,1,24,-23,34,19,7
3,00:06:33,3,True,31,1,30,52,19,7
3,00:01:42,3,False,3,31,-28,48,7,7
4,00:05:46,3,True,31,10,21,12,3,7
4,00:02:37,3,True,31,10,21,16,26,7
4,00:01:58,3,False,10,31,-21,49,12,7
4,00:01:18,3,True,31,10,21,39,3,7
1,00:13:52,3,True,0,0,0,29,15,7
1,00:09:35,3,True,0,7,-7,12,17,7
2,00:11:32,3,False,21,7,14,49,6,7
2,00:01:50,3,True,14,21,-7,46,16,7
2,00:00:51,3,False,21,14,7,33,6,7
3,00:13:43,3,False,21,17,4,40,5,7
3,00:05:05,3,True,20,22,-2,38,7,7
3,00:03:59,3,False,22,20,2,33,10,7
4,00:15:00,3,True,20,25,-5,43,2,7
4,00:05:46,3,False,28,26,2,30,20,7
4,00:02:07,3,False,28,33,-5,32,23,7
1,00:13:45,3,True,0,0,0,34,5,7
1,00:08:05,3,True,0,0,0,42,6,7
1,00:06:14,3,False,0,7,-7,27,15,7
1,00:00:24,3,False,0,14,-14,24,20,7
2,00:02:06,3,False,0,17,-17,48,8,7
2,00:01:36,3,True,17,0,17,29,9,7
2,00:01:16,3,False,0,17,-17,30,17,7
3,00:08:14,3,True,20,3,17,23,10,7
3,00:02:57,3,False,3,20,-17,41,4,7
4,00:07:07,3,False,3,21,-18,49,11,7
1,00:13:33,3,False,0,0,0,25,13,7
1,00:10:43,3,False,0,0,0,42,10,7
2,00:15:00,3,True,7,7,0,48,7,7
2,00:12:09,3,False,7,7,0,45,3,7
2,00:11:08,3,False,7,7,0,15,15,7
2,00:06:40,3,False,7,10,-3,45,12,7
2,00:05:13,3,True,10,7,3,16,24,7
2,00:01:54,3,True,10,10,0,36,9,7
2,00:01:27,3,False,10,10,0,28,10,7
3,00:14:16,3,True,10,10,0,23,4,7
3,00:04:30,3,True,13,17,-4,42,5,7
3,00:02:11,3,False,17,13,4,48,10,7
3,00:01:02,3,True,13,17,-4,28,6,7
4,00:03:57,3,False,24,22,2,33,23,7
1,00:14:01,3,True,0,0,0,35,3,7
1,00:04:43,3,True,7,0,7,18,7,7
1,00:02:18,3,True,7,0,7,42,8,7
2,00:09:01,3,False,0,17,-17,44,7,7
2,00:07:44,3,True,17,0,17,28,13,7
2,00:02:35,3,False,1,17,-16,52,2,7
3,00:13:46,3,False,1,17,-16,44,2,7
3,00:07:32,3,False,1,24,-23,29,11,7
3,00:03:20,3,True,25,8,17,38,5,7
4,00:11:55,3,False,15,28,-13,54,18,7
4,00:06:40,3,False,15,34,-19,17,19,7
2,00:12:47,3,True,10,10,0,47,18,7
2,00:10:22,3,True,10,10,0,50,6,7
3,00:09:42,3,False,19,20,-1,41,16,7
3,00:08:14,3,True,20,19,1,30,10,7
4,00:09:43,3,False,22,30,-8,45,7,7
4,00:07:05,3,True,30,28,2,29,6,7
4,00:05:59,3,False,28,30,-2,42,6,7
1,00:12:15,3,True,0,0,0,44,6,7
1,00:11:25,3,False,0,0,0,31,10,7
1,00:10:02,3,True,0,0,0,35,4,7
1,00:00:16,3,False,0,1,-1,41,4,7
2,00:13:40,3,True,1,0,1,33,6,7
2,00:12:23,3,False,0,1,-1,32,22,7
2,00:11:34,3,True,1,0,1,35,10,7
2,00:09:43,3,False,0,1,-1,34,10,7
2,00:04:34,3,False,7,1,6,43,10,7
3,00:11:43,3,False,7,10,-3,29,16,7
3,00:05:32,3,False,7,11,-4,54,1,7
3,00:03:58,3,True,11,7,4,6,7,7
4,00:03:58,3,False,11,25,-14,45,10,7
4,00:02:24,3,True,25,11,14,45,9,7
4,00:01:39,3,True,27,11,16,34,11,7
1,00:03:51,3,False,3,6,-3,36,9,7
2,00:06:50,3,False,17,6,11,54,2,7
2,00:02:45,3,False,17,6,11,51,7,7
3,00:01:46,3,False,31,15,16,42,3,7
4,00:15:00,3,True,15,31,-16,31,11,7
4,00:01:52,3,True,15,34,-19,53,6,7
1,00:06:08,3,True,0,1,-1,10,20,7
1,00:01:01,3,True,0,4,-4,46,10,7
2,00:09:58,3,False,11,3,8,40,5,7
2,00:04:43,3,False,11,6,5,41,9,7
2,00:00:48,3,True,13,11,2,49,8,7
3,00:11:56,3,False,14,13,1,53,28,7
4,00:15:00,3,True,13,16,-3,29,9,7
4,00:10:13,3,True,13,19,-6,25,20,7
4,00:01:34,3,True,13,26,-13,25,20,7
4,00:00:51,3,True,13,26,-13,52,4,7
1,00:08:50,3,False,0,0,0,52,25,7
1,00:07:16,3,True,0,7,-7,31,7,7
1,00:04:12,3,False,7,0,7,6,18,7
1,00:02:55,3,True,0,7,-7,45,9,7
1,00:01:42,3,False,7,0,7,27,13,7
1,00:00:01,3,True,0,7,-7,51,1,7
2,00:06:49,3,True,0,10,-10,35,10,7
2,00:00:56,3,False,13,3,10,38,7,7
3,00:12:56,3,False,13,3,10,30,16,7
3,00:08:45,3,True,3,13,-10,47,4,7
3,00:01:29,3,False,13,3,10,20,8,7
4,00:06:01,3,True,3,23,-20,29,16,7
4,00:02:19,3,True,3,26,-23,30,15,7
1,00:07:42,3,False,3,0,3,10,7,7
1,00:03:20,3,False,3,3,0,36,5,7
1,00:02:06,3,True,3,3,0,48,10,7
2,00:02:43,3,False,7,6,1,45,10,7
3,00:13:22,3,True,9,7,2,38,18,7
3,00:08:55,3,False,7,9,-2,36,10,7
3,00:07:29,3,True,9,7,2,26,19,7
4,00:09:23,3,False,14,12,2,47,17,7
1,00:13:50,3,True,0,1,-1,40,5,7
1,00:12:16,3,True,0,1,-1,52,12,7
1,00:08:48,3,True,0,1,-1,51,12,7
1,00:07:37,3,True,0,1,-1,17,8,7
1,00:06:20,3,True,0,1,-1,49,9,7
2,00:15:00,3,True,0,4,-4,49,8,7
2,00:02:01,3,True,7,4,3,47,10,7
2,00:01:27,3,False,4,7,-3,20,3,7
3,00:11:50,3,True,7,4,3,45,10,7
3,00:08:51,3,True,7,4,3,53,9,7
3,00:06:46,3,False,4,7,-3,28,3,7
3,00:04:46,3,True,7,4,3,6,21,7
4,00:11:13,3,True,7,7,0,53,4,7
4,00:00:31,3,False,7,10,-3,43,4,7
1,00:11:00,3,False,0,3,-3,31,10,7
2,00:09:08,3,False,3,10,-7,45,4,7
2,00:00:57,3,False,3,20,-17,33,6,7
3,00:14:16,3,False,3,20,-17,25,9,7
3,00:11:10,3,False,3,20,-17,39,3,7
3,00:04:25,3,False,3,27,-24,22,25,7
3,00:03:28,3,True,27,3,24,50,4,7
4,00:10:00,3,False,3,41,-38,54,4,7
4,00:08:50,3,True,41,3,38,22,7,7
4,00:06:30,3,True,41,3,38,51,17,7
4,00:00:10,3,True,41,5,36,35,3,7
1,00:08:30,3,False,3,3,0,35,11,7
1,00:03:23,3,False,10,3,7,43,2,7
2,00:13:21,3,False,10,10,0,24,6,7
2,00:06:30,3,False,10,10,0,40,28,7
2,00:00:46,3,False,13,13,0,55,10,7
3,00:13:54,3,True,13,20,-7,37,6,7
3,00:12:29,3,False,20,13,7,29,6,7
3,00:10:38,3,True,13,20,-7,47,14,7
3,00:06:04,3,True,20,20,0,21,13,7
4,00:04:15,3,False,26,20,6,27,15,7
4,00:03:07,3,True,20,26,-6,46,10,7
4,00:02:08,3,False,26,20,6,28,7,7
4,00:01:40,3,True,20,26,-6,44,9,7
1,00:13:53,3,False,0,0,0,43,7,7
1,00:11:12,3,True,0,0,0,36,12,7
1,00:07:12,3,True,0,3,-3,33,2,7
2,00:14:49,3,False,6,0,6,50,11,7
2,00:08:23,3,True,0,9,-9,49,10,7
4,00:09:44,3,True,6,23,-17,24,20,7
4,00:08:12,3,False,23,6,17,47,15,7
4,00:04:44,3,True,6,23,-17,54,13,7
1,00:03:00,3,True,14,7,7,13,6,7
2,00:10:38,3,True,14,14,0,36,14,7
3,00:13:06,3,False,17,20,-3,50,10,7
3,00:11:56,3,True,20,17,3,25,2,7
3,00:05:18,2,False,20,23,-3,41,9,7
3,00:01:15,3,False,20,23,-3,17,7,7
3,00:00:13,3,False,20,23,-3,50,5,7
4,00:09:26,3,True,23,23,0,40,5,7
1,00:08:30,3,False,0,14,-14,34,4,7
1,00:00:09,3,True,14,6,8,28,17,7
2,00:14:31,3,False,6,14,-8,48,2,7
2,00:10:42,3,False,6,14,-8,37,2,7
2,00:09:38,3,True,14,6,8,38,2,7
2,00:07:44,3,False,6,14,-8,23,4,7
2,00:02:27,3,False,6,21,-15,42,13,7
3,00:13:51,3,True,28,6,22,39,7,7
3,00:00:18,3,False,9,31,-22,51,2,7
4,00:14:33,3,False,9,31,-22,15,5,7
4,00:05:58,3,True,37,9,28,29,11,7
1,00:09:40,3,True,0,3,-3,35,10,7
1,00:07:14,3,False,3,0,3,55,6,7
1,00:05:34,3,True,0,3,-3,13,15,7
2,00:11:43,3,False,6,6,0,55,7,7
2,00:07:59,3,False,6,6,0,18,8,7
2,00:06:26,3,True,6,6,0,52,9,7
2,00:01:00,3,True,6,13,-7,22,17,7
2,00:00:07,3,True,6,13,-7,52,11,7
3,00:06:17,3,False,20,13,7,27,14,7
3,00:05:06,3,True,13,20,-7,19,20,7
3,00:04:05,3,True,13,20,-7,53,10,7
4,00:12:45,3,False,20,20,0,30,9,7
4,00:02:37,3,False,20,29,-9,16,4,7
4,00:01:50,3,True,29,20,9,47,8,7
1,00:11:35,3,False,0,1,-1,42,3,7
2,00:09:14,3,True,5,3,2,43,12,7
2,00:08:10,3,False,3,5,-2,16,14,7
2,00:05:59,3,True,5,3,2,46,10,7
2,00:04:34,3,False,3,5,-2,23,10,7
2,00:02:15,3,True,5,3,2,25,10,7
3,00:10:15,3,False,17,5,12,48,12,7
3,00:08:20,3,False,17,5,12,22,10,7
3,00:06:12,3,False,17,5,12,39,10,7
3,00:04:42,3,True,5,17,-12,15,20,7
3,00:02:27,3,False,17,5,12,52,23,7
3,00:00:30,3,True,5,17,-12,23,12,7
4,00:06:12,3,True,5,21,-16,48,10,7
4,00:02:56,3,True,5,21,-16,11,22,7
1,00:13:57,3,True,0,0,0,31,3,7
1,00:11:25,3,False,0,0,0,48,2,7
1,00:09:09,3,True,0,0,0,50,6,7
1,00:06:49,3,False,0,0,0,42,6,7
1,00:01:35,3,False,7,7,0,27,8,7
1,00:00:21,3,True,7,7,0,43,10,7
2,00:12:30,3,False,7,7,0,39,1,7
2,00:11:28,3,True,7,7,0,36,1,7
2,00:07:12,3,True,7,10,-3,20,25,7
2,00:04:43,3,False,10,14,-4,47,5,7
3,00:12:25,3,False,10,21,-11,54,6,7
3,00:08:54,3,False,10,21,-11,55,10,7
4,00:15:00,3,True,21,13,8,47,2,7
4,00:04:19,3,False,19,24,-5,48,2,7
4,00:03:01,3,True,24,19,5,38,1,7
4,00:00:34,3,False,25,24,1,50,8,7
1,00:02:54,3,True,0,17,-17,48,5,7
2,00:11:15,3,False,24,0,24,48,13,7
3,00:11:46,3,False,32,7,25,55,10,7
3,00:10:15,3,True,7,32,-25,34,2,7
3,00:04:44,3,True,7,35,-28,45,14,7
3,00:03:36,3,False,35,7,28,32,2,7
4,00:13:12,3,False,35,7,28,41,0,7
4,00:02:59,3,True,14,38,-24,44,3,7
4,00:01:04,3,True,14,38,-24,27,13,7
1,00:06:45,3,True,0,3,-3,37,3,7
1,00:05:07,3,False,3,0,3,24,7,7
1,00:00:21,3,False,3,3,0,37,8,7
2,00:13:21,3,True,3,3,0,55,13,7
2,00:12:01,3,False,3,3,0,50,9,7
2,00:01:51,3,True,10,3,7,5,13,7
2,00:00:46,3,True,10,3,7,54,4,7
2,00:00:01,3,False,3,10,-7,29,4,7
3,00:13:36,3,False,3,10,-7,36,5,7
3,00:09:28,3,False,3,10,-7,51,10,7
3,00:06:38,3,False,3,10,-7,38,5,7
3,00:03:15,3,False,3,10,-7,43,15,7
4,00:02:57,3,True,17,16,1,54,4,7
1,00:13:55,3,True,0,0,0,30,9,7
2,00:02:03,3,True,8,27,-19,32,6,7
3,00:12:15,3,False,30,8,22,35,10,7
3,00:04:00,3,False,30,11,19,50,10,7
4,00:10:15,3,False,30,14,16,40,5,7
4,00:09:23,3,False,30,14,16,50,10,7
4,00:05:49,3,False,30,14,16,54,5,7
4,00:02:41,3,False,30,17,13,43,2,7
1,00:10:16,3,False,0,3,-3,36,9,7
1,00:04:03,3,False,3,10,-7,47,10,7
2,00:11:04,3,True,17,6,11,45,4,7
2,00:09:00,3,True,17,6,11,50,5,7
2,00:07:06,3,True,17,6,11,45,10,7
2,00:05:04,3,True,17,13,4,36,12,7
3,00:13:57,3,False,19,17,2,40,4,7
3,00:11:49,3,False,19,17,2,53,5,7
3,00:07:47,3,True,20,19,1,43,23,7
3,00:00:33,3,True,27,26,1,35,8,7
1,00:13:57,3,False,0,0,0,36,8,7
1,00:10:52,3,False,0,0,0,35,7,7
1,00:05:42,3,False,0,7,-7,28,1,7
1,00:02:34,3,False,0,7,-7,19,10,7
2,00:02:12,3,False,0,21,-21,31,6,7
3,00:12:03,3,False,7,28,-21,45,6,7
1,00:12:05,3,True,0,0,0,43,4,7
1,00:06:49,3,True,0,7,-7,44,6,7
1,00:04:18,3,True,0,7,-7,53,7,7
2,00:08:01,3,False,7,7,0,45,7,7
2,00:05:25,3,True,7,7,0,35,6,7
2,00:00:47,3,False,14,14,0,18,17,7
3,00:13:34,3,False,14,21,-7,24,2,7
3,00:11:10,3,True,21,14,7,54,4,7
3,00:05:15,3,False,21,21,0,40,8,7
4,00:11:44,3,False,21,28,-7,7,37,7
4,00:07:40,3,False,21,31,-10,33,12,7
4,00:00:49,3,True,38,21,17,40,4,7
1,00:05:55,3,True,1,0,1,55,6,7
2,00:05:38,3,False,4,8,-4,54,4,7
2,00:02:08,3,False,4,8,-4,11,7,7
2,00:01:30,3,True,8,4,4,51,11,7
3,00:06:35,3,True,8,4,4,54,10,7
3,00:02:41,3,True,8,7,1,41,4,7
4,00:13:58,3,False,7,8,-1,53,4,7
1,00:11:41,3,True,0,0,0,42,23,7
2,00:14:52,3,True,7,10,-3,47,8,7
2,00:11:52,3,True,7,10,-3,42,3,7
2,00:02:13,3,True,7,17,-10,50,14,7
2,00:00:55,3,False,17,7,10,51,10,7
2,00:00:13,3,False,17,7,10,53,10,7
4,00:13:10,3,True,17,20,-3,53,13,7
4,00:11:40,3,True,17,20,-3,13,8,7
4,00:02:51,3,True,20,23,-3,46,7,7
1,00:14:12,3,True,0,0,0,35,7,7
2,00:03:48,3,True,4,4,0,42,16,7
2,00:01:22,3,True,4,4,0,39,1,7
3,00:13:57,3,False,4,4,0,30,25,7
3,00:06:20,3,False,4,5,-1,51,3,7
3,00:03:41,3,False,4,5,-1,47,4,7
3,00:02:41,3,True,5,4,1,35,10,7
3,00:01:16,3,False,4,5,-1,24,8,7
4,00:12:53,3,True,12,4,8,45,6,7
1,00:13:58,3,False,0,0,0,50,3,7
1,00:06:53,3,True,0,7,-7,19,17,7
1,00:02:11,3,True,0,10,-10,53,9,7
1,00:00:01,3,False,10,0,10,27,20,7
2,00:10:13,3,False,10,3,7,36,9,7
2,00:04:52,3,False,10,6,4,42,8,7
2,00:03:34,3,True,6,10,-4,26,12,7
2,00:01:37,3,True,6,13,-7,32,13,7
3,00:13:56,3,True,9,13,-4,50,13,7
3,00:10:40,3,True,9,13,-4,46,1,7
3,00:07:41,3,True,9,13,-4,36,2,7
3,00:06:20,3,False,13,9,4,35,1,7
4,00:11:09,3,True,17,16,1,40,5,7
4,00:08:38,3,True,17,19,-2,28,8,7
4,00:02:22,3,False,26,17,9,51,6,7
1,00:13:58,3,True,0,0,0,37,4,7
1,00:12:29,3,False,0,0,0,39,5,7
1,00:11:22,3,True,0,0,0,28,7,7
1,00:10:00,3,False,0,0,0,37,16,7
1,00:04:23,3,False,0,1,-1,50,5,7
1,00:02:59,3,True,1,0,1,7,9,7
2,00:09:47,3,True,1,0,1,12,5,7
2,00:01:57,3,True,1,3,-2,39,7,7
3,00:05:25,3,True,8,6,2,55,2,7
4,00:12:30,3,False,13,11,2,35,10,7
1,00:12:56,3,False,0,0,0,31,16,7
1,00:10:09,3,True,0,0,0,52,7,7
2,00:15:00,3,False,7,7,0,16,19,7
2,00:14:10,3,False,7,7,0,49,10,7
2,00:10:24,3,False,7,14,-7,21,17,7
2,00:04:48,3,False,7,24,-17,25,13,7
2,00:02:27,3,False,7,24,-17,8,23,7
3,00:10:33,3,True,31,13,18,42,3,7
3,00:06:20,3,True,31,16,15,22,23,7
3,00:00:01,3,True,31,23,8,49,4,7
4,00:08:05,3,False,24,34,-10,38,7,7
4,00:07:14,3,True,34,24,10,22,10,7
4,00:04:38,3,True,34,24,10,41,7,7
4,00:00:45,3,False,27,34,-7,54,14,7
1,00:10:25,3,False,0,7,-7,52,3,7
1,00:01:56,3,True,7,7,0,15,2,7
2,00:09:26,3,False,8,7,1,39,2,7
2,00:02:36,3,False,8,7,1,32,10,7
2,00:01:43,3,False,8,7,1,54,7,7
2,00:00:49,3,False,8,7,1,47,10,7
3,00:02:38,3,True,7,11,-4,42,3,7
3,00:01:09,3,False,11,7,4,35,7,7
4,00:14:11,3,False,11,7,4,53,8,7
4,00:04:34,3,True,7,18,-11,30,15,7
4,00:00:41,3,False,32,7,25,45,26,7
1,00:10:45,3,False,0,3,-3,27,17,7
1,00:06:55,3,True,10,0,10,45,6,7
1,00:02:51,3,False,0,10,-10,43,10,7
2,00:13:34,3,True,10,3,7,35,6,7
2,00:11:18,3,True,10,3,7,47,6,7
3,00:14:04,3,False,9,13,-4,24,10,7
3,00:08:22,3,True,16,12,4,36,9,7
3,00:07:05,3,False,12,16,-4,37,9,7
4,00:11:38,3,False,19,16,3,53,4,7
4,00:09:04,3,False,19,16,3,47,10,7
4,00:06:18,3,False,19,16,3,21,19,7
4,00:04:53,3,False,19,16,3,43,5,7
4,00:01:49,3,True,16,20,-4,35,10,7
4,00:00:40,3,False,20,16,4,50,2,7
1,00:09:21,3,True,0,3,-3,53,7,7
1,00:08:08,3,False,3,0,3,31,4,7
2,00:12:01,3,False,3,8,-5,41,4,7
2,00:03:16,3,False,3,8,-5,17,24,7
3,00:08:37,3,True,9,3,6,46,6,7
3,00:07:12,3,False,3,9,-6,41,1,7
3,00:00:02,3,False,3,13,-10,35,10,7
4,00:12:08,3,False,3,13,-10,32,10,7
4,00:09:10,3,True,13,3,10,54,8,7
4,00:02:43,3,False,10,20,-10,49,20,7
4,00:02:24,3,True,20,10,10,35,2,7
4,00:00:28,3,True,20,10,10,29,10,7
1,00:06:00,3,True,0,7,-7,44,7,7
1,00:04:30,3,False,7,0,7,35,5,7
2,00:09:29,3,True,2,7,-5,50,5,7
2,00:03:42,3,False,7,11,-4,32,3,7
3,00:02:58,3,True,21,14,7,18,10,7
3,00:01:12,3,True,21,21,0,32,13,7
1,00:02:38,3,True,10,1,9,47,16,7
1,00:00:55,3,False,3,10,-7,48,7,7
2,00:12:49,3,True,10,3,7,22,17,7
2,00:08:16,3,True,10,3,7,45,13,7
2,00:07:05,3,False,3,10,-7,20,5,7
2,00:01:59,3,True,13,3,10,40,16,7
3,00:10:14,3,False,12,13,-1,48,18,7
3,00:08:03,3,False,12,13,-1,20,17,7
3,00:05:05,3,False,12,13,-1,36,9,7
3,00:01:18,3,False,12,13,-1,31,19,7
4,00:15:00,3,True,13,12,1,33,7,7
4,00:07:40,3,True,13,12,1,49,7,7
1,00:09:11,3,False,0,8,-8,20,25,7
1,00:05:42,3,True,8,7,1,36,1,7
1,00:00:42,3,False,7,8,-1,52,19,7
2,00:12:41,3,False,7,8,-1,50,8,7
2,00:02:33,3,True,15,10,5,35,10,7
2,00:01:27,3,False,10,15,-5,52,5,7
3,00:09:26,3,False,10,18,-8,43,2,7
3,00:08:05,3,True,18,10,8,36,8,7
3,00:05:39,3,False,10,18,-8,45,15,7
3,00:01:51,3,True,18,10,8,50,12,7
3,00:00:01,3,True,18,10,8,53,6,7
1,00:10:15,3,False,0,3,-3,41,15,7
1,00:08:45,3,True,3,0,3,32,9,7
1,00:06:36,3,False,0,3,-3,51,10,7
1,00:04:35,3,True,3,0,3,38,12,7
1,00:02:45,3,False,0,3,-3,39,4,7
2,00:15:00,3,True,3,0,3,55,3,7
2,00:13:16,3,False,0,3,-3,9,19,7
2,00:01:51,3,False,3,5,-2,52,15,7
3,00:13:15,3,False,6,5,1,40,8,7
3,00:12:08,3,True,5,6,-1,26,15,7
3,00:10:48,3,False,6,5,1,51,4,7
3,00:04:03,3,True,5,7,-2,37,8,7
3,00:01:07,3,True,5,7,-2,48,3,7
4,00:13:34,3,False,7,5,2,36,4,7
4,00:09:15,3,False,7,5,2,24,20,7
4,00:00:57,3,True,5,7,-2,42,17,7
1,00:12:06,3,False,0,0,0,52,4,7
1,00:05:01,3,True,0,3,-3,15,22,7
1,00:03:24,3,True,0,3,-3,45,4,7
1,00:00:35,3,True,0,3,-3,18,17,7
2,00:14:40,3,False,3,0,3,45,5,7
2,00:12:58,3,True,0,3,-3,43,10,7
2,00:01:34,3,True,7,17,-10,46,3,7
2,00:01:10,3,False,17,7,10,30,7,7
3,00:12:16,3,False,17,10,7,55,9,7
3,00:09:43,3,False,24,10,14,49,10,7
3,00:02:18,3,False,31,10,21,53,10,7
3,00:00:14,3,False,31,10,21,17,7,7
4,00:12:14,3,False,31,13,18,43,2,7
4,00:11:11,3,True,13,31,-18,21,10,7
4,00:09:44,3,True,13,31,-18,44,6,7
4,00:03:19,3,False,34,20,14,15,16,7
1,00:11:34,3,True,7,0,7,49,4,7
1,00:10:32,3,True,7,0,7,21,7,7
1,00:05:20,3,True,7,10,-3,25,12,7
2,00:08:44,3,False,17,7,10,50,7,7
2,00:06:01,3,True,7,17,-10,26,20,7
3,00:07:11,3,True,10,24,-14,41,5,7
3,00:03:06,3,False,24,17,7,47,4,7
4,00:13:29,3,False,24,24,0,32,3,7
4,00:12:23,3,False,24,31,-7,39,6,7
4,00:11:42,3,True,31,24,7,23,4,7
4,00:07:16,3,True,31,24,7,40,6,7
1,00:13:12,3,False,0,0,0,50,13,7
2,00:09:55,3,False,8,8,0,37,8,7
2,00:00:38,3,True,8,20,-12,25,15,7
3,00:00:01,3,True,16,30,-14,49,1,7
4,00:13:26,3,True,16,30,-14,38,6,7
4,00:12:16,3,False,30,16,14,31,11,7
4,00:08:28,3,True,17,30,-13,53,10,7
4,00:06:50,3,True,17,30,-13,37,10,7
4,00:05:27,3,False,30,17,13,41,6,7
4,00:01:01,3,False,30,24,6,41,12,7
1,00:14:09,3,False,0,0,0,38,10,7
1,00:13:01,3,True,0,0,0,29,7,7
1,00:11:49,3,False,0,0,0,36,15,7
1,00:05:46,3,True,2,0,2,42,17,7
1,00:04:05,3,False,0,2,-2,41,6,7
2,00:04:32,3,False,3,6,-3,43,2,7
2,00:00:50,3,True,6,3,3,6,9,7
3,00:11:11,3,False,6,9,-3,44,1,7
4,00:05:28,3,False,16,26,-10,41,5,7
1,00:00:44,3,False,15,3,12,25,3,7
2,00:14:48,3,True,3,15,-12,36,10,7
2,00:13:03,3,False,15,3,12,41,9,7
2,00:02:01,3,False,29,3,26,25,12,7
3,00:13:54,3,True,10,29,-19,9,8,7
3,00:02:50,3,False,32,25,7,36,3,7
3,00:01:23,3,True,25,32,-7,34,10,7
4,00:11:05,3,True,25,33,-8,37,8,7
4,00:03:47,3,False,33,33,0,17,26,7
1,00:12:29,3,True,0,0,0,44,5,7
1,00:08:18,3,True,0,0,0,31,13,7
2,00:07:52,3,False,3,6,-3,40,6,7
2,00:04:54,3,False,3,6,-3,51,3,7
3,00:11:56,3,False,3,15,-12,28,3,7
4,00:13:43,3,True,16,6,10,13,4,7
4,00:05:54,3,True,19,9,10,48,5,7
1,00:10:33,3,False,0,3,-3,43,2,7
1,00:01:55,3,True,6,0,6,33,4,7
1,00:00:22,3,False,0,6,-6,29,16,7
2,00:12:08,3,False,0,13,-13,46,2,7
2,00:10:35,3,True,13,0,13,31,5,7
2,00:08:05,3,True,13,0,13,17,8,7
2,00:02:21,3,True,13,3,10,41,4,7
2,00:02:00,3,False,3,13,-10,28,18,7
3,00:13:53,3,False,3,13,-10,20,12,7
3,00:07:38,3,False,3,13,-10,21,14,7
3,00:05:30,3,False,3,20,-17,45,11,7
3,00:00:08,3,False,3,20,-17,19,16,7
4,00:13:07,3,False,3,20,-17,46,9,7
4,00:10:26,3,False,3,20,-17,51,1,7
4,00:08:49,3,False,3,20,-17,31,5,7
4,00:02:45,3,False,3,27,-24,11,14,7
1,00:09:08,3,True,0,1,-1,34,11,7
1,00:04:50,3,True,0,4,-4,43,2,7
1,00:03:17,3,True,0,4,-4,49,10,7
2,00:03:33,3,False,18,8,10,44,4,7
3,00:12:15,3,True,9,21,-12,31,9,7
3,00:08:02,3,True,9,28,-19,9,19,7
3,00:06:25,3,False,28,9,19,55,11,7
3,00:03:48,3,True,9,28,-19,40,8,7
4,00:15:00,3,True,9,28,-19,49,7,7
1,00:12:54,3,True,0,0,0,25,12,7
1,00:09:10,3,True,0,0,0,44,13,7
1,00:05:10,3,False,0,0,0,23,9,7
2,00:11:06,3,True,3,1,2,41,4,7
2,00:10:08,3,False,1,3,-2,45,10,7
2,00:07:50,3,True,3,1,2,22,24,7
2,00:05:36,3,False,1,3,-2,49,19,7
2,00:01:39,3,True,3,15,-12,45,5,7
3,00:09:17,3,False,15,6,9,48,13,7
3,00:03:28,3,False,15,7,8,39,6,7
4,00:08:05,3,False,15,17,-2,51,6,7
1,00:13:26,3,True,0,0,0,50,4,7
1,00:12:08,3,True,0,0,0,11,13,7
1,00:10:46,3,True,0,0,0,45,5,7
1,00:09:06,3,True,0,0,0,19,10,7
1,00:07:50,3,True,0,0,0,51,4,7
1,00:05:45,3,True,0,0,0,34,6,7
1,00:03:36,3,True,0,0,0,54,10,7
2,00:12:26,3,False,0,7,-7,46,2,7
3,00:14:13,3,True,15,8,7,27,10,7
3,00:08:31,3,False,15,15,0,48,4,7
4,00:15:00,3,False,15,18,-3,27,4,7
4,00:07:09,3,False,15,28,-13,39,6,7
4,00:05:14,3,True,28,15,13,48,6,7
4,00:01:45,3,False,15,31,-16,40,4,7
4,00:00:57,3,False,15,31,-16,36,9,7
1,00:02:00,3,False,7,3,4,36,5,7
1,00:00:36,3,True,3,7,-4,30,8,7
2,00:13:31,3,True,3,8,-5,44,1,7
2,00:05:06,3,True,3,15,-12,52,10,7
2,00:03:02,3,False,15,3,12,30,7,7
2,00:02:11,3,False,15,10,5,49,6,7
2,00:01:14,0,False,15,10,5,23,0,7
3,00:14:13,3,True,10,22,-12,45,1,7
3,00:06:30,3,True,17,29,-12,44,5,7
3,00:00:01,3,False,29,17,12,25,11,7
4,00:11:52,3,False,29,24,5,47,10,7
4,00:04:27,3,True,24,29,-5,25,20,7
4,00:00:34,3,False,32,32,0,40,8,7
1,00:14:10,3,True,0,0,0,50,5,7
1,00:12:06,3,False,0,0,0,37,10,7
2,00:07:47,3,True,0,7,-7,46,20,7
3,00:11:29,3,True,7,11,-4,39,6,7
3,00:06:36,3,False,12,7,5,20,10,7
3,00:03:51,3,False,12,7,5,46,6,7
4,00:15:00,3,True,7,12,-5,50,15,7
4,00:11:35,3,True,7,12,-5,46,1,7
4,00:05:20,3,True,7,15,-8,37,8,7
4,00:04:02,3,False,15,7,8,38,5,7
4,00:01:53,3,False,15,7,8,49,8,7
1,00:14:04,3,True,0,0,0,42,3,7
1,00:10:30,3,False,0,7,-7,48,1,7
2,00:07:45,3,True,13,0,13,34,2,7
2,00:05:23,3,True,13,0,13,52,2,7
2,00:00:48,3,True,14,0,14,50,4,7
3,00:13:50,3,False,0,14,-14,26,18,7
3,00:09:05,3,False,0,17,-17,50,10,7
3,00:05:50,3,True,17,0,17,48,6,7
3,00:02:43,3,True,17,0,17,37,10,7
3,00:00:58,3,False,0,17,-17,50,2,7
4,00:15:00,3,True,17,0,17,20,5,7
4,00:13:09,3,False,0,17,-17,51,11,7
4,00:06:48,3,True,17,0,17,45,10,7
4,00:05:31,3,True,17,0,17,17,4,7
1,00:10:26,3,True,0,3,-3,19,6,7
1,00:09:08,3,False,3,0,3,55,12,7
1,00:06:42,3,True,0,3,-3,42,8,7
1,00:05:31,3,False,3,0,3,25,9,7
2,00:14:42,3,False,3,0,3,47,5,7
2,00:02:54,3,False,10,5,5,55,5,7
2,00:02:07,3,True,5,10,-5,34,4,7
2,00:00:16,3,True,5,10,-5,24,17,7
2,00:00:01,1,True,5,10,-5,50,10,7
3,00:11:25,3,True,5,13,-8,25,20,7
3,00:05:59,3,False,13,5,8,45,6,7
3,00:05:02,3,True,5,13,-8,22,9,7
3,00:00:01,3,True,5,13,-8,41,9,7
4,00:09:36,3,False,16,5,11,47,10,7
4,00:02:14,3,False,16,11,5,51,6,7
1,00:07:19,3,True,0,7,-7,51,4,7
1,00:02:23,3,False,7,0,7,34,8,7
1,00:01:08,3,True,0,7,-7,50,3,7
2,00:05:21,3,False,7,3,4,42,3,7
2,00:00:59,3,True,3,7,-4,44,3,7
3,00:12:54,3,False,7,3,4,38,1,7
3,00:06:50,3,False,7,8,-1,30,15,7
3,00:01:01,3,False,7,11,-4,44,11,7
4,00:14:38,3,False,7,11,-4,53,4,7
4,00:13:19,3,False,7,11,-4,16,6,7
4,00:08:48,3,False,7,14,-7,48,12,7
4,00:06:01,3,True,14,7,7,42,10,7
4,00:03:11,3,False,7,14,-7,54,13,7
4,00:02:10,3,True,14,7,7,26,1,7
1,00:12:48,3,False,0,7,-7,38,3,7
1,00:05:26,3,False,7,7,0,37,3,7
2,00:11:52,3,False,10,7,3,31,4,7
2,00:00:01,0,False,17,28,-11,35,0,7
3,00:01:21,3,False,20,39,-19,40,5,7
4,00:10:31,3,False,20,42,-22,49,6,7
4,00:07:14,3,True,42,20,22,26,10,7
1,00:13:27,3,False,0,0,0,43,2,7
2,00:13:34,3,True,0,2,-2,54,8,7
2,00:02:38,3,True,0,9,-9,51,19,7
3,00:06:20,3,True,0,17,-17,22,3,7
3,00:01:01,3,False,24,8,16,35,6,7
4,00:04:00,3,False,24,24,0,51,1,7
1,00:12:44,3,False,0,0,0,48,4,7
1,00:11:59,3,False,0,0,0,6,9,7
1,00:08:47,3,False,0,7,-7,24,13,7
2,00:14:34,3,False,7,17,-10,42,8,7
2,00:00:36,3,False,21,20,1,42,9,7
3,00:05:51,3,False,21,23,-2,35,10,7
1,00:11:07,3,True,0,0,0,49,4,7
1,00:09:33,3,True,0,0,0,45,7,7
1,00:07:16,3,True,0,0,0,52,10,7
2,00:01:05,3,False,10,9,1,35,10,7
3,00:12:20,3,True,9,10,-1,45,1,7
3,00:05:13,3,True,12,10,2,24,10,7
3,00:00:01,3,False,17,12,5,47,5,7
4,00:12:08,3,True,12,17,-5,39,10,7
4,00:10:15,3,False,17,12,5,48,4,7
4,00:05:50,3,True,14,17,-3,45,14,7
4,00:00:52,3,True,19,17,2,55,6,7
1,00:06:50,3,True,0,7,-7,41,14,7
1,00:05:26,3,False,7,0,7,35,16,7
2,00:14:44,3,True,0,10,-10,43,2,7
2,00:12:16,3,False,10,0,10,55,5,7
2,00:10:55,3,True,0,10,-10,13,21,7
4,00:11:30,3,False,30,20,10,45,5,7
1,00:12:30,3,False,0,0,0,54,9,7
1,00:05:05,3,True,3,0,3,44,10,7
1,00:03:27,3,True,3,0,3,37,4,7
1,00:00:06,3,True,3,0,3,41,9,7
2,00:13:21,3,True,3,0,3,26,16,7
2,00:10:54,3,True,3,0,3,53,15,7
3,00:00:43,3,True,27,3,24,50,8,7
4,00:02:27,3,False,3,41,-38,38,7,7
4,00:01:47,3,True,41,3,38,26,0,7
1,00:02:29,3,True,0,7,-7,39,6,7
2,00:08:28,3,False,7,7,0,41,1,7
2,00:02:59,3,False,7,14,-7,20,8,7
2,00:02:12,3,True,14,7,7,55,8,7
2,00:01:23,3,False,7,14,-7,20,3,7
2,00:00:30,3,False,7,14,-7,42,6,7
3,00:03:07,3,False,7,31,-24,29,9,7
4,00:14:29,3,True,34,7,27,32,10,7
1,00:13:28,3,False,0,0,0,40,9,7
1,00:12:16,3,True,0,0,0,34,4,7
1,00:10:40,3,False,0,0,0,26,10,7
2,00:11:55,3,False,0,11,-11,38,7,7
2,00:04:28,3,False,0,21,-21,10,8,7
2,00:01:26,3,True,30,0,30,53,3,7
2,00:00:51,3,False,0,30,-30,33,2,7
4,00:00:44,3,True,41,9,32,50,4,7
1,00:02:20,3,True,4,0,4,40,1,7
2,00:13:03,3,False,0,4,-4,45,20,7
2,00:08:50,3,True,4,1,3,53,12,7
2,00:06:46,3,False,1,4,-3,30,19,7
2,00:04:22,3,True,4,1,3,45,7,7
3,00:11:27,3,True,7,1,6,49,11,7
3,00:03:15,3,True,7,3,4,35,14,7
4,00:12:55,3,False,6,15,-9,35,10,7
4,00:11:02,3,False,6,15,-9,53,3,7
4,00:09:41,3,False,6,15,-9,19,12,7
1,00:12:25,3,False,0,0,0,39,11,7
1,00:04:15,3,True,3,3,0,43,1,7
2,00:09:15,3,False,10,6,4,47,10,7
2,00:04:48,3,False,10,6,4,22,3,7
2,00:00:56,3,False,10,6,4,32,5,7
3,00:12:18,3,True,6,10,-4,44,8,7
3,00:11:27,3,True,6,10,-4,4,10,7
3,00:05:23,3,True,6,13,-7,52,20,7
3,00:02:46,3,True,6,13,-7,16,10,7
4,00:12:09,3,True,6,20,-14,55,7,7
4,00:02:38,3,False,20,12,8,40,5,7
4,00:00:34,3,True,12,20,-8,49,6,7
1,00:08:21,3,True,0,7,-7,36,10,7
2,00:01:35,3,True,6,16,-10,47,9,7
2,00:01:05,3,True,6,16,-10,47,5,7
3,00:05:06,3,False,23,7,16,25,10,7
3,00:03:47,3,True,7,23,-16,55,5,7
4,00:06:25,3,False,26,23,3,51,10,7
4,00:04:35,3,True,23,26,-3,38,7,7
1,00:00:47,3,True,3,0,3,49,9,7
2,00:10:12,3,True,3,3,0,36,9,7
2,00:02:40,3,False,4,3,1,34,6,7
3,00:12:09,3,False,11,13,-2,48,7,7
3,00:11:03,3,False,11,13,-2,20,4,7
3,00:03:42,3,True,13,14,-1,43,2,7
3,00:01:22,3,False,14,13,1,48,3,7
4,00:12:36,3,True,13,17,-4,35,10,7
4,00:05:25,3,True,13,24,-11,55,10,7
2,00:13:41,3,False,7,7,0,43,8,7
2,00:10:05,3,False,7,7,0,53,10,7
2,00:02:48,3,True,7,10,-3,22,23,7
4,00:11:05,3,False,23,17,6,34,11,7
4,00:09:11,3,False,23,17,6,53,1,7
4,00:02:45,3,True,17,23,-6,49,10,7
4,00:02:04,3,True,17,23,-6,17,3,7
1,00:06:58,3,False,0,1,-1,54,10,7
2,00:13:32,3,False,3,8,-5,30,3,7
2,00:06:51,3,True,8,10,-2,33,9,7
2,00:02:41,3,True,8,13,-5,42,3,7
3,00:13:37,3,False,20,15,5,43,3,7
3,00:11:55,3,True,15,20,-5,38,3,7
3,00:06:53,3,True,15,27,-12,36,10,7
3,00:04:42,3,False,27,15,12,42,15,7
3,00:02:00,3,True,15,27,-12,40,20,7
3,00:01:02,3,False,27,15,12,24,10,7
1,00:08:45,3,False,0,5,-5,44,11,7
1,00:04:05,3,False,0,8,-8,35,10,7
2,00:13:44,3,False,0,15,-15,17,29,7
2,00:09:46,3,False,0,15,-15,43,7,7
2,00:08:20,3,True,15,0,15,27,1,7
2,00:03:24,3,True,15,7,8,49,11,7
2,00:01:55,3,True,15,7,8,33,10,7
2,00:01:32,3,False,7,15,-8,26,3,7
2,00:00:58,3,True,15,7,8,42,21,7
3,00:07:18,3,False,14,15,-1,50,12,7
4,00:10:38,3,False,21,18,3,40,5,7
1,00:12:40,3,False,0,0,0,20,15,7
1,00:10:19,3,False,0,3,-3,35,10,7
1,00:04:51,3,True,4,7,-3,26,14,7
1,00:03:27,3,False,7,4,3,50,7,7
1,00:01:23,3,True,4,7,-3,38,13,7
2,00:15:00,3,False,7,4,3,30,11,7
2,00:12:16,3,False,7,4,3,42,8,7
2,00:09:59,3,False,7,4,3,40,7,7
2,00:06:20,3,False,7,7,0,24,13,7
3,00:10:50,3,False,13,14,-1,40,25,7
4,00:13:39,3,False,13,17,-4,22,7,7
4,00:12:21,3,True,17,13,4,48,22,7
4,00:11:05,3,False,13,17,-4,20,15,7
4,00:08:13,3,True,17,20,-3,38,18,7
4,00:05:23,3,True,17,21,-4,29,16,7
4,00:00:24,3,False,28,23,5,53,22,7
1,00:13:47,3,True,0,0,0,52,6,7
1,00:10:42,3,False,0,0,0,28,19,7
1,00:05:32,3,False,0,1,-1,43,2,7
2,00:14:17,3,True,8,0,8,42,20,7
2,00:06:17,3,True,15,14,1,41,4,7
3,00:05:15,3,False,17,22,-5,54,1,7
3,00:02:31,3,True,22,24,-2,19,10,7
3,00:00:16,3,True,22,24,-2,14,29,7
1,00:02:48,3,True,7,0,7,46,6,7
2,00:08:38,3,True,10,3,7,40,12,7
2,00:06:25,3,False,3,10,-7,48,4,7
3,00:13:38,3,False,3,10,-7,47,3,7
3,00:06:32,3,False,9,11,-2,30,15,7
3,00:04:46,3,True,11,9,2,47,12,7
4,00:12:50,3,True,11,9,2,36,24,7
1,00:13:44,3,False,0,0,0,35,11,7
1,00:10:06,3,False,0,3,-3,43,2,7
2,00:08:54,3,False,3,17,-14,47,4,7
2,00:06:24,3,True,17,3,14,40,4,7
2,00:00:41,3,False,3,20,-17,46,3,7
3,00:13:38,3,True,20,3,17,30,3,7
3,00:11:38,3,False,3,20,-17,35,15,7
4,00:14:42,3,False,3,30,-27,46,10,7
4,00:06:50,3,True,37,3,34,43,10,7
4,00:02:14,3,False,3,37,-34,26,10,7
1,00:12:54,3,False,0,0,0,46,10,7
1,00:07:04,3,False,0,0,0,22,17,7
1,00:06:19,3,True,0,0,0,36,10,7
1,00:01:16,3,False,3,0,3,38,10,7
2,00:14:30,3,False,3,0,3,23,18,7
2,00:09:27,3,False,3,7,-4,48,3,7
2,00:02:55,3,False,4,7,-3,52,6,7
2,00:02:13,3,True,7,4,3,25,0,7
3,00:12:08,3,True,7,11,-4,49,14,7
3,00:10:25,3,True,7,11,-4,25,12,7
3,00:07:45,3,True,7,11,-4,46,4,7
4,00:10:56,3,False,14,10,4,41,10,7
4,00:07:43,3,False,14,17,-3,36,5,7
4,00:06:43,3,True,17,14,3,47,10,7
4,00:04:46,3,False,14,17,-3,40,10,7
4,00:03:17,3,True,17,14,3,51,7,7
1,00:13:30,3,False,0,0,0,42,14,7
1,00:07:07,3,False,0,14,-14,25,15,7
2,00:13:13,3,True,17,0,17,52,5,7
2,00:11:45,3,True,17,0,17,15,7,7
2,00:10:24,3,True,17,0,17,53,11,7
2,00:07:30,3,True,17,0,17,35,5,7
2,00:02:37,3,False,0,20,-20,29,16,7
2,00:01:25,3,True,20,0,20,47,8,7
3,00:10:23,3,False,1,20,-19,27,17,7
3,00:07:40,3,False,1,20,-19,45,11,7
4,00:06:35,3,False,5,23,-18,30,15,7
4,00:04:59,3,True,23,5,18,49,24,7
4,00:02:26,3,True,23,5,18,11,6,7
4,00:01:28,3,False,5,23,-18,51,9,7
1,00:04:21,3,True,3,3,0,43,11,7
3,00:11:27,3,False,24,13,11,48,13,7
3,00:10:14,3,False,24,13,11,24,5,7
3,00:09:03,3,False,24,13,11,51,16,7
3,00:07:57,3,False,24,13,11,18,11,7
4,00:01:36,3,True,16,33,-17,36,19,7
4,00:00:47,3,False,33,16,17,39,3,7
1,00:11:05,3,False,0,3,-3,35,10,7
1,00:05:57,3,False,0,4,-4,43,13,7
2,00:13:01,3,False,0,4,-4,30,15,7
2,00:10:15,3,False,0,4,-4,40,5,7
2,00:02:11,3,True,11,6,5,42,3,7
2,00:00:56,3,False,6,11,-5,43,8,7
3,00:14:11,3,False,6,11,-5,39,3,7
3,00:11:34,0,True,11,6,5,41,0,7
3,00:08:55,3,False,6,14,-8,35,10,7
3,00:04:48,3,True,14,6,8,55,13,7
3,00:03:32,3,False,6,14,-8,27,6,7
1,00:03:05,3,False,1,0,1,53,15,7
2,00:10:56,3,True,7,1,6,29,5,7
2,00:02:45,3,False,4,10,-6,35,10,7
2,00:02:11,3,True,10,4,6,47,9,7
3,00:12:50,3,True,16,4,12,47,10,7
3,00:02:46,3,False,7,23,-16,20,3,7
4,00:10:11,3,True,24,7,17,50,7,7
4,00:05:10,3,True,24,10,14,28,18,7
4,00:01:24,3,False,17,24,-7,36,3,7
4,00:00:09,2,False,17,24,-7,31,10,7
1,00:10:33,3,True,0,0,0,51,17,7
1,00:09:07,3,True,0,0,0,37,7,7
1,00:03:13,3,False,0,1,-1,49,10,7
1,00:00:30,3,True,1,0,1,50,2,7
2,00:10:50,3,True,1,0,1,50,3,7
2,00:09:41,3,False,0,1,-1,27,9,7
2,00:00:52,3,False,3,15,-12,22,10,7
2,00:00:28,3,False,3,15,-12,47,3,7
4,00:05:52,3,False,3,50,-47,37,3,7
4,00:03:46,3,True,50,3,47,20,9,7
4,00:01:35,3,True,50,11,39,36,14,7
1,00:12:44,3,False,0,0,0,18,9,7
1,00:09:44,3,False,0,7,-7,49,3,7
1,00:05:49,3,True,7,1,6,41,4,7
1,00:00:14,3,True,7,1,6,48,13,7
2,00:10:00,3,False,1,15,-14,41,4,7
2,00:06:28,3,False,1,22,-21,42,8,7
2,00:04:57,3,True,22,1,21,33,3,7
3,00:13:46,3,False,4,29,-25,35,2,7
3,00:04:48,3,True,36,11,25,23,2,7
3,00:01:52,3,True,36,18,18,33,7,7
4,00:14:45,3,False,18,36,-18,48,18,7
4,00:11:59,3,True,36,18,18,44,6,7
4,00:07:32,3,False,18,36,-18,29,8,7
1,00:11:31,3,False,0,0,0,54,7,7
1,00:09:59,3,True,0,0,0,17,15,7
1,00:03:49,3,False,0,7,-7,27,12,7
2,00:12:06,3,False,0,14,-14,50,7,7
2,00:00:52,3,True,17,7,10,48,1,7
3,00:12:53,3,False,7,17,-10,54,4,7
3,00:11:05,3,False,7,17,-10,55,7,7
3,00:02:59,3,False,7,20,-13,37,8,7
3,00:00:41,3,True,20,7,13,28,8,7
4,00:04:39,3,True,20,13,7,38,7,7
1,00:10:40,3,False,0,3,-3,40,5,7
1,00:09:20,3,True,3,0,3,41,6,7
2,00:12:29,3,False,0,7,-7,43,9,7
2,00:06:30,3,False,0,10,-10,38,8,7
2,00:01:41,3,False,0,17,-17,52,10,7
2,00:01:11,3,True,17,0,17,16,10,7
3,00:13:44,3,True,17,7,10,45,10,7
3,00:11:00,3,True,17,7,10,50,5,7
3,00:00:33,3,True,18,10,8,30,15,7
4,00:11:37,3,False,10,18,-8,50,10,7
4,00:08:37,3,True,18,10,8,33,1,7
4,00:07:46,3,False,10,18,-8,35,15,7
4,00:01:59,3,False,10,18,-8,50,26,7
1,00:05:44,3,True,0,7,-7,38,12,7
1,00:00:24,3,False,7,3,4,36,5,7
2,00:00:26,3,False,14,13,1,50,10,7
3,00:09:15,3,True,20,14,6,42,1,7
4,00:15:00,3,True,27,17,10,37,7,7
4,00:13:42,3,False,17,27,-10,50,9,7
4,00:04:05,3,False,24,30,-6,41,4,7
1,00:13:23,3,True,0,0,0,49,2,7
1,00:11:56,3,True,0,0,0,24,4,7
1,00:10:07,3,True,0,0,0,50,2,7
1,00:00:15,3,True,7,0,7,45,15,7
2,00:13:19,3,False,0,7,-7,35,10,7
2,00:07:31,3,False,0,10,-10,42,4,7
3,00:11:50,3,False,0,27,-27,22,20,7
3,00:07:32,3,False,0,34,-34,26,9,7
4,00:08:38,3,False,7,37,-30,35,4,7
4,00:07:02,3,True,37,7,30,36,10,7
4,00:04:52,3,False,7,37,-30,49,2,7
4,00:03:10,3,True,37,7,30,10,13,7
4,00:01:34,3,True,37,10,27,43,2,7
1,00:14:05,3,True,0,0,0,33,6,7
1,00:03:54,3,False,0,6,-6,48,6,7
2,00:03:37,3,True,6,6,0,36,6,7
2,00:02:38,3,False,6,6,0,46,10,7
3,00:13:59,3,False,13,6,7,28,6,7
3,00:10:56,3,False,13,7,6,31,14,7
3,00:09:14,3,True,7,13,-6,36,8,7
3,00:00:55,3,True,14,20,-6,48,4,7
4,00:03:20,3,False,34,20,14,30,12,7
4,00:00:07,3,True,27,34,-7,47,5,7
2,00:10:20,3,True,6,3,3,42,10,7
2,00:09:00,3,False,3,6,-3,49,6,7
2,00:07:26,3,True,6,3,3,44,3,7
2,00:06:06,3,False,3,6,-3,26,7,7
3,00:10:59,3,False,6,9,-3,16,21,7
3,00:05:32,3,False,6,12,-6,39,6,7
3,00:01:43,3,True,12,6,6,30,18,7
1,00:10:32,3,False,0,0,0,33,12,7
1,00:11:55,3,False,0,0,0,37,5,7
1,00:05:54,3,False,0,0,0,6,9,7
1,00:04:30,3,True,0,0,0,50,20,7
1,00:01:30,3,True,0,1,-1,44,1,7
1,00:00:01,3,False,1,0,1,40,9,7
2,00:05:38,3,False,4,0,4,47,4,7
2,00:02:09,3,False,4,3,1,26,24,7
3,00:12:32,3,False,12,3,9,53,14,7
3,00:10:33,3,True,3,12,-9,34,7,7
3,00:07:37,3,False,12,3,9,29,35,7
3,00:06:26,3,True,3,12,-9,38,10,7
3,00:00:35,3,True,3,19,-16,49,9,7
2,00:12:27,3,False,3,7,-4,54,5,7
2,00:03:15,3,True,7,20,-13,42,4,7
3,00:02:47,3,False,30,7,23,50,8,7
3,00:01:20,3,False,30,7,23,5,10,7
4,00:06:52,3,True,10,30,-20,39,5,7
4,00:02:32,3,True,10,30,-20,20,10,7
2,00:11:04,3,True,7,13,-6,45,7,7
2,00:04:22,3,True,7,20,-13,39,10,7
2,00:02:15,3,False,20,7,13,50,4,7
3,00:11:07,3,True,7,20,-13,52,6,7
3,00:09:59,3,True,7,20,-13,19,8,7
3,00:06:24,0,True,7,23,-16,35,0,7
3,00:03:19,3,False,23,7,16,47,10,7
4,00:09:07,3,False,26,13,13,46,10,7
4,00:06:24,3,False,26,13,13,47,1,7
1,00:04:50,3,False,3,6,-3,30,5,7
1,00:02:10,3,False,3,6,-3,32,4,7
3,00:05:57,3,False,16,19,-3,22,10,7
4,00:04:55,3,True,30,30,0,24,9,7
1,00:07:09,3,True,6,0,6,27,10,7
1,00:04:33,3,True,6,0,6,50,7,7
1,00:03:23,3,True,6,0,6,14,6,7
1,00:03:23,3,True,6,0,6,14,6,7
1,00:01:57,3,False,0,6,-6,46,10,7
2,00:02:48,3,True,13,5,8,29,7,7
2,00:00:38,3,True,13,5,8,45,10,7
4,00:08:58,3,True,16,20,-4,34,10,7
4,00:05:52,3,False,20,16,4,40,25,7
1,00:02:45,3,False,7,7,0,47,14,7
1,00:00:55,3,True,7,7,0,29,4,7
2,00:13:45,3,True,7,15,-8,31,27,7
3,00:12:58,3,False,18,10,8,27,17,7
3,00:03:32,3,True,18,18,0,30,1,7
4,00:03:22,3,False,22,18,4,14,15,7
1,00:09:53,3,True,2,0,2,34,25,7
1,00:08:48,3,False,0,2,-2,17,10,7
2,00:12:17,3,False,7,10,-3,55,5,7
2,00:02:12,3,True,10,10,0,42,3,7
2,00:01:02,3,False,10,10,0,50,13,7
3,00:04:43,3,False,10,16,-6,32,20,7
4,00:02:09,3,True,26,11,15,36,7,7
1,00:09:22,3,False,0,0,0,48,7,7
1,00:05:54,3,False,0,0,0,42,26,7
1,00:04:52,3,True,0,0,0,26,2,7
2,00:10:02,3,True,7,7,0,38,8,7
2,00:00:37,3,True,14,15,-1,39,2,7
4,00:15:00,3,False,23,23,0,28,1,7
4,00:02:51,3,True,26,30,-4,55,3,7
1,00:00:00,3,True,7,10,-3,22,19,7
2,00:13:48,3,True,7,17,-10,27,20,7
2,00:08:11,3,True,7,31,-24,45,3,7
2,00:02:40,3,True,7,38,-31,21,4,7
2,00:01:49,3,False,38,7,31,48,18,7
3,00:02:46,3,False,41,18,23,46,19,7
4,00:03:44,3,False,52,26,26,52,10,7
1,00:09:50,3,True,0,0,0,54,10,7
1,00:00:50,3,False,0,7,-7,44,29,7
2,00:15:00,3,False,0,7,-7,47,5,7
2,00:12:49,3,False,0,7,-7,19,18,7
2,00:08:26,3,False,0,10,-10,40,5,7
1,00:03:49,3,False,3,0,3,40,4,7
1,00:02:09,3,False,3,0,3,13,15,7
1,00:01:18,3,False,3,0,3,42,10,7
2,00:12:05,3,True,0,3,-3,16,9,7
2,00:01:10,3,True,7,7,0,52,11,7
2,00:00:30,3,False,7,7,0,27,3,7
3,00:11:20,3,False,9,10,-1,26,20,7
4,00:05:59,3,False,16,27,-11,41,10,7
2,00:10:40,3,False,10,3,7,18,10,7
2,00:02:04,3,False,10,9,1,54,5,7
3,00:01:36,3,False,11,21,-10,43,2,7
1,00:09:02,3,True,0,0,0,28,7,7
1,00:06:11,3,False,0,7,-7,31,4,7
2,00:13:35,3,False,0,20,-20,15,15,7
2,00:08:24,3,False,0,26,-26,41,10,7
2,00:05:44,3,False,0,29,-29,40,5,7
3,00:14:10,3,True,36,11,25,32,6,7
3,00:05:30,3,False,14,43,-29,42,6,7
3,00:04:13,3,True,43,14,29,37,15,7
3,00:03:12,3,False,14,43,-29,42,10,7
4,00:06:00,3,False,17,46,-29,50,5,7
4,00:02:39,3,True,46,17,29,29,6,7
1,00:13:53,3,True,0,0,0,18,8,7
1,00:04:47,3,False,0,3,-3,37,18,7
2,00:00:59,3,True,12,10,2,54,3,7
3,00:09:29,3,False,13,19,-6,44,20,7
3,00:07:19,3,False,13,19,-6,33,3,7
4,00:09:24,3,False,20,25,-5,40,5,7
4,00:02:23,3,True,25,23,2,40,5,7
1,00:12:22,3,True,0,0,0,46,4,7
1,00:08:50,3,True,0,0,0,36,11,7
1,00:04:29,3,True,0,7,-7,40,4,7
2,00:13:53,3,False,7,3,4,51,5,7
2,00:07:33,3,True,6,7,-1,38,6,7
2,00:02:28,3,False,7,6,1,50,14,7
2,00:00:24,3,True,6,7,-1,38,30,7
3,00:09:22,3,False,7,9,-2,40,5,7
4,00:10:47,3,False,22,12,10,43,7,7
1,00:12:10,3,True,0,0,0,13,6,7
1,00:10:55,3,True,0,0,0,49,6,7
1,00:04:34,3,True,0,0,0,40,10,7
2,00:14:34,3,True,0,7,-7,22,6,7
2,00:04:48,3,False,7,14,-7,15,3,7
3,00:08:09,3,True,22,14,8,24,15,7
3,00:02:57,3,False,17,22,-5,46,11,7
3,00:00:41,3,True,22,17,5,31,5,7
4,00:11:30,3,True,22,20,2,30,15,7
4,00:10:24,3,False,20,22,-2,32,15,7
1,00:11:27,3,True,1,0,1,46,3,7
1,00:09:07,3,True,1,0,1,43,12,7
1,00:06:49,3,False,0,1,-1,34,10,7
1,00:04:49,3,True,1,0,1,45,15,7
2,00:09:31,3,True,4,7,-3,26,5,7
2,00:02:26,3,False,7,4,3,26,6,7
3,00:12:13,3,False,10,7,3,45,10,7
3,00:05:06,3,True,14,10,4,45,10,7
3,00:02:20,3,False,10,14,-4,52,10,7
4,00:11:15,3,False,13,14,-1,51,3,7
4,00:09:49,3,False,13,14,-1,8,24,7
4,00:02:11,3,False,13,17,-4,39,4,7
4,00:01:09,3,False,13,17,-4,42,10,7
1,00:13:44,3,False,0,0,0,52,7,7
1,00:08:06,3,True,0,2,-2,17,8,7
1,00:03:23,3,True,0,5,-5,38,7,7
1,00:01:14,3,True,0,5,-5,22,10,7
2,00:14:46,3,True,0,5,-5,43,3,7
2,00:08:43,3,False,5,0,5,53,2,7
3,00:07:14,3,True,6,11,-5,35,10,7
1,00:06:59,3,False,7,0,7,49,6,7
1,00:01:27,3,True,0,7,-7,47,3,7
2,00:00:50,3,False,9,4,5,55,2,7
4,00:06:44,3,False,27,14,13,36,9,7
4,00:02:08,3,False,27,17,10,41,4,7
1,00:13:57,3,True,0,1,-1,40,5,7
1,00:09:19,3,True,0,8,-8,22,7,7
2,00:15:00,3,False,16,8,8,39,8,7
2,00:06:10,3,True,16,16,0,11,17,7
2,00:00:48,3,True,16,16,0,54,3,7
3,00:13:12,3,False,16,16,0,47,8,7
3,00:08:55,3,False,16,16,0,51,3,7
4,00:13:50,3,True,23,22,1,30,6,7
4,00:01:01,3,True,26,25,1,23,4,7
1,00:13:17,3,True,0,0,0,46,6,7
1,00:12:14,3,False,0,0,0,43,10,7
1,00:11:02,3,True,0,0,0,28,10,7
2,00:10:16,3,True,8,19,-11,43,3,7
2,00:04:45,3,False,19,11,8,30,15,7
2,00:01:03,3,True,17,19,-2,51,10,7
3,00:12:13,3,True,17,19,-2,52,8,7
3,00:11:10,3,True,17,19,-2,4,10,7
4,00:09:38,3,False,23,20,3,54,10,7
4,00:00:08,3,False,26,26,0,47,15,7
1,00:13:43,3,True,0,0,0,33,1,7
1,00:01:28,3,False,0,14,-14,26,16,7
2,00:07:01,3,False,7,21,-14,51,21,7
2,00:04:25,3,True,21,7,14,36,3,7
2,00:02:03,3,True,21,7,14,55,5,7
2,00:00:35,3,False,7,21,-14,29,12,7
3,00:10:14,3,True,21,10,11,36,9,7
3,00:09:00,3,False,10,21,-11,34,6,7
3,00:02:38,3,True,21,18,3,19,6,7
4,00:11:31,3,True,21,21,0,35,10,7
1,00:08:51,3,False,0,0,0,47,28,7
2,00:14:11,3,True,1,3,-2,54,6,7
2,00:07:25,3,False,3,4,-1,39,25,7
2,00:06:22,3,True,4,3,1,30,3,7
2,00:05:22,3,False,3,4,-1,35,4,7
2,00:03:59,3,True,4,3,1,35,7,7
2,00:00:49,3,False,3,4,-1,37,4,7
3,00:13:00,3,False,3,4,-1,52,10,7
3,00:09:41,3,False,3,4,-1,17,10,7
3,00:08:45,3,False,3,4,-1,52,9,7
3,00:07:37,3,False,3,4,-1,9,15,7
4,00:14:30,3,False,3,18,-15,54,3,7
4,00:13:16,3,True,18,3,15,26,7,7
4,00:10:29,3,False,3,18,-15,42,6,7
4,00:02:43,3,False,3,32,-29,40,6,7
4,00:01:09,3,False,3,32,-29,47,18,7
1,00:01:58,3,True,3,7,-4,37,16,7
2,00:02:49,3,True,6,11,-5,49,10,7
3,00:05:46,3,True,21,17,4,43,18,7
3,00:00:50,3,False,17,21,-4,54,15,7
4,00:12:40,3,True,21,20,1,18,27,7
1,00:04:08,3,False,3,7,-4,15,7,7
2,00:06:21,3,False,6,7,-1,29,3,7
2,00:01:19,3,True,7,13,-6,38,15,7
3,00:04:18,3,True,10,15,-5,30,29,7
4,00:01:48,0,True,13,18,-5,50,0,7
2,00:09:31,3,True,3,7,-4,10,8,71
2,00:05:13,3,True,0,32,-32,53,3,71
4,00:02:14,3,False,14,17,-3,33,10,71
2,00:12:56,3,True,7,2,5,45,15,67
2,00:00:45,3,True,14,17,-3,51,2,67
4,00:10:01,3,True,8,20,-12,49,4,67
4,00:09:25,3,True,30,28,2,40,6,67
3,00:07:38,3,True,17,12,5,44,18,67
2,00:08:35,3,False,10,7,3,48,4,67
1,00:06:13,3,True,3,7,-4,51,5,67
1,00:07:27,3,False,0,7,-7,51,10,67
4,00:12:35,3,False,4,24,-20,45,31,67
2,00:14:27,3,False,14,10,4,47,10,67
3,00:05:38,3,True,30,23,7,48,10,67
4,00:00:25,3,True,33,37,-4,43,10,67
1,00:12:48,3,False,0,0,0,51,1,67
2,00:01:31,3,True,20,11,9,50,1,67
2,00:03:03,3,False,6,23,-17,50,1,67
2,00:10:17,3,True,0,14,-14,44,3,67
2,00:07:00,3,True,3,7,-4,46,14,67
3,00:01:53,3,False,8,3,5,42,9,67
4,00:11:49,3,True,4,8,-4,45,8,67
4,00:00:46,3,False,21,35,-14,45,10,67
3,00:11:09,3,True,14,21,-7,44,6,67
1,00:01:14,3,True,10,7,3,52,8,67
2,00:14:29,3,False,7,11,-4,50,5,67
4,00:00:26,3,True,26,32,-6,50,5,67
4,00:00:00,1,False,33,26,7,28,10,67
2,00:02:01,3,True,7,25,-18,45,4,67
2,00:14:00,3,False,0,8,-8,46,11,67
3,00:12:24,3,False,13,13,0,54,2,67
2,00:00:40,3,True,3,0,3,23,15,67
4,00:08:21,3,True,11,34,-23,50,11,67
1,00:04:56,3,True,0,0,0,50,3,67
1,00:01:48,3,False,1,0,1,46,5,67
3,00:12:43,3,True,4,3,1,54,7,67
4,00:06:53,3,True,14,11,3,50,2,67
2,00:14:35,3,False,3,0,3,47,17,67
2,00:07:36,3,False,3,1,2,49,9,67
1,00:08:12,3,True,0,0,0,48,5,67
1,00:10:26,3,False,0,0,0,41,6,67
1,00:03:37,3,True,0,7,-7,47,5,67
2,00:10:32,3,True,3,8,-5,49,4,67
3,00:05:27,3,True,17,16,1,49,7,67
3,00:03:56,3,True,3,31,-28,37,17,67
3,00:04:27,3,True,3,31,-28,43,8,67
4,00:10:47,3,True,3,39,-36,39,10,67
4,00:14:43,3,False,24,7,17,52,6,67
2,00:10:28,3,True,17,3,14,53,7,67
2,00:02:59,3,True,18,3,15,50,10,67
2,00:10:52,3,True,7,4,3,50,15,67
3,00:10:23,3,False,10,8,2,48,4,67
3,00:05:22,3,True,9,10,-1,40,10,67
2,00:08:58,3,True,16,3,13,45,7,67
3,00:12:41,3,False,3,14,-11,55,14,67
3,00:11:59,3,True,24,6,18,51,15,67
4,00:02:05,3,True,27,29,-2,47,8,67
4,00:03:26,3,True,13,23,-10,44,18,67
4,00:11:12,3,True,31,14,17,55,4,67
4,00:07:18,3,True,27,20,7,48,12,67
1,00:01:46,3,False,10,0,10,43,11,67
2,00:06:35,3,False,14,10,4,40,12,67
1,00:00:00,3,True,7,3,4,51,3,67
4,00:11:42,3,False,30,6,24,48,10,67
1,00:05:18,3,True,0,1,-1,54,7,67
4,00:09:52,3,True,6,9,-3,45,3,67
3,00:01:03,3,True,16,24,-8,45,4,67
2,00:04:21,3,True,6,14,-8,45,8,67
2,00:04:10,3,True,7,3,4,41,22,67
2,00:04:21,3,True,17,3,14,52,7,67
1,00:07:11,3,False,0,0,0,49,8,67
3,00:11:51,3,True,7,22,-15,42,3,67
2,00:05:18,3,True,14,0,14,50,6,67
2,00:00:25,3,True,14,1,13,45,2,67
1,00:00:00,3,False,0,17,-17,43,2,67
1,00:12:48,3,True,0,0,0,52,9,67
3,00:04:30,3,True,14,0,14,42,8,67
2,00:06:57,3,False,0,21,-21,53,4,67
3,00:05:23,3,False,1,24,-23,46,10,67
1,00:01:07,3,False,0,0,0,44,4,67
3,00:07:56,3,False,7,10,-3,45,23,67
1,00:13:20,3,True,0,0,0,51,3,67
2,00:14:20,3,True,3,3,0,50,5,67
1,00:12:15,3,False,0,0,0,47,4,67
2,00:11:59,3,False,3,4,-1,45,12,67
1,00:09:07,3,False,7,0,7,53,5,67
1,00:02:53,3,False,10,1,9,53,6,67
3,00:01:12,3,False,14,31,-17,44,16,67
2,00:14:18,3,True,4,0,4,43,15,67
2,00:06:56,3,False,4,7,-3,54,24,67
1,00:01:51,3,False,0,0,0,50,13,67
2,00:14:17,3,False,0,1,-1,55,6,67
3,00:12:02,3,False,4,4,0,42,6,67
4,00:02:16,3,True,12,11,1,45,6,67
3,00:03:52,3,False,13,9,4,52,3,67
1,00:07:42,3,False,0,0,0,43,8,67
4,00:12:08,3,False,23,31,-8,50,3,67
4,00:02:00,3,True,16,19,-3,45,4,67
2,00:13:04,3,False,3,7,-4,50,6,67
3,00:12:03,3,False,3,8,-5,52,2,67
3,00:00:37,3,False,3,12,-9,41,2,67
1,00:11:36,3,False,0,3,-3,40,10,67
3,00:04:41,3,True,5,6,-1,49,8,67
2,00:00:02,3,True,7,20,-13,45,5,67
2,00:10:59,3,False,8,7,1,43,18,67
3,00:02:17,3,True,15,30,-15,47,21,67
4,00:09:49,3,False,30,16,14,47,12,67
4,00:11:53,3,True,25,32,-7,47,11,67
1,00:10:04,3,False,0,0,0,52,5,67
2,00:11:57,3,True,3,0,3,49,10,67
3,00:04:05,3,False,15,6,9,50,15,67
4,00:04:56,3,False,15,17,-2,50,1,67
2,00:09:36,3,False,0,7,-7,47,7,67
2,00:08:02,3,False,0,8,-8,45,10,67
2,00:14:43,3,True,3,7,-4,52,2,67
3,00:12:40,3,True,7,10,-3,46,10,67
3,00:08:28,3,False,11,7,4,55,6,67
2,00:02:52,3,False,0,13,-13,50,14,67
3,00:10:03,3,True,0,9,-9,50,10,67
4,00:13:38,3,False,6,40,-34,39,13,67
1,00:04:49,3,False,0,3,-3,53,20,67
4,00:08:10,3,True,15,6,9,55,6,67
1,00:00:00,3,True,3,14,-11,46,8,67
2,00:08:43,3,True,6,15,-9,47,7,67
3,00:13:09,3,False,16,6,10,50,5,67
4,00:06:24,3,True,17,20,-3,43,14,67
3,00:07:26,3,False,9,10,-1,40,10,67
2,00:04:57,3,True,7,3,4,47,2,67
3,00:02:27,3,True,20,1,19,46,8,67
1,00:08:40,3,False,0,3,-3,48,4,67
4,00:01:02,3,False,9,28,-19,42,2,67
1,00:04:56,3,False,0,0,0,44,11,67
1,00:07:04,3,True,7,0,7,45,9,67
3,00:11:35,3,False,13,6,7,50,11,67
1,00:02:35,3,True,0,0,0,49,10,67
2,00:06:57,3,True,9,15,-6,39,32,67
4,00:10:13,3,True,18,21,-3,42,18,67
4,00:00:44,3,True,21,22,-1,45,9,67
1,00:05:15,3,False,0,2,-2,53,10,67
3,00:01:17,3,True,16,10,6,43,10,67
4,00:11:01,3,False,11,24,-13,38,11,67
2,00:01:36,3,True,7,6,1,45,4,67
3,00:03:00,3,True,20,11,9,48,9,67
2,00:00:19,3,False,14,21,-7,52,2,67
1,00:13:04,3,False,0,0,0,45,13,67
2,00:14:05,3,False,7,0,7,47,8,67
2,00:06:28,3,False,8,3,5,42,3,67
3,00:02:35,3,True,20,22,-2,51,10,67
1,00:05:21,3,False,0,0,0,41,10,67
1,00:14:54,1,True,0,0,0,44,10,4
1,00:14:14,2,True,0,0,0,51,3,4
1,00:11:50,1,False,0,0,0,37,10,4
1,00:10:44,1,False,0,0,0,11,10,4
1,00:10:21,2,False,0,0,0,18,3,4
1,00:05:44,1,True,0,0,0,21,10,4
1,00:05:09,2,True,0,0,0,28,3,4
1,00:00:27,1,False,0,3,-3,50,10,4
2,00:14:02,2,True,3,0,3,21,1,4
2,00:13:11,1,True,3,0,3,20,10,4
2,00:11:10,2,False,7,3,4,49,3,4
2,00:10:31,1,True,3,7,-4,8,10,4
2,00:09:18,1,True,3,7,-4,47,10,4
2,00:07:55,2,False,7,3,4,50,10,4
2,00:07:03,1,False,7,3,4,12,10,4
2,00:06:35,1,False,7,3,4,23,10,4
2,00:01:25,2,True,3,14,-11,48,5,4
2,00:00:46,1,False,14,3,11,23,10,4
3,00:14:54,1,False,14,3,11,35,10,4
3,00:14:10,2,False,14,3,11,39,6,4
3,00:13:52,1,False,14,3,11,54,10,4
3,00:13:24,2,True,3,14,-11,46,0,4
3,00:11:44,1,True,3,14,-11,5,5,4
3,00:10:26,1,True,3,17,-14,32,10,4
3,00:09:47,2,True,3,17,-14,34,8,4
3,00:08:05,3,False,17,3,14,52,14,4
3,00:03:28,1,False,17,6,11,35,10,4
3,00:02:55,1,False,17,6,11,49,10,4
3,00:01:37,2,True,6,17,-11,30,10,4
4,00:14:54,1,True,6,24,-18,33,10,4
4,00:13:57,1,False,24,6,18,24,10,4
4,00:12:20,1,False,24,6,18,3,3,4
4,00:11:02,3,False,24,6,18,6,6,4
4,00:09:57,1,False,24,6,18,45,10,4
4,00:09:44,1,False,24,6,18,45,10,4
4,00:08:32,1,True,6,24,-18,35,10,4
4,00:07:44,2,True,6,24,-18,40,5,4
4,00:06:16,2,True,6,24,-18,48,2,4
4,00:05:41,3,True,6,24,-18,49,1,4
4,00:04:52,2,False,24,6,18,44,3,4
4,00:02:35,3,False,24,6,18,18,1,4
4,00:02:02,1,False,24,6,18,50,10,4
4,00:00:23,1,False,24,6,18,55,10,4
4,00:00:16,2,False,24,6,18,55,10,4
4,00:00:14,3,True,6,24,-18,49,4,4
1,00:13:54,1,False,0,0,0,28,10,4
1,00:12:33,1,False,0,0,0,1,1,4
1,00:11:41,2,False,0,7,-7,31,15,4
1,00:06:23,1,True,7,3,4,25,10,4
1,00:03:32,1,False,3,7,-4,42,10,4
1,00:03:10,1,False,3,7,-4,54,10,4
2,00:14:20,1,True,7,6,1,37,10,4
2,00:11:20,1,False,13,7,6,53,10,4
2,00:10:08,1,True,7,13,-6,32,10,4
2,00:05:59,1,True,7,16,-9,30,10,4
2,00:00:05,1,True,10,23,-13,30,10,4
3,00:12:50,1,False,23,10,13,49,10,4
3,00:10:54,1,False,23,10,13,4,10,4
3,00:04:29,1,True,12,26,-14,35,10,4
3,00:03:49,2,True,12,26,-14,43,2,4
3,00:02:18,1,False,26,12,14,53,10,4
3,00:01:10,1,True,12,26,-14,22,10,4
4,00:15:00,1,True,12,26,-14,54,10,4
4,00:13:37,1,True,12,26,-14,1,1,4
4,00:11:45,1,False,33,19,14,32,10,4
4,00:08:32,2,True,19,33,-14,33,10,4
4,00:07:29,2,True,19,33,-14,43,10,4
4,00:06:35,3,True,19,33,-14,52,1,4
4,00:05:19,1,False,33,19,14,38,10,4
4,00:01:56,1,False,33,26,7,51,5,4
1,00:09:33,1,False,0,0,0,6,6,4
1,00:06:56,1,True,7,0,7,19,10,4
1,00:06:14,2,True,7,0,7,28,1,4
1,00:05:41,3,True,7,0,7,28,1,4
1,00:03:28,1,False,0,7,-7,43,10,4
2,00:15:00,1,True,7,0,7,8,10,4
2,00:12:55,2,True,7,0,7,46,3,4
2,00:10:51,1,False,0,7,-7,42,10,4
2,00:05:25,1,True,14,7,7,21,10,4
2,00:04:00,1,True,14,7,7,33,10,4
2,00:00:19,2,True,14,7,7,4,15,4
3,00:14:10,2,False,9,14,-5,38,4,4
3,00:11:22,1,False,9,14,-5,5,5,4
3,00:07:31,2,True,21,9,12,44,2,4
3,00:05:44,1,True,21,9,12,4,4,4
3,00:04:13,1,True,21,9,12,1,1,4
3,00:03:56,1,True,21,16,5,30,10,4
3,00:01:31,3,True,21,16,5,52,0,4
3,00:01:16,1,True,21,16,5,52,10,4
3,00:00:01,1,False,16,21,-5,47,10,4
4,00:12:28,2,False,16,22,-6,46,1,4
4,00:09:05,1,False,19,22,-3,47,10,4
4,00:06:00,1,False,19,22,-3,2,2,4
4,00:02:06,2,False,19,29,-10,46,0,4
4,00:01:24,3,True,29,19,10,32,1,4
1,00:14:12,1,True,0,0,0,26,10,4
1,00:13:50,3,True,0,0,0,36,0,4
1,00:12:00,1,False,0,0,0,49,10,4
1,00:10:33,1,True,0,0,0,54,10,4
1,00:10:18,2,True,0,0,0,46,2,4
1,00:09:45,1,True,0,0,0,41,10,4
1,00:06:10,1,True,0,3,-3,47,20,4
1,00:04:24,1,True,0,3,-3,55,10,4
1,00:02:37,1,False,3,7,-4,41,10,4
2,00:14:21,1,False,10,7,3,5,15,4
2,00:12:47,1,True,7,10,-3,49,10,4
2,00:11:48,1,True,7,10,-3,24,10,4
2,00:09:33,1,True,7,11,-4,35,10,4
2,00:08:18,1,False,11,7,4,35,10,4
2,00:07:10,1,False,11,7,4,48,10,4
2,00:06:37,2,False,11,7,4,52,6,4
2,00:06:20,1,True,7,11,-4,49,10,4
2,00:04:24,2,True,7,11,-4,19,10,4
2,00:02:42,1,False,11,14,-3,48,10,4
2,00:00:01,2,False,11,14,-3,36,13,4
3,00:14:53,1,False,11,14,-3,37,10,4
3,00:12:35,1,True,14,11,3,32,10,4
3,00:12:01,2,True,14,11,3,31,11,4
3,00:10:59,1,False,11,14,-3,31,10,4
3,00:10:05,1,False,11,14,-3,49,10,4
3,00:06:35,1,True,14,11,3,25,10,4
3,00:04:26,2,True,14,14,0,33,2,4
3,00:03:40,1,True,14,14,0,35,10,4
3,00:01:17,1,False,14,14,0,7,10,4
4,00:15:00,1,True,21,14,7,39,10,4
4,00:11:21,1,True,21,14,7,24,10,4
4,00:08:05,2,False,17,21,-4,27,5,4
4,00:07:22,1,False,17,21,-4,34,10,4
4,00:04:40,2,False,17,21,-4,51,3,4
4,00:04:09,1,False,17,21,-4,33,10,4
4,00:02:36,1,True,24,17,7,49,10,4
4,00:01:37,1,True,24,17,7,1,1,4
4,00:01:25,2,True,24,17,7,1,1,4
4,00:00:49,1,True,24,24,0,33,10,4
1,00:14:52,1,False,0,0,0,16,10,4
1,00:13:29,1,True,0,0,0,50,10,4
1,00:12:15,1,False,0,0,0,18,10,4
1,00:11:53,2,False,0,0,0,22,6,4
1,00:09:42,1,True,0,0,0,39,10,4
1,00:07:35,2,True,0,0,0,54,2,4
1,00:06:09,1,False,2,0,2,37,10,4
1,00:05:42,2,False,2,0,2,43,4,4
1,00:01:56,1,False,2,0,2,17,10,4
1,00:00:45,1,False,2,0,2,3,3,4
2,00:14:35,1,True,7,2,5,40,10,4
2,00:11:05,1,True,7,3,4,4,4,4
2,00:09:59,2,True,7,3,4,1,1,4
2,00:09:26,1,True,7,10,-3,37,10,4
2,00:08:56,2,True,7,10,-3,47,0,4
2,00:08:18,1,True,7,10,-3,49,10,4
2,00:08:02,1,False,10,7,3,49,10,4
2,00:06:42,1,False,10,7,3,16,10,4
2,00:02:01,1,True,7,10,-3,6,6,4
2,00:01:56,1,True,7,17,-10,43,10,4
2,00:01:18,2,False,17,14,3,44,1,4
3,00:14:51,1,True,14,18,-4,34,10,4
3,00:11:01,1,False,18,14,4,1,1,4
3,00:07:42,1,False,18,21,-3,54,10,4
3,00:07:01,2,False,18,21,-3,45,1,4
3,00:05:40,1,False,18,24,-6,35,10,4
3,00:05:10,2,False,18,24,-6,44,1,4
3,00:02:34,1,True,24,18,6,30,10,4
3,00:01:27,3,True,24,18,6,39,1,4
3,00:00:01,2,True,24,18,6,50,2,4
4,00:15:00,3,True,24,18,6,51,1,4
4,00:11:15,2,True,31,18,13,46,3,4
4,00:10:17,2,True,31,25,6,43,2,4
4,00:08:40,1,False,25,31,-6,30,10,4
4,00:07:35,1,False,25,31,-6,43,10,4
4,00:07:21,1,False,25,31,-6,21,10,4
4,00:06:40,1,False,25,31,-6,10,10,4
4,00:04:10,1,False,25,38,-13,23,10,4
4,00:02:18,1,False,25,41,-16,10,10,4
4,00:01:58,1,False,25,48,-23,28,10,4
4,00:01:52,2,False,25,48,-23,30,8,4
4,00:00:38,1,True,48,25,23,21,10,4
4,00:00:30,2,True,48,25,23,30,1,4
1,00:14:38,1,True,0,0,0,34,10,4
1,00:10:48,2,False,0,0,0,28,2,4
1,00:10:09,3,False,0,0,0,29,1,4
1,00:09:28,1,False,0,0,0,31,10,4
1,00:09:12,2,False,0,0,0,31,10,4
1,00:08:14,1,False,0,0,0,53,10,4
1,00:07:50,2,False,0,0,0,48,5,4
1,00:05:08,1,False,0,3,-3,46,10,4
1,00:01:11,1,True,3,0,3,24,10,4
2,00:14:19,1,True,3,7,-4,50,10,4
2,00:11:12,1,False,7,10,-3,36,10,4
2,00:09:23,1,False,7,10,-3,53,10,4
2,00:04:53,1,False,7,10,-3,28,10,4
2,00:03:46,3,False,7,10,-3,38,0,4
2,00:03:13,1,False,7,10,-3,37,10,4
2,00:02:53,1,False,7,10,-3,26,10,4
2,00:02:34,2,False,7,10,-3,19,3,4
2,00:02:20,3,False,7,10,-3,16,0,4
2,00:01:06,1,True,17,14,3,37,15,4
3,00:12:19,1,False,17,17,0,38,10,4
3,00:11:05,1,True,17,17,0,10,10,4
3,00:07:20,1,True,17,17,0,47,10,4
3,00:07:01,2,True,17,17,0,45,8,4
3,00:04:47,1,True,17,20,-3,35,10,4
3,00:03:13,1,False,20,17,3,42,10,4
3,00:02:21,1,True,17,20,-3,17,10,4
3,00:01:20,1,True,17,23,-6,35,10,4
4,00:14:29,1,True,17,23,-6,5,5,4
4,00:13:40,2,True,17,23,-6,2,2,4
4,00:11:58,1,False,26,17,9,31,10,4
4,00:08:55,1,False,26,20,6,54,10,4
4,00:08:21,2,False,26,20,6,46,2,4
4,00:03:30,1,False,26,20,6,1,1,4
1,00:14:55,1,True,0,0,0,34,10,4
1,00:13:28,1,False,0,0,0,48,10,4
1,00:11:37,1,False,0,0,0,1,1,4
1,00:11:15,1,False,0,7,-7,11,10,4
1,00:07:45,1,False,0,10,-10,47,10,4
1,00:03:52,1,False,0,10,-10,38,10,4
1,00:01:25,1,True,17,0,17,27,10,4
1,00:00:06,1,True,17,0,17,54,10,4
2,00:15:00,2,True,17,0,17,55,9,4
2,00:13:58,1,False,0,17,-17,20,10,4
2,00:08:56,2,True,17,0,17,27,3,4
2,00:08:45,1,True,17,0,17,36,10,4
2,00:05:47,3,True,17,0,17,4,1,4
2,00:04:59,1,True,17,0,17,2,2,4
2,00:03:10,1,False,7,17,-10,37,10,4
2,00:02:32,2,False,7,17,-10,38,19,4
2,00:00:42,2,False,7,17,-10,49,2,4
3,00:13:27,2,False,7,20,-13,35,10,4
3,00:12:22,1,False,7,20,-13,43,10,4
3,00:11:23,1,False,7,20,-13,33,10,4
3,00:10:25,1,False,7,20,-13,1,1,4
3,00:09:08,1,False,7,23,-16,35,10,4
3,00:08:41,2,False,7,23,-16,40,5,4
3,00:07:24,1,True,23,7,16,25,10,4
3,00:03:10,1,True,30,7,23,32,10,4
3,00:02:30,2,True,30,7,23,37,5,4
3,00:00:01,1,False,7,30,-23,11,10,4
4,00:13:19,1,True,30,7,23,25,10,4
4,00:12:47,2,True,30,7,23,33,2,4
4,00:12:05,1,True,30,7,23,39,10,4
4,00:08:46,2,True,37,7,30,41,2,4
4,00:07:39,1,True,37,13,24,47,10,4
4,00:06:33,1,False,13,37,-24,47,10,4
4,00:05:59,2,False,13,37,-24,55,2,4
4,00:05:05,2,True,37,13,24,20,1,4
4,00:04:09,1,True,37,20,17,48,10,4
4,00:01:58,1,True,37,34,3,38,10,4
4,00:00:37,2,False,34,37,-3,50,10,4
1,00:14:42,1,True,0,0,0,49,10,4
1,00:13:05,2,False,0,0,0,26,6,4
1,00:12:21,1,False,0,1,-1,35,10,4
1,00:11:10,0,False,0,1,-1,40,0,4
1,00:09:03,3,False,0,1,-1,13,12,4
1,00:06:15,1,False,0,1,-1,52,10,4
1,00:03:31,1,False,0,8,-8,36,10,4
1,00:02:15,1,True,8,0,8,16,10,4
1,00:00:52,1,False,0,8,-8,42,10,4
2,00:15:00,1,True,8,0,8,54,10,4
2,00:14:31,2,True,8,0,8,45,1,4
2,00:13:53,1,True,8,0,8,25,10,4
2,00:12:47,1,True,8,0,8,7,7,4
2,00:09:59,1,True,8,3,5,45,10,4
2,00:08:18,1,True,8,3,5,42,10,4
2,00:06:53,1,True,8,3,5,29,10,4
2,00:05:20,2,True,8,10,-2,15,1,4
2,00:04:41,3,True,8,10,-2,16,0,4
2,00:02:37,3,False,10,8,2,42,0,4
2,00:00:35,2,True,8,17,-9,26,10,4
3,00:14:49,1,False,17,8,9,35,10,4
3,00:14:26,2,False,17,8,9,40,5,4
3,00:13:12,1,True,8,17,-9,53,10,4
3,00:12:26,1,True,8,17,-9,17,10,4
3,00:10:18,1,False,17,8,9,36,10,4
3,00:09:12,1,False,17,8,9,50,10,4
3,00:08:30,2,True,8,17,-9,54,4,4
3,00:07:43,1,True,8,17,-9,24,10,4
3,00:07:08,2,True,8,17,-9,27,7,4
3,00:05:43,1,False,17,8,9,42,10,4
3,00:02:32,1,False,17,8,9,36,10,4
4,00:15:00,1,True,8,17,-9,45,10,4
4,00:14:29,1,True,8,17,-9,16,10,4
4,00:13:50,2,True,8,17,-9,10,4,4
4,00:08:52,1,False,20,9,11,45,10,4
4,00:07:02,1,True,9,20,-11,27,10,4
4,00:04:42,1,False,20,9,11,23,10,4
4,00:02:39,2,True,9,20,-11,51,3,4
4,00:02:31,1,True,9,20,-11,47,10,4
4,00:02:11,2,True,9,20,-11,45,8,4
4,00:02:05,3,True,9,20,-11,37,0,4
4,00:01:44,1,True,9,20,-11,35,10,4
4,00:01:20,2,True,9,20,-11,30,5,4
4,00:00:48,3,True,9,20,-11,32,7,4
1,00:14:54,1,False,0,0,0,35,10,4
1,00:12:01,1,True,0,0,0,32,10,4
1,00:09:58,1,False,0,0,0,29,10,4
1,00:07:58,1,True,0,0,0,46,10,4
1,00:07:24,1,False,0,0,0,45,10,4
1,00:05:43,1,True,2,0,2,41,10,4
1,00:04:17,1,False,0,2,-2,7,10,4
2,00:14:17,1,False,7,2,5,33,10,4
2,00:10:46,1,False,7,9,-2,27,10,4
2,00:09:28,1,True,9,7,2,32,10,4
2,00:07:41,2,True,9,7,2,16,2,4
2,00:06:51,1,True,9,7,2,8,8,4
2,00:05:24,1,True,9,10,-1,35,10,4
2,00:04:45,2,True,9,10,-1,41,4,4
2,00:04:09,1,True,9,10,-1,47,10,4
3,00:14:31,2,True,9,10,-1,37,0,4
3,00:13:54,1,False,10,9,1,42,10,4
3,00:11:38,1,False,10,10,0,46,10,4
3,00:07:36,1,False,17,10,7,54,10,4
3,00:06:08,1,False,17,10,7,54,10,4
3,00:05:35,2,False,17,10,7,50,6,4
3,00:04:55,1,False,17,10,7,41,10,4
3,00:03:30,2,False,17,10,7,1,1,4
3,00:03:01,1,False,17,17,0,41,10,4
3,00:01:26,1,True,17,17,0,40,10,4
3,00:00:09,1,False,17,17,0,15,10,4
4,00:15:00,2,False,17,17,0,25,0,4
4,00:14:37,1,False,17,17,0,28,10,4
4,00:11:21,1,True,17,17,0,44,10,4
4,00:10:50,2,True,17,17,0,54,0,4
4,00:10:11,1,False,17,17,0,54,10,4
4,00:06:24,1,True,17,17,0,37,10,4
4,00:05:40,2,True,17,17,0,31,4,4
4,00:04:18,2,True,17,20,-3,44,1,4
4,00:01:44,1,True,24,20,4,54,10,4
4,00:01:39,2,False,20,24,-4,49,3,4
4,00:01:18,1,False,20,24,-4,45,10,4
4,00:01:12,2,False,20,24,-4,36,1,4
4,00:00:46,1,False,20,24,-4,32,10,4
1,00:14:52,1,True,0,0,0,29,10,4
1,00:12:07,1,True,0,0,0,21,10,4
1,00:10:57,1,True,0,7,-7,30,10,4
1,00:10:13,2,True,0,7,-7,27,13,4
1,00:06:53,1,True,0,7,-7,40,10,4
1,00:06:16,2,True,0,7,-7,47,3,4
1,00:05:45,1,True,0,7,-7,52,10,4
1,00:04:27,1,False,7,0,7,15,10,4
1,00:03:56,1,False,7,0,7,25,10,4
1,00:03:13,2,False,7,0,7,32,3,4
1,00:02:35,1,False,7,0,7,37,10,4
1,00:01:48,2,False,7,0,7,42,5,4
1,00:01:06,1,False,7,0,7,50,10,4
2,00:11:57,1,True,0,7,-7,50,10,4
2,00:11:04,1,False,7,0,7,28,10,4
2,00:08:25,1,False,7,1,6,8,8,4
2,00:07:54,2,False,7,1,6,1,1,4
2,00:07:35,1,False,7,8,-1,33,10,4
2,00:06:50,2,False,7,8,-1,39,4,4
2,00:02:46,1,False,10,8,2,33,10,4
2,00:02:29,1,False,10,8,2,19,10,4
2,00:01:03,1,True,9,10,-1,54,10,4
3,00:14:53,1,False,10,9,1,28,10,4
3,00:14:13,2,False,10,9,1,33,5,4
3,00:13:23,1,True,9,10,-1,29,10,4
3,00:13:04,2,True,9,10,-1,37,2,4
3,00:06:45,1,True,9,13,-4,53,10,4
3,00:06:11,1,False,13,9,4,21,10,4
4,00:14:43,1,True,9,16,-7,35,10,4
4,00:12:28,1,False,16,9,7,50,10,4
4,00:11:02,1,False,16,9,7,20,10,4
4,00:10:07,1,False,16,9,7,10,10,4
4,00:08:56,1,False,16,12,4,35,10,4
4,00:07:45,1,True,12,16,-4,38,10,4
4,00:04:35,1,False,19,12,7,49,10,4
4,00:03:50,1,True,12,19,-7,45,10,4
4,00:03:30,2,True,12,19,-7,38,3,4
4,00:02:52,1,True,12,19,-7,44,20,4
4,00:01:20,1,True,12,22,-10,48,10,4
4,00:01:00,2,True,12,22,-10,41,3,4
4,00:00:47,1,True,12,22,-10,16,10,4
4,00:00:35,2,True,12,22,-10,16,10,4
1,00:13:37,1,True,0,0,0,42,10,4
1,00:11:49,3,False,0,0,0,44,1,4
1,00:10:51,1,False,0,0,0,20,10,4
1,00:08:45,1,False,0,3,-3,29,10,4
2,00:10:33,2,True,10,5,5,48,12,4
2,00:06:09,1,False,5,17,-12,30,10,4
2,00:04:16,1,True,17,5,12,43,15,4
2,00:04:01,2,True,17,5,12,41,13,4
2,00:02:41,2,True,17,5,12,16,3,4
2,00:01:20,1,True,17,5,12,17,10,4
2,00:00:28,1,True,17,5,12,4,4,4
3,00:07:47,1,False,8,34,-26,32,10,4
3,00:05:24,1,False,8,34,-26,39,10,4
3,00:04:58,2,False,8,34,-26,43,6,4
3,00:02:27,1,True,34,8,26,42,10,4
3,00:02:00,2,True,34,8,26,36,4,4
4,00:14:17,1,True,34,8,26,1,1,4
4,00:05:32,1,False,22,34,-12,38,10,4
4,00:05:08,2,False,22,34,-12,29,1,4
4,00:04:03,1,False,22,37,-15,35,10,4
4,00:01:51,1,True,37,29,8,22,10,4
4,00:01:44,2,True,37,29,8,30,2,4
4,00:01:19,3,True,37,29,8,31,1,4
4,00:01:06,1,True,37,29,8,33,10,4
4,00:01:01,2,True,37,29,8,37,6,4
1,00:11:30,1,True,7,1,6,35,10,4
1,00:11:01,2,True,7,1,6,42,3,4
1,00:09:35,1,False,1,7,-6,38,10,4
1,00:07:15,1,False,1,7,-6,48,10,4
1,00:06:43,2,False,1,7,-6,43,5,4
1,00:06:20,3,False,1,7,-6,38,0,4
1,00:05:45,1,False,1,7,-6,36,10,4
1,00:02:07,2,False,1,10,-9,45,1,4
1,00:01:38,1,False,1,10,-9,46,10,4
1,00:01:12,1,True,10,1,9,46,10,4
2,00:14:06,1,False,2,10,-8,27,10,4
2,00:10:12,1,True,13,2,11,25,10,4
2,00:07:26,1,True,13,2,11,43,10,4
2,00:06:09,1,False,2,13,-11,20,10,4
2,00:04:23,1,False,2,13,-11,50,10,4
2,00:03:18,1,True,13,2,11,43,10,4
2,00:01:29,2,False,5,13,-8,30,15,4
3,00:10:42,1,True,16,8,8,35,10,4
3,00:09:57,2,True,16,8,8,30,15,4
3,00:09:27,1,False,8,16,-8,32,10,4
3,00:06:58,1,False,8,16,-8,1,1,4
3,00:05:27,1,True,23,8,15,21,10,4
4,00:12:30,2,True,30,28,2,23,20,4
4,00:10:40,1,True,30,28,2,44,10,4
4,00:06:54,2,True,30,29,1,24,10,4
4,00:03:33,1,True,30,30,0,35,10,4
4,00:02:46,1,True,30,30,0,22,10,4
4,00:02:20,2,True,30,30,0,23,11,4
4,00:02:01,1,True,30,30,0,11,10,4
1,00:11:10,1,False,0,0,0,29,10,4
1,00:09:23,1,False,0,0,0,12,10,4
1,00:08:47,1,False,0,0,0,1,1,4
1,00:07:17,2,False,0,0,0,1,1,4
1,00:06:52,1,False,0,7,-7,27,10,4
1,00:01:23,1,False,0,7,-7,35,10,4
2,00:13:13,1,False,0,14,-14,54,10,4
2,00:09:39,3,False,0,14,-14,54,1,4
2,00:07:26,1,False,0,14,-14,8,8,4
2,00:00:52,2,True,28,0,28,31,1,4
2,00:00:20,1,True,28,0,28,5,10,4
3,00:14:23,2,False,0,35,-35,53,1,4
3,00:13:19,2,False,0,35,-35,41,5,4
3,00:08:44,1,True,38,0,38,20,10,4
3,00:06:54,1,False,0,38,-38,43,10,4
3,00:02:59,1,False,0,44,-44,35,10,4
3,00:00:22,1,False,0,44,-44,38,10,4
4,00:14:38,2,True,44,0,44,53,1,4
4,00:12:05,1,True,44,0,44,10,10,4
4,00:09:58,1,True,44,0,44,7,10,4
4,00:07:06,1,False,0,44,-44,33,10,4
4,00:03:59,1,False,0,51,-51,30,10,4
4,00:02:28,2,False,0,52,-52,41,4,4
4,00:01:17,1,True,52,0,52,25,10,4
4,00:01:05,2,True,52,0,52,27,8,4
1,00:14:25,1,True,0,0,0,30,15,4
1,00:12:57,1,True,0,0,0,38,10,4
1,00:11:46,1,True,0,0,0,24,10,4
1,00:10:48,1,True,0,0,0,14,10,4
1,00:09:58,2,True,0,0,0,11,7,4
1,00:08:48,2,True,0,0,0,1,1,4
1,00:07:30,2,False,3,7,-4,41,2,4
1,00:05:23,1,True,7,3,4,26,10,4
1,00:04:37,1,True,7,3,4,1,10,4
1,00:02:58,2,True,7,3,4,36,6,4
1,00:02:07,1,True,7,3,4,25,15,4
1,00:01:22,2,True,7,3,4,15,5,4
1,00:00:55,3,True,7,3,4,10,0,4
1,00:00:21,1,True,7,3,4,9,9,4
2,00:13:07,1,False,6,7,-1,53,10,4
2,00:10:44,1,True,7,9,-2,35,10,4
2,00:09:23,1,False,9,7,2,41,10,4
2,00:06:35,1,False,9,7,2,30,10,4
2,00:04:52,1,True,7,9,-2,30,20,4
2,00:04:31,2,True,7,9,-2,46,4,4
2,00:02:33,1,False,9,10,-1,35,10,4
3,00:14:53,1,False,12,10,2,34,10,4
3,00:12:53,0,False,12,10,2,41,0,4
3,00:11:30,1,False,12,10,2,21,10,4
3,00:10:13,1,False,12,10,2,3,3,4
3,00:09:45,1,True,17,12,5,50,10,4
3,00:05:35,1,True,17,13,4,20,10,4
3,00:05:01,2,True,17,13,4,22,8,4
3,00:03:21,1,False,13,17,-4,53,10,4
3,00:02:21,1,False,13,17,-4,21,10,4
3,00:00:35,1,False,13,17,-4,45,10,4
3,00:00:01,2,False,13,17,-4,37,2,4
4,00:15:00,1,False,13,17,-4,33,10,4
4,00:13:07,1,False,13,17,-4,3,3,4
4,00:12:45,1,True,24,13,11,52,10,4
4,00:11:32,1,True,24,13,11,18,10,4
4,00:06:11,1,True,25,13,12,45,10,4
4,00:05:09,1,True,25,13,12,13,10,4
4,00:02:38,1,True,25,13,12,40,10,4
4,00:02:31,2,True,25,13,12,40,10,4
4,00:01:16,1,False,13,25,-12,53,10,4
1,00:14:02,1,False,0,0,0,24,10,4
1,00:13:07,1,False,0,0,0,13,10,4
1,00:12:47,1,False,0,0,0,2,2,4
1,00:11:54,2,False,0,0,0,1,1,4
1,00:11:33,1,False,0,7,-7,34,10,4
1,00:09:15,2,True,7,0,7,41,6,4
1,00:08:05,1,False,0,7,-7,39,10,4
1,00:07:34,2,False,0,7,-7,44,5,4
1,00:04:09,3,True,7,3,4,38,1,4
1,00:02:57,1,True,7,3,4,32,5,4
1,00:01:50,1,True,7,10,-3,30,10,4
2,00:14:44,1,False,10,7,3,21,10,4
2,00:11:01,1,True,7,10,-3,19,10,4
2,00:08:30,1,True,7,11,-4,35,10,4
2,00:07:18,1,False,11,7,4,23,10,4
2,00:06:32,1,False,11,7,4,39,10,4
2,00:05:09,1,True,7,11,-4,28,10,4
2,00:03:25,1,True,7,11,-4,52,10,4
2,00:02:52,2,True,7,11,-4,47,5,4
2,00:01:57,2,True,7,14,-7,15,30,4
2,00:01:29,3,False,14,7,7,50,1,4
3,00:12:48,1,False,14,7,7,3,10,4
3,00:08:23,1,False,14,9,5,12,10,4
3,00:05:27,2,False,14,16,-2,54,1,4
3,00:03:40,1,False,14,23,-9,49,10,4
3,00:03:06,2,True,23,14,9,54,3,4
3,00:02:23,3,True,23,14,9,53,2,4
3,00:01:36,2,True,23,14,9,26,2,4
4,00:14:19,1,True,23,14,9,1,1,4
4,00:13:37,1,False,21,23,-2,53,10,4
4,00:12:53,2,False,21,23,-2,46,3,4
4,00:12:33,3,False,21,23,-2,44,1,4
4,00:12:06,1,False,21,23,-2,41,10,4
4,00:10:11,1,False,21,23,-2,47,10,4
4,00:06:18,1,False,21,23,-2,36,10,4
4,00:04:03,1,True,23,21,2,45,10,4
4,00:03:50,1,True,23,21,2,29,10,4
4,00:01:20,1,True,23,24,-1,48,10,4
4,00:00:57,1,True,23,24,-1,35,10,4
4,00:00:29,2,True,23,24,-1,34,9,4
4,00:00:03,3,True,23,24,-1,32,7,4
1,00:12:43,1,True,0,7,-7,44,10,4
1,00:11:44,2,True,0,7,-7,41,13,4
1,00:07:53,1,False,7,3,4,54,10,4
1,00:07:11,2,False,7,3,4,47,17,4
1,00:06:13,1,True,3,8,-5,35,10,4
1,00:04:20,1,False,8,3,5,1,10,4
1,00:03:06,1,False,8,3,5,44,10,4
1,00:02:25,1,False,8,3,5,28,10,4
2,00:14:40,1,False,8,6,2,24,10,4
2,00:12:52,1,False,8,6,2,13,10,4
2,00:12:13,1,False,8,6,2,35,10,4
2,00:10:28,1,True,6,8,-2,30,10,4
2,00:07:54,1,False,8,13,-5,44,5,4
2,00:06:11,1,True,13,8,5,23,10,4
2,00:04:49,1,True,13,8,5,49,10,4
2,00:04:04,2,True,13,8,5,45,14,4
2,00:01:36,1,True,13,8,5,25,10,4
2,00:00:45,1,True,13,8,5,12,10,4
3,00:12:25,1,True,13,15,-2,50,10,4
3,00:11:35,1,False,15,13,2,31,10,4
3,00:07:38,1,True,13,22,-9,24,10,4
3,00:01:09,1,False,22,16,6,49,10,4
3,00:00:41,1,False,22,16,6,39,10,4
4,00:15:00,2,False,22,16,6,19,1,4
4,00:13:27,1,False,22,19,3,35,10,4
4,00:12:07,1,True,19,22,-3,34,10,4
4,00:10:17,1,True,19,22,-3,47,10,4
4,00:07:12,1,True,19,22,-3,9,10,4
4,00:04:51,1,True,19,22,-3,24,10,4
4,00:00:46,1,False,22,26,-4,42,10,4
1,00:14:45,1,False,0,0,0,35,10,4
1,00:07:27,1,False,0,8,-8,35,10,4
1,00:06:08,3,False,0,8,-8,44,1,4
1,00:04:04,1,True,8,0,8,16,10,4
1,00:02:39,1,True,8,0,8,1,1,4
1,00:01:37,2,True,8,0,8,1,1,4
1,00:00:02,1,False,7,8,-1,54,10,4
2,00:14:27,1,False,7,8,-1,17,10,4
2,00:12:27,3,False,7,8,-1,40,1,4
2,00:10:49,1,False,7,8,-1,51,20,4
2,00:09:39,1,True,8,14,-6,32,10,4
2,00:08:06,1,False,14,8,6,33,10,4
2,00:07:22,2,False,14,8,6,42,1,4
2,00:02:15,1,False,14,8,6,28,10,4
2,00:02:13,2,False,14,8,6,29,9,4
2,00:01:11,2,True,8,14,-6,45,5,4
2,00:00:38,2,False,14,8,6,31,10,4
2,00:00:21,1,True,8,14,-6,10,10,4
3,00:14:55,1,True,8,17,-9,40,10,4
3,00:10:31,1,False,17,8,9,19,10,4
3,00:06:19,1,True,15,17,-2,5,5,4
3,00:04:08,2,True,15,20,-5,55,2,4
3,00:03:43,3,False,20,15,5,54,1,4
3,00:03:03,1,False,20,15,5,52,10,4
3,00:01:52,1,False,20,15,5,21,10,4
3,00:00:48,1,False,20,15,5,43,10,4
4,00:10:56,1,True,15,27,-12,46,10,4
4,00:09:36,1,False,27,22,5,29,10,4
4,00:08:38,1,False,27,22,5,45,10,4
4,00:06:25,1,False,27,22,5,48,10,4
4,00:05:30,1,False,27,22,5,35,10,4
4,00:04:31,1,False,27,22,5,14,10,4
4,00:02:45,1,False,27,22,5,5,10,4
4,00:01:53,1,False,27,22,5,48,10,4
4,00:01:48,2,True,22,27,-5,54,2,4
1,00:14:11,2,True,0,0,0,36,1,4
1,00:12:54,1,False,0,0,0,38,10,4
1,00:11:42,1,False,0,0,0,36,10,4
1,00:07:30,1,True,7,0,7,55,10,4
1,00:06:43,2,False,0,7,-7,44,10,4
1,00:06:17,1,False,0,7,-7,28,10,4
1,00:02:38,2,False,0,10,-10,27,10,4
1,00:01:16,1,False,0,17,-17,29,10,4
1,00:00:40,2,False,0,17,-17,36,3,4
1,00:00:01,1,False,0,17,-17,39,10,4
2,00:15:00,2,False,0,17,-17,47,2,4
2,00:12:49,1,False,0,17,-17,23,10,4
2,00:10:00,1,True,17,0,17,26,10,4
2,00:09:43,2,True,17,0,17,31,5,4
2,00:09:02,1,True,17,0,17,42,10,4
2,00:07:31,1,False,0,17,-17,41,10,4
2,00:03:23,1,True,17,0,17,46,10,4
2,00:02:44,1,True,17,0,17,15,10,4
2,00:01:46,2,True,17,3,14,40,5,4
2,00:00:18,2,True,24,3,21,52,4,4
3,00:13:37,1,False,3,24,-21,44,10,4
3,00:12:09,1,True,24,3,21,15,10,4
3,00:05:50,1,False,3,24,-21,50,10,4
3,00:04:43,1,True,24,3,21,45,10,4
3,00:01:28,2,True,24,4,20,44,1,4
4,00:11:14,1,True,25,4,21,37,10,4
4,00:09:37,1,True,25,7,18,35,10,4
4,00:09:05,2,True,25,7,18,40,5,4
4,00:06:35,1,True,25,7,18,12,10,4
4,00:05:36,1,True,25,7,18,50,10,4
4,00:04:50,2,True,25,7,18,42,2,4
4,00:03:54,2,True,25,7,18,28,1,4
4,00:03:18,3,True,25,7,18,27,0,4
4,00:02:36,2,True,25,7,18,18,2,4
4,00:01:48,1,True,25,7,18,43,10,4
4,00:01:29,2,True,25,7,18,44,9,4
4,00:01:15,1,True,25,7,18,54,10,4
4,00:01:00,2,True,25,7,18,55,9,4
4,00:00:25,1,False,7,25,-18,15,10,4
1,00:13:31,1,True,0,0,0,40,10,4
1,00:11:55,1,True,0,0,0,3,3,4
1,00:11:04,2,True,0,7,-7,34,7,4
1,00:06:22,1,True,3,14,-11,54,10,4
1,00:04:55,1,True,3,14,-11,26,10,4
1,00:02:28,1,False,14,3,11,3,3,4
1,00:01:30,1,False,14,10,4,29,10,4
2,00:14:25,1,False,14,11,3,35,10,4
2,00:13:49,1,False,14,11,3,51,10,4
2,00:11:33,1,True,11,14,-3,28,10,4
2,00:08:56,2,True,11,17,-6,27,3,4
2,00:02:39,1,False,20,13,7,44,10,4
2,00:01:53,1,True,13,20,-7,51,10,4
2,00:01:23,1,True,13,20,-7,32,10,4
2,00:00:35,1,True,13,20,-7,22,10,4
2,00:00:12,1,True,13,20,-7,5,5,4
3,00:13:19,1,False,23,20,3,29,10,4
3,00:09:03,1,False,23,27,-4,20,10,4
3,00:04:40,2,True,30,24,6,43,2,4
3,00:04:12,1,True,30,24,6,46,10,4
4,00:14:32,1,True,33,24,9,13,10,4
4,00:07:00,1,True,33,31,2,42,10,4
4,00:05:12,2,True,33,31,2,28,6,4
4,00:04:28,1,True,33,34,-1,35,10,4
4,00:03:05,1,False,34,33,1,43,10,4
4,00:02:39,1,True,33,34,-1,46,10,4
4,00:01:54,1,True,33,34,-1,30,10,4
4,00:01:24,1,True,33,37,-4,43,10,4
4,00:01:19,2,True,33,37,-4,40,7,4
1,00:14:22,1,False,0,0,0,42,10,4
1,00:12:48,1,True,0,1,-1,35,10,4
1,00:10:28,1,True,0,1,-1,1,1,4
1,00:10:04,1,True,0,8,-8,44,10,4
1,00:06:33,1,True,0,11,-11,35,10,4
1,00:05:43,1,True,0,11,-11,45,10,4
1,00:03:34,1,False,11,0,11,10,10,4
2,00:13:59,1,False,11,3,8,12,10,4
2,00:08:20,2,False,11,3,8,42,3,4
2,00:07:45,3,False,11,3,8,39,0,4
2,00:00:49,1,False,12,20,-8,5,10,4
2,00:00:44,2,False,12,20,-8,14,1,4
3,00:13:50,1,False,12,20,-8,27,10,4
3,00:11:10,1,False,12,20,-8,16,10,4
3,00:09:56,3,False,12,20,-8,7,1,4
3,00:09:24,1,False,12,20,-8,6,6,4
3,00:08:32,2,False,12,20,-8,2,2,4
3,00:04:22,1,False,12,23,-11,47,10,4
3,00:00:44,1,True,23,12,11,28,10,4
4,00:09:12,1,True,23,23,0,28,10,4
4,00:07:58,1,True,23,23,0,2,2,4
4,00:03:31,1,False,30,23,7,42,5,4
4,00:03:00,1,False,30,23,7,53,10,4
4,00:02:36,2,True,23,30,-7,48,1,4
4,00:02:06,1,True,23,30,-7,46,10,4
4,00:01:47,1,True,23,30,-7,33,10,4
4,00:01:23,2,True,23,30,-7,31,8,4
4,00:00:33,1,False,31,23,8,20,10,4
1,00:14:55,1,True,0,0,0,27,10,4
1,00:06:53,1,True,8,7,1,35,10,4
1,00:06:25,1,True,8,7,1,19,10,4
1,00:05:50,1,True,8,7,1,6,6,4
1,00:00:05,2,True,8,21,-13,44,2,4
2,00:15:00,1,True,8,21,-13,46,10,4
2,00:13:59,2,True,8,21,-13,53,3,4
2,00:13:49,1,False,21,15,6,45,10,4
2,00:12:07,2,True,15,21,-6,50,10,4
2,00:10:19,1,True,15,21,-6,24,10,4
2,00:04:45,1,False,24,22,2,42,10,4
2,00:04:15,2,False,24,22,2,35,3,4
2,00:03:00,1,False,24,25,-1,24,10,4
2,00:02:01,1,True,25,24,1,34,10,4
2,00:00:46,2,True,25,31,-6,36,17,4
3,00:13:47,1,True,25,31,-6,35,10,4
3,00:09:32,1,False,34,32,2,38,10,4
3,00:09:01,2,False,34,32,2,47,1,4
3,00:07:01,2,True,32,34,-2,42,1,4
3,00:06:18,1,True,32,34,-2,30,10,4
3,00:02:22,1,True,32,34,-2,53,10,4
4,00:11:29,1,True,32,34,-2,50,10,4
4,00:09:36,2,False,34,32,2,38,1,4
4,00:07:16,1,False,34,32,2,25,10,4
4,00:04:45,1,False,34,39,-5,41,10,4
4,00:04:15,2,False,34,39,-5,50,1,4
4,00:02:33,1,True,39,34,5,28,10,4
4,00:01:48,3,True,39,34,5,37,1,4
4,00:01:27,1,True,39,34,5,39,10,4
1,00:13:55,1,False,0,0,0,6,10,4
1,00:12:27,1,True,2,0,2,53,10,4
1,00:11:19,1,False,0,2,-2,42,10,4
1,00:08:51,1,False,0,5,-5,35,10,4
1,00:08:35,2,False,0,5,-5,43,2,4
1,00:05:58,1,True,5,0,5,17,10,4
1,00:01:33,1,True,5,0,5,52,10,4
1,00:00:01,1,True,5,0,5,7,10,4
2,00:13:29,1,True,5,0,5,31,10,4
2,00:09:31,1,False,0,8,-8,35,10,4
2,00:09:05,2,False,0,8,-8,42,3,4
2,00:08:00,1,True,8,0,8,14,10,4
2,00:07:15,2,True,8,0,8,23,1,4
2,00:06:39,3,True,8,0,8,24,0,4
2,00:04:56,1,True,8,0,8,36,10,4
2,00:00:29,1,False,0,15,-15,28,10,4
3,00:13:39,2,False,0,15,-15,26,11,4
3,00:07:11,1,True,15,0,15,38,10,4
3,00:05:10,2,True,15,0,15,8,5,4
3,00:04:16,1,True,15,0,15,2,2,4
3,00:02:41,1,True,15,7,8,41,10,4
3,00:00:00,1,False,7,15,-8,1,1,4
4,00:11:38,3,False,7,22,-15,14,0,4
4,00:08:43,2,False,7,22,-15,14,14,4
4,00:06:33,1,True,29,14,15,46,10,4
4,00:05:13,1,False,14,29,-15,45,10,4
4,00:03:11,2,False,14,29,-15,25,10,4
4,00:00:46,1,False,14,36,-22,53,10,4
4,00:00:39,2,False,14,36,-22,52,9,4
1,00:14:54,1,True,0,0,0,35,10,4
1,00:14:15,2,True,0,0,0,43,2,4
1,00:12:30,1,False,0,0,0,50,10,4
1,00:11:25,2,False,0,0,0,20,3,4
1,00:10:40,1,False,0,0,0,11,10,4
1,00:09:25,1,False,0,7,-7,30,10,4
1,00:08:42,2,False,0,7,-7,39,1,4
1,00:07:49,1,True,7,0,7,33,10,4
1,00:06:58,2,True,7,0,7,44,10,4
1,00:05:38,1,False,0,7,-7,29,10,4
1,00:05:01,0,True,7,0,7,31,0,4
1,00:02:02,1,True,16,0,16,41,10,4
2,00:15:00,1,False,0,16,-16,20,10,4
2,00:13:26,2,False,0,16,-16,29,13,4
2,00:11:28,1,True,16,0,16,21,10,4
2,00:09:34,1,True,16,6,10,36,10,4
2,00:08:15,1,False,6,16,-10,48,10,4
2,00:06:14,1,False,6,16,-10,1,1,4
2,00:04:33,1,True,23,6,17,51,10,4
2,00:00:42,1,True,31,6,25,18,10,4
2,00:00:35,2,True,31,6,25,27,1,4
3,00:12:03,1,True,31,6,25,40,10,4
3,00:09:37,1,True,31,21,10,35,10,4
3,00:07:22,2,False,21,31,-10,37,2,4
3,00:05:48,2,True,31,21,10,33,3,4
3,00:05:13,1,True,31,21,10,38,10,4
3,00:04:12,1,False,21,31,-10,32,10,4
3,00:03:17,1,False,21,31,-10,18,10,4
3,00:02:11,2,False,21,31,-10,11,3,4
3,00:01:09,1,True,38,21,17,49,10,4
4,00:15:00,1,True,38,21,17,33,10,4
4,00:08:51,2,False,24,38,-14,46,4,4
4,00:07:59,1,False,24,38,-14,41,10,4
4,00:07:12,2,False,24,38,-14,34,3,4
4,00:04:43,1,False,24,41,-17,47,10,4
4,00:03:39,1,False,24,41,-17,28,10,4
4,00:03:00,2,False,24,41,-17,22,4,4
4,00:02:16,1,False,24,44,-20,35,10,4
4,00:02:10,1,False,24,44,-20,46,10,4
4,00:01:50,2,False,24,44,-20,54,2,4
1,00:14:18,2,True,0,0,0,41,1,4
1,00:13:44,3,True,0,0,0,41,1,4
1,00:09:43,1,False,0,0,0,1,1,4
1,00:02:37,1,False,0,14,-14,16,10,4
1,00:02:12,2,False,0,14,-14,25,1,4
1,00:01:26,1,True,14,0,14,42,10,4
1,00:00:43,1,False,0,14,-14,11,10,4
2,00:13:37,1,False,0,17,-17,46,10,4
2,00:13:02,2,False,0,17,-17,52,4,4
2,00:09:30,1,True,20,0,20,41,10,4
2,00:06:53,1,True,20,3,17,35,10,4
2,00:04:47,1,True,20,3,17,49,10,4
3,00:12:14,1,True,27,11,16,38,10,4
3,00:11:38,2,True,27,11,16,38,10,4
3,00:10:24,2,False,11,27,-16,45,0,4
3,00:09:35,2,False,11,27,-16,55,2,4
3,00:07:32,1,True,27,11,16,31,10,4
3,00:05:44,2,False,11,27,-16,36,1,4
3,00:04:31,1,False,11,27,-16,19,10,4
3,00:02:19,1,True,27,14,13,35,10,4
3,00:00:30,1,False,14,27,-13,55,10,4
4,00:15:00,3,True,27,14,13,45,0,4
4,00:14:26,1,True,27,14,13,43,10,4
4,00:07:51,3,True,27,17,10,42,2,4
4,00:05:48,1,True,27,17,10,1,1,4
4,00:05:31,1,True,27,24,3,34,10,4
4,00:05:08,2,True,27,24,3,43,1,4
4,00:04:14,1,False,24,27,-3,45,10,4
4,00:03:08,1,False,24,27,-3,28,10,4
4,00:01:58,1,True,27,24,3,50,10,4
4,00:01:50,2,True,27,24,3,53,7,4
5,00:15:00,1,True,27,27,0,9,9,4
1,00:13:50,1,False,0,0,0,47,10,4
1,00:12:28,1,True,0,0,0,23,10,4
1,00:11:50,2,True,0,0,0,14,1,4
1,00:10:25,1,True,0,0,0,19,19,4
1,00:10:02,1,True,0,7,-7,20,10,4
1,00:08:38,1,True,0,7,-7,34,10,4
1,00:07:47,1,True,0,7,-7,45,10,4
1,00:06:55,2,True,0,7,-7,44,11,4
1,00:05:00,1,True,0,7,-7,42,5,4
1,00:04:12,2,True,0,7,-7,39,2,4
1,00:03:50,1,True,0,7,-7,34,10,4
1,00:00:41,1,True,0,14,-14,15,10,4
2,00:13:38,1,True,0,14,-14,6,10,4
2,00:11:49,1,False,14,0,14,45,10,4
2,00:09:23,2,False,15,0,15,29,10,4
2,00:06:19,1,True,1,15,-14,25,10,4
2,00:05:28,1,True,1,15,-14,50,10,4
2,00:05:09,2,False,15,1,14,51,1,4
2,00:04:23,1,False,15,1,14,46,10,4
2,00:03:11,1,False,15,1,14,14,10,4
2,00:02:47,2,False,15,1,14,22,2,4
2,00:00:19,1,True,1,15,-14,8,10,4
3,00:13:32,1,True,1,22,-21,53,10,4
3,00:10:35,1,True,1,29,-28,30,10,4
3,00:09:03,1,True,1,36,-35,32,10,4
3,00:07:43,1,False,36,4,32,21,10,4
3,00:06:10,1,True,4,36,-32,39,10,4
3,00:04:01,1,False,36,4,32,7,10,4
3,00:01:56,1,True,6,36,-30,53,10,4
3,00:01:14,2,True,6,36,-30,45,2,4
4,00:15:00,1,True,6,36,-30,18,10,4
4,00:11:56,1,False,39,6,33,27,10,4
4,00:10:43,1,False,39,6,33,46,10,4
4,00:03:59,1,False,39,12,27,17,10,4
4,00:03:21,2,False,39,12,27,21,6,4
4,00:01:31,1,False,39,15,24,35,10,4
4,00:01:25,2,False,39,15,24,36,9,4
4,00:00:46,1,False,39,15,24,51,10,4
1,00:14:03,1,False,0,0,0,38,5,4
1,00:13:45,2,False,0,0,0,42,1,4
1,00:12:30,1,True,0,0,0,45,10,4
1,00:09:50,2,False,0,0,0,12,2,4
1,00:09:09,1,False,0,0,0,9,9,4
1,00:08:22,1,False,0,3,-3,35,10,4
1,00:06:25,2,True,3,0,3,30,3,4
1,00:04:51,1,True,3,0,3,16,10,4
1,00:02:30,1,False,0,3,-3,5,10,4
2,00:15:00,1,True,3,0,3,15,10,4
2,00:14:36,2,True,3,0,3,7,2,4
2,00:13:40,3,True,3,0,3,5,0,4
2,00:12:42,1,True,3,0,3,4,4,4
2,00:12:02,2,True,3,7,-4,36,3,4
2,00:09:39,2,True,3,7,-4,47,5,4
2,00:09:11,3,True,3,7,-4,43,1,4
2,00:05:32,1,False,8,3,5,37,10,4
2,00:03:54,1,True,3,8,-5,42,10,4
2,00:02:57,1,False,8,3,5,52,10,4
2,00:02:49,1,False,8,3,5,41,10,4
2,00:01:37,1,False,8,3,5,10,10,4
2,00:01:33,2,False,8,3,5,16,4,4
2,00:00:05,1,True,3,8,-5,39,10,4
2,00:00:01,2,True,3,8,-5,36,13,4
3,00:13:07,1,False,8,3,5,41,10,4
3,00:12:43,1,True,3,8,-5,52,10,4
3,00:11:44,1,True,3,8,-5,51,10,4
3,00:08:35,1,True,3,8,-5,46,10,4
3,00:07:04,1,False,8,3,5,31,10,4
3,00:04:39,1,True,3,8,-5,49,10,4
3,00:01:53,1,False,8,4,4,35,10,4
4,00:11:49,1,True,4,9,-5,35,10,4
4,00:11:36,1,True,4,9,-5,45,10,4
4,00:08:42,1,False,9,4,5,50,10,4
4,00:06:03,1,True,4,9,-5,1,1,4
4,00:02:01,1,False,16,11,5,36,10,4
4,00:01:52,1,False,16,11,5,54,10,4
4,00:01:07,1,True,11,16,-5,23,10,4
4,00:01:00,2,True,11,16,-5,22,9,4
1,00:11:07,1,False,0,0,0,4,10,4
1,00:08:04,1,True,0,0,0,53,10,4
1,00:07:02,1,False,0,0,0,8,8,4
1,00:05:55,1,False,0,7,-7,33,10,4
1,00:04:04,1,True,7,0,7,34,10,4
1,00:02:25,1,False,0,7,-7,50,10,4
1,00:01:25,1,False,0,7,-7,25,10,4
2,00:13:45,2,False,0,10,-10,25,2,4
2,00:13:08,1,False,0,10,-10,30,10,4
2,00:12:29,2,False,0,10,-10,34,6,4
2,00:10:35,1,False,0,10,-10,28,10,4
2,00:07:40,1,True,13,0,13,50,10,4
2,00:04:48,1,True,13,3,10,27,10,4
2,00:04:11,2,True,13,3,10,37,0,4
2,00:02:46,1,True,13,3,10,54,10,4
3,00:11:57,1,True,14,3,11,27,10,4
3,00:11:37,1,True,14,3,11,40,10,4
3,00:08:25,1,False,3,14,-11,28,10,4
3,00:06:51,3,False,3,14,-11,19,1,4
3,00:06:37,1,False,3,14,-11,15,10,4
3,00:02:10,2,True,17,3,14,12,2,4
3,00:01:07,1,True,17,3,14,7,7,4
4,00:13:20,2,True,17,6,11,29,1,4
4,00:12:01,1,True,17,9,8,23,10,4
4,00:11:35,2,True,17,9,8,30,3,4
4,00:11:00,3,True,17,9,8,33,0,4
4,00:09:37,2,True,17,9,8,34,12,4
4,00:06:38,2,False,9,17,-8,32,1,4
4,00:06:00,1,False,9,17,-8,9,9,4
4,00:04:24,1,False,9,17,-8,4,4,4
4,00:03:35,3,False,9,24,-15,48,3,4
4,00:03:16,1,False,9,24,-15,49,10,4
1,00:14:01,1,False,0,0,0,27,10,4
1,00:11:55,2,True,0,0,0,7,2,4
1,00:11:18,1,True,0,7,-7,36,10,4
1,00:10:23,1,True,0,7,-7,55,10,4
1,00:09:12,1,False,7,0,7,43,10,4
1,00:05:56,2,False,7,3,4,45,0,4
1,00:04:16,1,True,3,7,-4,9,10,4
1,00:01:39,2,True,3,7,-4,28,2,4
1,00:00:01,2,True,3,7,-4,17,2,4
2,00:13:26,1,True,3,14,-11,54,10,4
2,00:11:35,2,False,14,3,11,8,8,4
2,00:07:46,1,False,14,11,3,35,10,4
2,00:05:47,1,True,11,14,-3,19,10,4
2,00:04:48,1,True,11,14,-3,30,10,4
2,00:04:00,3,True,11,14,-3,39,1,4
2,00:02:41,2,False,14,11,3,28,0,4
2,00:01:04,2,True,14,14,0,49,2,4
2,00:00:39,2,True,14,14,0,36,2,4
3,00:14:01,2,True,14,21,-7,50,1,4
3,00:13:25,1,True,14,21,-7,53,10,4
3,00:12:51,1,False,21,14,7,39,10,4
3,00:12:26,2,False,21,14,7,32,3,4
3,00:11:40,1,False,21,17,4,35,10,4
3,00:09:02,1,True,17,21,-4,52,10,4
3,00:07:54,1,False,21,17,4,35,10,4
3,00:07:17,2,False,21,17,4,26,1,4
3,00:05:02,2,False,21,20,1,44,1,4
3,00:04:04,1,False,21,20,1,45,10,4
3,00:01:45,1,True,20,21,-1,42,10,4
4,00:15:00,2,False,21,20,1,48,6,4
4,00:14:40,1,False,21,20,1,40,10,4
4,00:13:20,1,False,21,20,1,3,3,4
4,00:12:50,1,False,21,28,-7,33,10,4
4,00:10:05,1,False,21,28,-7,52,10,4
4,00:07:59,1,False,21,28,-7,40,10,4
4,00:07:34,2,False,21,28,-7,33,3,4
4,00:03:25,1,True,35,21,14,27,10,4
4,00:03:14,2,True,35,21,14,32,5,4
4,00:03:00,1,True,35,21,14,43,10,4
4,00:02:33,1,True,35,21,14,55,10,4
4,00:02:10,2,False,21,35,-14,53,8,4
4,00:02:04,1,False,21,35,-14,45,10,4
1,00:12:37,2,False,0,0,0,24,4,4
1,00:11:41,1,False,0,0,0,40,10,4
1,00:09:18,1,False,9,0,9,49,10,4
1,00:08:52,1,True,0,9,-9,43,10,4
1,00:07:50,0,False,9,0,9,16,0,4
1,00:05:17,1,False,16,0,16,7,7,4
1,00:03:56,1,False,16,0,16,1,1,4
1,00:00:21,2,False,16,7,9,11,10,4
2,00:15:00,1,False,16,7,9,27,10,4
2,00:14:01,1,False,16,7,9,41,10,4
2,00:11:27,1,False,16,7,9,53,10,4
2,00:11:05,2,True,7,16,-9,51,4,4
2,00:09:53,1,True,7,16,-9,45,10,4
2,00:08:23,2,False,16,7,9,40,2,4
2,00:06:07,1,False,16,10,6,35,10,4
2,00:04:35,1,True,10,16,-6,55,10,4
2,00:02:54,2,False,16,10,6,14,10,4
2,00:01:15,1,False,16,13,3,35,10,4
2,00:00:34,1,True,13,16,-3,32,10,4
2,00:00:29,2,True,13,16,-3,33,9,4
3,00:14:23,1,True,13,16,-3,48,10,4
3,00:12:53,1,False,16,13,3,11,10,4
3,00:05:18,2,False,23,13,10,40,4,4
3,00:03:25,2,True,13,23,-10,25,1,4
3,00:02:40,1,True,13,23,-10,27,10,4
3,00:01:59,2,True,13,23,-10,35,2,4
3,00:00:39,1,True,13,23,-10,31,20,4
4,00:09:49,2,True,13,23,-10,12,2,4
4,00:08:37,3,True,13,30,-17,40,0,4
4,00:08:11,1,True,13,30,-17,41,10,4
4,00:06:12,1,False,30,20,10,50,10,4
4,00:03:24,1,False,30,20,10,51,10,4
4,00:02:27,1,False,30,20,10,44,10,4
4,00:02:23,2,False,30,20,10,45,9,4
1,00:11:12,2,True,0,0,0,45,1,4
1,00:10:48,3,True,0,0,0,45,1,4
1,00:07:48,1,False,0,0,0,31,10,4
1,00:05:39,1,False,0,3,-3,30,10,4
1,00:02:45,1,True,3,0,3,36,10,4
1,00:01:00,1,False,7,3,4,46,10,4
1,00:00:40,1,False,7,3,4,16,10,4
2,00:10:35,1,False,7,10,-3,41,10,4
2,00:08:05,1,False,7,10,-3,48,10,4
2,00:04:28,2,True,10,7,3,28,2,4
2,00:03:32,3,True,10,7,3,27,1,4
2,00:02:20,1,True,10,10,0,38,10,4
2,00:01:34,2,False,10,10,0,33,0,4
3,00:14:00,2,True,13,10,3,29,1,4
3,00:12:40,2,True,13,10,3,17,2,4
3,00:11:17,1,True,13,10,3,1,1,4
3,00:10:50,1,True,13,16,-3,30,10,4
3,00:10:28,2,True,13,16,-3,35,5,4
3,00:08:17,2,False,16,13,3,44,2,4
3,00:07:14,2,False,16,13,3,55,2,4
3,00:06:04,2,True,13,16,-3,43,0,4
3,00:04:37,2,True,13,16,-3,34,2,4
3,00:02:35,1,False,19,13,6,50,10,4
4,00:14:07,2,True,15,19,-4,53,2,4
4,00:12:19,1,False,19,15,4,13,10,4
4,00:10:54,1,False,19,15,4,1,1,4
4,00:08:46,1,False,19,22,-3,48,10,4
4,00:07:41,1,False,19,22,-3,32,10,4
4,00:04:16,3,False,19,25,-6,54,1,4
4,00:02:59,1,False,19,25,-6,41,10,4
4,00:02:09,1,False,19,25,-6,17,10,4
4,00:00:46,1,True,28,19,9,34,10,4
1,00:14:21,1,True,0,0,0,34,10,4
1,00:12:06,1,False,0,0,0,44,10,4
1,00:10:53,1,False,0,3,-3,33,10,4
1,00:10:15,2,False,0,3,-3,32,11,4
1,00:09:53,1,False,0,3,-3,49,10,4
1,00:09:08,1,True,3,0,3,25,10,4
1,00:07:20,1,False,0,3,-3,40,10,4
1,00:05:28,1,False,0,4,-4,50,10,4
1,00:04:11,1,True,4,0,4,47,10,4
1,00:03:28,1,True,4,0,4,15,10,4
2,00:14:36,1,False,7,11,-4,47,10,4
2,00:13:16,1,True,11,7,4,32,10,4
2,00:11:54,1,False,7,11,-4,40,10,4
2,00:11:09,2,False,7,11,-4,50,0,4
2,00:09:50,0,False,7,11,-4,50,0,4
2,00:08:58,1,True,11,7,4,43,10,4
2,00:07:30,1,True,11,7,4,2,10,4
2,00:05:58,1,False,14,11,3,44,10,4
2,00:04:36,1,True,11,14,-3,45,10,4
2,00:02:28,1,True,11,14,-3,25,10,4
3,00:14:37,1,False,21,14,7,28,10,4
3,00:14:27,2,False,21,14,7,35,3,4
3,00:13:31,1,False,21,14,7,48,10,4
3,00:13:07,2,True,14,21,-7,52,0,4
3,00:10:25,2,True,14,22,-8,44,1,4
3,00:09:40,1,True,14,22,-8,45,10,4
3,00:05:33,2,True,14,29,-15,51,3,4
3,00:04:45,1,True,14,29,-15,54,10,4
3,00:03:48,1,False,29,14,15,15,10,4
3,00:02:06,1,False,29,14,15,36,10,4
3,00:01:10,1,True,14,29,-15,45,10,4
3,00:00:29,2,True,14,29,-15,38,3,4
3,00:00:01,1,True,14,29,-15,32,10,4
4,00:15:00,2,True,14,29,-15,25,3,4
4,00:14:01,1,True,14,29,-15,10,10,4
4,00:12:07,1,True,14,32,-18,46,10,4
4,00:11:26,2,True,14,32,-18,55,1,4
4,00:09:44,1,False,32,21,11,35,10,4
4,00:09:00,2,False,32,21,11,39,6,4
4,00:06:29,2,False,32,21,11,55,1,4
4,00:06:17,1,True,21,32,-11,46,10,4
4,00:05:24,2,True,21,32,-11,42,6,4
4,00:03:02,1,True,21,32,-11,42,10,4
4,00:02:15,2,True,21,32,-11,37,5,4
4,00:00:45,3,False,39,21,18,38,10,4
4,00:00:23,1,False,39,21,18,2,10,4
1,00:12:49,1,True,0,0,0,17,10,4
1,00:10:54,1,True,0,7,-7,33,10,4
1,00:09:48,2,False,7,0,7,52,3,4
1,00:06:21,1,False,7,3,4,14,10,4
1,00:04:51,1,False,7,10,-3,27,10,4
1,00:03:57,1,False,7,10,-3,39,10,4
1,00:02:36,1,True,10,7,3,50,10,4
1,00:01:14,1,False,7,11,-4,35,10,4
1,00:00:20,2,False,7,11,-4,44,1,4
2,00:14:29,1,True,11,8,3,35,10,4
2,00:12:10,2,False,8,11,-3,20,2,4
2,00:11:10,1,False,8,11,-3,12,5,4
2,00:09:04,3,False,8,11,-3,1,1,4
2,00:07:49,1,True,18,8,10,49,10,4
2,00:05:22,1,True,18,15,3,7,10,4
2,00:03:25,2,True,18,15,3,55,3,4
2,00:01:37,2,True,18,15,3,45,4,4
2,00:00:59,2,True,18,15,3,38,10,4
2,00:00:22,1,True,18,15,3,2,10,4
3,00:14:01,1,False,15,18,-3,42,10,4
3,00:11:39,1,True,25,15,10,47,10,4
3,00:10:08,1,False,22,25,-3,39,10,4
3,00:09:00,1,False,22,25,-3,20,10,4
3,00:07:27,1,False,22,25,-3,37,10,4
3,00:06:24,1,False,22,25,-3,47,10,4
3,00:06:00,1,True,25,22,3,52,10,4
3,00:03:36,1,True,25,25,0,40,10,4
3,00:02:57,2,True,25,25,0,47,3,4
4,00:14:42,1,False,25,25,0,5,10,4
4,00:11:57,1,True,25,25,0,31,10,4
4,00:05:41,1,False,32,25,7,30,10,4
4,00:02:08,1,False,32,26,6,40,10,4
4,00:02:03,2,False,32,26,6,45,5,4
4,00:01:38,1,False,32,26,6,55,10,4
4,00:01:17,2,True,26,32,-6,51,6,4
1,00:11:58,2,True,0,0,0,48,1,4
1,00:09:42,3,False,0,0,0,32,1,4
1,00:06:54,1,False,0,7,-7,31,10,4
1,00:05:10,1,True,7,0,7,40,10,4
1,00:03:16,2,True,7,0,7,34,2,4
1,00:02:04,1,True,7,0,7,17,10,4
1,00:00:33,1,True,7,3,4,35,10,4
2,00:14:38,1,False,3,7,-4,23,10,4
2,00:14:12,2,False,3,7,-4,30,3,4
2,00:10:01,1,True,7,6,1,35,10,4
2,00:08:42,1,False,6,7,-1,40,10,4
2,00:05:30,1,True,7,6,1,21,10,4
2,00:02:38,2,True,7,13,-6,50,2,4
2,00:02:27,3,True,7,13,-6,52,0,4
2,00:00:50,1,False,13,7,6,17,10,4
2,00:00:40,2,False,13,7,6,22,5,4
2,00:00:06,1,False,13,7,6,39,10,4
3,00:14:54,1,True,7,13,-6,37,10,4
3,00:11:20,1,True,7,13,-6,16,10,4
3,00:08:54,1,True,7,16,-9,35,10,4
3,00:08:36,2,True,7,16,-9,36,9,4
3,00:06:01,1,False,16,7,9,30,10,4
3,00:04:25,1,True,7,16,-9,47,10,4
3,00:03:03,1,True,7,16,-9,36,10,4
3,00:00:49,3,True,7,19,-12,44,1,4
4,00:14:26,1,False,19,7,12,20,10,4
4,00:14:05,2,False,19,7,12,28,2,4
4,00:12:23,2,True,7,19,-12,50,3,4
4,00:09:05,1,False,19,7,12,43,10,4
4,00:07:56,1,True,7,19,-12,47,10,4
4,00:02:05,1,True,14,19,-5,50,10,4
4,00:01:59,1,True,14,19,-5,39,10,4
4,00:01:33,2,True,14,19,-5,34,5,4
1,00:14:03,1,False,7,0,7,54,10,4
1,00:11:01,2,False,7,7,0,45,2,4
1,00:10:23,1,False,7,7,0,49,10,4
1,00:08:46,2,True,7,7,0,26,1,4
1,00:05:28,1,False,15,7,8,29,10,4
1,00:04:20,1,False,15,7,8,32,10,4
1,00:02:56,1,False,15,7,8,10,10,4
2,00:15:00,1,False,15,7,8,14,10,4
2,00:13:05,1,True,7,15,-8,45,10,4
2,00:11:33,1,True,7,15,-8,26,10,4
2,00:07:53,3,True,7,15,-8,17,1,4
2,00:06:53,1,True,7,15,-8,28,10,4
2,00:05:29,1,True,7,18,-11,32,10,4
2,00:01:44,2,True,7,33,-26,53,2,4
3,00:14:55,1,False,33,14,19,39,10,4
3,00:14:15,2,False,33,14,19,46,3,4
3,00:12:31,1,True,14,33,-19,17,10,4
3,00:10:36,1,True,14,33,-19,1,1,4
3,00:10:12,1,True,14,40,-26,34,10,4
3,00:08:48,1,False,40,14,26,41,10,4
3,00:04:36,3,True,14,40,-26,27,1,4
3,00:02:44,1,True,14,40,-26,44,10,4
3,00:01:48,1,True,14,40,-26,32,10,4
3,00:00:41,1,True,14,40,-26,17,10,4
4,00:13:42,3,True,14,47,-33,38,0,4
4,00:12:10,1,True,14,47,-33,5,10,4
4,00:10:09,1,True,14,50,-36,35,10,4
4,00:08:39,1,False,50,14,36,39,10,4
4,00:05:09,1,False,50,17,33,50,10,4
4,00:04:04,1,True,17,50,-33,5,10,4
4,00:02:39,1,True,17,50,-33,47,10,4
4,00:01:02,1,True,17,53,-36,45,10,4
4,00:00:57,2,True,17,53,-36,41,6,4
1,00:14:10,2,True,0,0,0,42,5,4
1,00:13:36,3,True,0,0,0,47,0,4
1,00:12:29,1,False,0,7,-7,19,10,4
1,00:11:50,2,False,0,7,-7,27,2,4
1,00:08:12,1,False,0,7,-7,31,5,4
1,00:04:10,1,False,0,7,-7,52,10,4
2,00:13:35,1,False,0,9,-9,35,10,4
2,00:10:49,1,False,6,9,-3,35,10,4
2,00:10:12,2,False,6,9,-3,40,5,4
2,00:08:40,1,True,9,6,3,42,10,4
2,00:07:54,2,True,9,6,3,35,3,4
2,00:02:25,1,True,9,6,3,7,7,4
3,00:14:59,1,False,13,13,0,35,10,4
3,00:13:40,1,True,13,13,0,48,10,4
3,00:13:10,2,True,13,13,0,49,9,4
3,00:10:51,1,True,14,13,1,55,10,4
3,00:05:35,1,False,13,17,-4,35,10,4
3,00:03:41,2,True,17,13,4,50,3,4
3,00:02:30,1,False,13,17,-4,19,10,4
3,00:00:25,1,True,17,13,4,46,10,4
4,00:09:39,1,False,13,18,-5,32,10,4
4,00:08:09,1,False,13,18,-5,19,10,4
4,00:05:43,1,False,13,25,-12,48,10,4
4,00:03:53,2,True,25,13,12,27,1,4
4,00:03:10,2,True,25,13,12,18,2,4
4,00:02:40,1,True,25,13,12,15,10,4
4,00:02:04,1,False,20,25,-5,36,10,4
4,00:01:22,1,True,25,20,5,34,10,4
4,00:01:20,2,True,25,20,5,35,9,4
4,00:01:13,1,True,25,20,5,45,10,4
4,00:00:24,1,False,20,25,-5,33,10,4
1,00:13:41,1,False,0,0,0,23,10,4
1,00:13:05,2,False,0,0,0,30,3,4
1,00:12:18,1,True,0,0,0,31,10,4
1,00:11:41,2,True,0,0,0,37,4,4
1,00:09:22,3,False,0,0,0,53,1,4
1,00:07:27,3,False,0,0,0,43,1,4
1,00:06:46,1,False,0,0,0,40,10,4
1,00:06:00,2,False,0,0,0,32,2,4
1,00:05:10,1,False,0,0,0,30,10,4
1,00:03:05,2,False,0,3,-3,22,2,4
1,00:01:10,1,False,0,3,-3,24,10,4
1,00:00:45,2,False,0,3,-3,32,2,4
1,00:00:01,1,False,0,3,-3,35,10,4
2,00:14:40,2,False,0,3,-3,44,1,4
2,00:13:54,1,False,0,3,-3,48,10,4
2,00:10:11,1,True,3,0,3,48,10,4
2,00:08:51,1,True,3,0,3,26,10,4
2,00:08:25,2,True,3,0,3,35,1,4
2,00:07:55,1,True,3,0,3,41,10,4
2,00:05:53,2,True,3,0,3,47,15,4
2,00:05:03,1,False,0,3,-3,30,10,4
2,00:03:49,1,False,0,3,-3,33,10,4
2,00:02:32,1,False,0,3,-3,47,10,4
2,00:01:20,2,True,3,0,3,39,11,4
3,00:14:08,2,False,1,3,-2,37,3,4
3,00:11:35,1,True,3,1,2,29,10,4
3,00:10:57,1,True,3,1,2,19,10,4
3,00:08:44,1,False,8,3,5,35,10,4
3,00:07:42,1,False,8,3,5,55,10,4
3,00:07:14,2,True,3,8,-5,47,2,4
3,00:06:34,1,True,3,8,-5,44,10,4
3,00:06:08,1,True,3,8,-5,32,10,4
3,00:05:33,2,True,3,8,-5,23,1,4
3,00:03:45,1,True,3,15,-12,39,10,4
3,00:03:11,1,True,3,15,-12,50,10,4
3,00:02:15,2,True,3,15,-12,40,20,4
3,00:01:37,1,False,15,3,12,14,10,4
4,00:15:00,1,True,3,15,-12,39,10,4
4,00:13:39,1,True,3,15,-12,11,10,4
4,00:12:50,2,True,3,15,-12,21,0,4
4,00:11:06,1,True,3,15,-12,41,10,4
4,00:09:28,1,False,15,3,12,29,10,4
4,00:08:09,1,False,15,3,12,43,10,4
4,00:07:15,1,False,15,3,12,55,10,4
4,00:05:15,2,True,3,15,-12,5,14,4
4,00:04:44,1,False,17,3,14,35,10,4
4,00:04:05,2,False,17,3,14,32,13,4
4,00:02:39,2,False,17,3,14,40,0,4
4,00:02:22,2,False,17,3,14,43,15,4
4,00:01:58,1,False,17,3,14,22,10,4
4,00:01:35,2,False,17,3,14,23,9,4
1,00:14:35,1,False,0,0,0,52,10,4
1,00:12:07,1,False,0,0,0,31,10,4
1,00:11:55,2,False,0,0,0,34,7,4
1,00:09:20,1,True,0,0,0,34,10,4
1,00:08:00,1,True,0,0,0,50,10,4
1,00:07:23,2,True,0,0,0,54,6,4
1,00:05:43,1,False,0,0,0,18,10,4
1,00:02:10,2,False,0,1,-1,45,1,4
1,00:01:33,1,False,0,1,-1,42,10,4
1,00:00:01,1,False,0,1,-1,43,10,4
2,00:15:00,2,False,0,1,-1,51,2,4
2,00:09:12,2,True,1,14,-13,38,23,4
2,00:08:05,2,False,14,1,13,39,1,4
2,00:07:07,2,False,14,1,13,50,1,4
2,00:06:36,3,False,14,1,13,51,0,4
2,00:04:41,1,True,1,14,-13,34,10,4
2,00:02:51,2,False,14,1,13,19,20,4
2,00:02:22,1,True,1,14,-13,54,10,4
2,00:00:26,1,False,17,4,13,33,10,4
2,00:00:20,2,False,17,4,13,35,8,4
3,00:14:54,1,False,17,4,13,28,10,4
3,00:12:08,1,False,17,4,13,40,10,4
3,00:11:13,1,True,4,17,-13,43,10,4
3,00:07:32,1,True,4,20,-16,49,10,4
3,00:06:52,1,True,4,20,-16,39,10,4
3,00:05:45,1,True,4,20,-16,25,10,4
3,00:03:27,3,True,4,20,-16,16,1,4
3,00:00:00,1,False,27,4,23,1,1,4
4,00:14:33,2,False,27,11,16,41,2,4
4,00:08:08,1,True,11,35,-24,46,10,4
4,00:05:50,2,False,35,11,24,16,10,4
4,00:04:45,1,False,35,11,24,15,10,4
4,00:03:20,1,False,35,11,24,15,10,4
4,00:02:43,1,False,35,11,24,47,10,4
4,00:02:30,2,False,35,11,24,48,9,4
4,00:01:44,1,True,11,35,-24,11,10,4
4,00:01:32,1,True,11,35,-24,39,10,4
4,00:01:09,1,False,35,11,24,52,10,4
4,00:00:50,2,False,35,11,24,45,3,4
4,00:00:09,2,False,35,11,24,37,10,4
1,00:13:31,1,False,0,0,0,34,10,4
1,00:10:36,2,True,3,0,3,45,1,4
1,00:09:24,1,True,3,0,3,44,10,4
1,00:06:32,1,True,3,7,-4,35,10,4
1,00:04:51,1,False,7,3,4,33,10,4
1,00:02:50,1,False,7,3,4,45,10,4
1,00:01:32,1,False,7,3,4,31,10,4
2,00:14:30,2,False,7,6,1,40,3,4
2,00:13:07,1,True,6,7,-1,35,10,4
2,00:12:42,2,True,6,7,-1,40,5,4
2,00:11:13,1,False,7,6,1,37,10,4
2,00:10:33,2,False,7,6,1,38,9,4
2,00:04:56,2,False,14,6,8,48,2,4
2,00:04:02,1,True,6,14,-8,21,10,4
2,00:01:23,1,True,6,14,-8,1,1,4
2,00:01:14,2,True,6,21,-15,15,15,4
3,00:13:51,2,True,6,21,-15,50,0,4
3,00:11:45,1,True,6,21,-15,22,10,4
3,00:10:41,2,True,6,21,-15,18,6,4
3,00:10:21,1,True,6,28,-22,39,10,4
3,00:07:45,1,False,28,6,22,31,10,4
3,00:06:42,1,True,6,28,-22,28,10,4
3,00:05:17,1,True,6,31,-25,22,10,4
3,00:04:47,2,True,6,31,-25,27,5,4
3,00:02:24,1,False,31,6,25,23,10,4
3,00:00:32,1,False,31,6,25,15,10,4
4,00:13:40,1,True,9,31,-22,20,10,4
4,00:11:48,1,True,9,32,-23,37,10,4
4,00:10:13,1,True,9,32,-23,4,10,4
4,00:08:34,1,True,9,32,-23,27,10,4
4,00:07:10,1,True,9,32,-23,17,10,4
4,00:06:24,2,True,9,32,-23,17,10,4
4,00:05:27,1,True,9,35,-26,35,10,4
4,00:04:25,3,True,9,35,-26,44,1,4
4,00:02:50,1,False,35,9,26,11,10,4
4,00:02:18,1,False,35,9,26,6,15,4
4,00:02:14,2,False,35,9,26,7,14,4
4,00:01:20,2,False,35,11,24,54,1,4
4,00:00:29,1,False,35,11,24,1,1,4
1,00:14:42,1,True,0,0,0,31,10,4
1,00:14:16,2,True,0,0,0,38,3,4
1,00:12:56,1,False,0,0,0,47,10,4
1,00:10:02,1,False,0,0,0,30,10,4
1,00:07:39,1,False,0,0,0,42,10,4
1,00:04:27,1,True,0,1,-1,47,10,4
1,00:03:20,1,False,1,0,1,51,10,4
1,00:02:42,2,False,1,0,1,51,10,4
1,00:00:44,1,True,1,1,0,3,3,4
1,00:00:22,2,True,1,1,0,1,1,4
2,00:15:00,3,True,1,1,0,1,1,4
2,00:12:32,1,True,1,3,-2,35,10,4
2,00:11:05,1,True,1,3,-2,25,10,4
2,00:10:40,1,True,1,3,-2,38,10,4
2,00:05:06,1,True,1,3,-2,37,10,4
2,00:03:55,1,True,1,3,-2,53,10,4
3,00:12:43,1,True,4,4,0,35,10,4
3,00:06:44,1,False,4,4,0,25,10,4
3,00:04:47,3,False,4,4,0,49,1,4
3,00:01:21,1,False,4,11,-7,54,10,4
4,00:10:08,1,False,11,11,0,40,10,4
4,00:04:56,1,True,14,12,2,35,10,4
4,00:04:11,2,True,14,12,2,40,5,4
4,00:02:50,1,False,12,14,-2,15,10,4
4,00:01:43,1,True,17,12,5,37,10,4
1,00:14:54,1,False,0,0,0,36,10,4
1,00:13:31,1,True,0,0,0,35,10,4
1,00:11:00,1,False,0,0,0,46,10,4
1,00:10:17,1,True,0,0,0,36,10,4
1,00:08:52,1,True,0,0,0,2,2,4
1,00:08:20,1,True,0,7,-7,21,10,4
1,00:07:28,1,True,0,7,-7,34,10,4
1,00:01:14,1,True,0,17,-17,22,10,4
1,00:00:40,1,True,0,17,-17,4,4,4
1,00:00:00,2,True,0,17,-17,4,4,4
2,00:14:14,2,True,0,24,-24,47,2,4
2,00:12:44,3,False,24,0,24,51,1,4
2,00:09:47,1,False,24,3,21,35,10,4
2,00:09:23,1,False,24,3,21,48,10,4
2,00:07:53,1,True,3,24,-21,30,10,4
2,00:07:17,1,True,3,24,-21,43,10,4
2,00:03:30,1,False,24,10,14,8,10,4
2,00:02:43,1,False,24,10,14,22,10,4
3,00:14:52,1,True,19,24,-5,46,10,4
3,00:13:10,1,False,24,19,5,22,10,4
3,00:10:02,2,False,24,22,2,42,3,4
3,00:09:15,1,False,24,22,2,51,10,4
3,00:05:40,1,False,24,22,2,34,10,4
3,00:03:20,2,False,24,28,-4,50,4,4
3,00:02:35,3,False,24,28,-4,47,1,4
3,00:01:12,1,False,24,28,-4,21,10,4
4,00:12:46,1,True,35,24,11,27,10,4
4,00:11:00,1,True,35,24,11,24,10,4
4,00:09:00,1,True,35,27,8,50,10,4
4,00:07:44,3,False,27,35,-8,50,0,4
4,00:07:18,1,False,27,35,-8,49,10,4
4,00:05:51,1,False,27,35,-8,20,10,4
4,00:05:17,2,False,27,35,-8,17,7,4
4,00:02:55,1,True,38,27,11,42,10,4
4,00:01:58,1,False,27,38,-11,36,10,4
4,00:01:52,2,False,27,38,-11,31,5,4
1,00:13:47,1,True,0,0,0,54,10,4
1,00:12:34,3,False,0,0,0,47,1,4
1,00:10:52,1,False,0,0,0,29,10,4
1,00:09:53,1,False,0,0,0,11,10,4
1,00:08:35,1,False,0,0,0,22,10,4
1,00:06:49,1,True,0,0,0,47,10,4
1,00:06:15,2,True,0,0,0,46,9,4
1,00:05:09,1,True,0,3,-3,37,10,4
1,00:03:47,1,False,3,0,3,39,10,4
1,00:01:37,2,True,0,3,-3,31,2,4
1,00:00:15,1,True,0,3,-3,50,10,4
2,00:14:35,2,False,3,0,3,51,1,4
2,00:11:13,1,True,3,3,0,50,10,4
2,00:08:39,1,False,3,3,0,13,10,4
2,00:08:15,1,False,3,10,-7,39,10,4
2,00:07:15,1,False,3,10,-7,52,10,4
2,00:06:50,1,True,10,3,7,40,10,4
2,00:04:31,1,True,10,3,7,12,10,4
2,00:03:29,2,True,10,3,7,3,1,4
2,00:01:21,1,False,10,10,0,16,10,4
2,00:01:10,2,False,10,10,0,22,4,4
2,00:00:38,1,True,10,10,0,20,10,4
2,00:00:29,2,True,10,10,0,24,6,4
3,00:13:38,1,False,10,10,0,37,10,4
3,00:10:08,2,False,10,17,-7,21,20,4
3,00:09:14,1,True,17,10,7,51,10,4
3,00:05:11,1,False,10,17,-7,1,1,4
3,00:04:51,1,False,10,24,-14,30,10,4
3,00:03:43,3,False,10,24,-14,40,0,4
3,00:03:10,1,False,10,24,-14,45,10,4
3,00:00:01,2,True,24,10,14,5,0,4
4,00:13:13,1,True,24,13,11,45,10,4
4,00:12:26,2,True,24,13,11,43,12,4
4,00:10:43,1,False,13,24,-11,44,10,4
4,00:09:26,1,False,13,24,-11,40,10,4
4,00:08:09,1,True,24,14,10,36,10,4
4,00:07:32,2,True,24,14,10,44,2,4
4,00:06:42,1,True,24,14,10,48,10,4
4,00:05:59,2,True,24,14,10,49,9,4
4,00:05:02,1,False,14,24,-10,8,10,4
4,00:04:03,1,False,14,24,-10,14,10,4
4,00:03:20,2,False,14,24,-10,7,3,4
4,00:02:49,3,False,14,24,-10,4,0,4
4,00:02:42,1,False,14,24,-10,3,3,4
4,00:02:00,2,False,14,24,-10,4,4,4
4,00:01:06,1,False,21,31,-10,48,10,4
4,00:00:58,1,False,21,31,-10,33,10,4
1,00:14:59,1,True,0,0,0,45,10,4
1,00:10:03,1,True,0,3,-3,51,10,4
1,00:08:42,1,False,3,0,3,25,10,4
1,00:05:58,1,False,3,0,3,44,10,4
1,00:02:10,1,False,3,0,3,31,10,4
2,00:13:02,2,False,3,1,2,53,0,4
2,00:09:45,2,True,1,3,-2,54,1,4
2,00:07:36,1,False,3,2,1,35,10,4
2,00:06:43,1,True,2,3,-1,48,10,4
2,00:05:54,1,True,2,3,-1,30,10,4
2,00:05:33,2,True,2,3,-1,22,2,4
2,00:04:56,3,True,2,3,-1,21,1,4
2,00:01:50,2,False,6,2,4,40,3,4
3,00:12:14,1,False,6,9,-3,34,10,4
3,00:11:09,1,False,6,9,-3,20,10,4
3,00:10:03,1,False,6,9,-3,8,8,4
3,00:08:26,1,False,6,12,-6,14,10,4
3,00:06:53,1,False,6,12,-6,40,10,4
4,00:13:31,1,False,21,12,9,25,10,4
4,00:09:50,1,False,21,15,6,35,10,4
4,00:07:50,1,True,15,21,-6,16,10,4
4,00:07:17,3,True,15,21,-6,25,1,4
4,00:05:02,1,False,21,15,6,43,10,4
4,00:02:40,2,False,21,15,6,35,10,4
4,00:00:11,1,True,22,21,1,35,10,4
1,00:13:05,1,False,0,0,0,52,10,4
1,00:12:31,2,False,0,0,0,45,3,4
1,00:12:06,1,False,0,0,0,39,10,4
1,00:08:00,1,True,0,0,0,21,10,4
1,00:07:02,1,True,0,0,0,35,10,4
1,00:04:03,1,True,0,0,0,39,10,4
1,00:03:38,1,True,0,0,0,50,10,4
2,00:12:39,1,True,3,0,3,34,10,4
2,00:10:42,2,False,0,3,-3,34,1,4
2,00:09:49,2,False,0,3,-3,37,10,4
2,00:08:39,1,False,0,3,-3,48,10,4
2,00:08:08,2,False,0,3,-3,41,3,4
2,00:07:10,1,False,0,6,-6,35,10,4
2,00:06:58,2,False,0,6,-6,42,3,4
3,00:13:13,1,True,16,0,16,23,10,4
3,00:10:10,1,True,16,0,16,19,10,4
3,00:07:38,1,False,0,16,-16,54,10,4
3,00:06:20,3,True,16,0,16,46,0,4
3,00:04:17,1,True,16,0,16,25,10,4
3,00:01:51,1,False,0,16,-16,46,10,4
4,00:12:32,1,False,0,30,-30,25,10,4
4,00:11:23,3,False,0,30,-30,35,0,4
4,00:09:53,1,True,30,0,30,44,10,4
4,00:09:14,1,False,0,30,-30,52,10,4
4,00:08:33,1,False,0,30,-30,40,10,4
4,00:07:11,1,False,0,30,-30,29,10,4
4,00:02:53,1,True,37,0,37,44,10,4
4,00:02:03,1,False,0,37,-37,36,10,4
4,00:01:56,2,False,0,37,-37,30,4,4
4,00:01:25,1,False,0,37,-37,25,10,4
4,00:00:55,2,False,0,37,-37,15,0,4
1,00:12:00,1,False,0,0,0,40,10,4
1,00:11:31,1,False,0,0,0,30,10,4
1,00:10:02,1,False,0,3,-3,35,10,4
1,00:07:24,1,True,3,3,0,46,10,4
1,00:05:22,1,False,3,3,0,17,15,4
1,00:04:07,1,False,3,3,0,18,10,4
1,00:03:00,1,False,3,3,0,2,2,4
1,00:00:12,1,True,10,3,7,47,10,4
2,00:08:42,1,False,3,13,-10,40,5,4
2,00:06:48,1,True,13,3,10,19,10,4
2,00:06:09,1,True,13,6,7,35,10,4
2,00:04:34,1,False,6,13,-7,20,10,4
2,00:02:49,1,True,13,6,7,49,10,4
2,00:02:37,2,False,6,13,-7,53,2,4
2,00:02:17,1,False,6,13,-7,49,10,4
2,00:00:46,1,False,6,13,-7,13,10,4
3,00:10:03,1,True,20,13,7,24,10,4
3,00:08:42,1,False,13,20,-7,50,10,4
3,00:07:13,1,True,20,13,7,34,10,4
3,00:06:50,1,False,13,20,-7,54,10,4
3,00:06:01,2,False,13,20,-7,45,1,4
3,00:05:24,1,False,13,20,-7,20,10,4
3,00:03:39,1,False,13,23,-10,35,10,4
3,00:00:13,1,False,13,23,-10,31,10,4
4,00:13:18,1,True,26,13,13,40,10,4
4,00:11:02,1,True,26,27,-1,28,10,4
4,00:08:57,1,False,27,26,1,45,10,4
4,00:07:32,1,False,27,26,1,1,11,4
4,00:06:09,1,False,27,26,1,29,10,4
4,00:05:40,1,False,27,26,1,11,10,4
4,00:04:12,1,False,27,29,-2,35,10,4
4,00:02:29,1,False,27,29,-2,25,10,4
4,00:02:23,2,False,27,29,-2,17,2,4
4,00:01:59,1,False,27,29,-2,4,4,4
4,00:01:40,2,False,27,29,-2,2,2,4
4,00:00:28,1,True,32,27,5,5,5,4
4,00:00:01,2,True,32,27,5,1,1,4
1,00:10:15,2,False,0,0,0,55,0,4
1,00:09:43,1,True,0,0,0,53,10,4
1,00:08:12,1,True,0,1,-1,35,10,4
1,00:07:13,2,True,0,1,-1,49,10,4
1,00:06:12,1,False,1,0,1,15,10,4
1,00:05:01,1,False,1,0,1,26,10,4
1,00:03:36,1,True,0,1,-1,31,10,4
1,00:02:18,1,True,0,8,-8,37,10,4
1,00:00:33,1,False,8,0,8,11,10,4
2,00:12:21,1,False,8,7,1,33,10,4
2,00:05:54,1,False,11,14,-3,37,10,4
2,00:05:15,2,False,11,14,-3,46,1,4
2,00:04:36,3,False,11,14,-3,47,0,4
2,00:02:44,1,True,14,11,3,28,10,4
2,00:02:24,1,True,14,11,3,14,10,4
2,00:02:03,2,True,14,11,3,15,11,4
2,00:01:05,2,True,14,14,0,30,15,4
2,00:00:09,1,True,14,14,0,25,10,4
3,00:14:56,1,False,17,14,3,28,10,4
3,00:13:14,1,True,14,17,-3,52,10,4
3,00:12:45,1,True,14,17,-3,42,10,4
3,00:12:05,2,True,14,17,-3,33,1,4
3,00:10:47,2,True,14,17,-3,17,2,4
3,00:09:13,1,True,14,24,-10,28,10,4
3,00:09:03,1,True,14,24,-10,38,10,4
3,00:08:30,2,True,14,24,-10,45,3,4
3,00:05:44,1,False,24,14,10,55,10,4
3,00:05:13,2,True,14,24,-10,47,2,4
3,00:03:37,2,True,14,24,-10,25,1,4
3,00:02:45,1,True,14,27,-13,35,10,4
3,00:02:15,2,True,14,27,-13,40,5,4
3,00:01:43,1,True,14,27,-13,45,10,4
4,00:11:18,1,False,34,17,17,9,10,4
4,00:10:50,2,False,34,17,17,15,4,4
4,00:08:20,1,True,17,34,-17,47,10,4
4,00:06:51,1,True,17,34,-17,34,10,4
4,00:05:44,1,True,17,34,-17,23,10,4
4,00:05:07,2,True,17,34,-17,18,5,4
4,00:04:16,1,True,17,37,-20,35,10,4
4,00:03:10,3,True,17,37,-20,43,2,4
4,00:01:39,1,False,37,17,20,1,1,4
4,00:01:19,2,False,37,17,20,2,2,4
4,00:01:18,1,True,24,37,-13,45,10,4
4,00:01:13,2,True,24,37,-13,44,9,4
1,00:14:49,1,True,0,0,0,26,10,4
1,00:12:55,1,False,0,0,0,15,10,4
1,00:11:29,1,False,0,3,-3,13,10,4
1,00:10:26,1,True,3,0,3,49,10,4
1,00:09:45,2,True,3,0,3,54,5,4
1,00:07:24,1,False,0,10,-10,49,10,4
1,00:03:12,1,True,10,0,10,12,10,4
1,00:01:41,1,True,10,3,7,42,10,4
1,00:00:30,1,False,3,10,-7,37,10,4
2,00:13:29,1,False,5,10,-5,46,10,4
2,00:12:49,2,False,5,10,-5,53,3,4
2,00:11:04,1,True,10,12,-2,12,10,4
2,00:08:43,1,False,12,10,2,52,10,4
2,00:05:53,1,False,12,17,-5,55,10,4
2,00:05:15,1,True,17,12,5,35,10,4
2,00:03:02,1,False,19,17,2,51,10,4
2,00:01:20,2,False,26,17,9,30,13,4
2,00:00:29,2,True,17,26,-9,23,18,4
3,00:12:55,1,True,17,26,-9,32,10,4
3,00:12:34,1,True,17,26,-9,12,10,4
3,00:10:54,2,True,17,29,-12,43,2,4
3,00:09:18,1,False,29,17,12,27,10,4
3,00:08:45,2,False,29,17,12,33,4,4
3,00:08:16,1,False,29,17,12,42,10,4
3,00:04:17,1,True,17,29,-12,25,10,4
3,00:03:25,1,True,17,29,-12,7,7,4
3,00:02:04,2,True,17,32,-15,42,3,4
4,00:14:45,1,False,32,20,12,35,10,4
4,00:10:30,3,False,32,20,12,1,1,4
4,00:08:57,1,False,32,20,12,46,10,4
4,00:07:56,3,False,32,20,12,55,1,4
4,00:07:10,1,True,20,32,-12,53,10,4
4,00:06:25,2,True,20,32,-12,45,2,4
4,00:05:46,3,True,20,32,-12,43,0,4
4,00:04:47,1,True,20,32,-12,47,15,4
4,00:02:56,2,True,20,32,-12,38,3,4
4,00:01:30,1,False,32,20,12,43,10,4
4,00:01:23,2,False,32,20,12,48,5,4
1,00:12:24,1,True,0,0,0,25,10,4
1,00:11:31,1,True,0,0,0,46,10,4
1,00:10:14,0,False,0,0,0,42,0,4
1,00:05:20,1,False,3,0,3,15,10,4
1,00:05:00,2,False,3,0,3,25,0,4
1,00:03:22,1,False,3,0,3,26,10,4
1,00:00:58,1,False,3,0,3,43,10,4
1,00:00:30,2,False,3,0,3,35,2,4
1,00:00:01,3,False,3,0,3,33,0,4
2,00:14:13,2,False,3,0,3,26,3,4
2,00:12:46,1,False,3,7,-4,49,10,4
2,00:11:33,2,True,7,3,4,39,3,4
2,00:11:10,1,True,7,3,4,32,10,4
2,00:07:31,1,False,6,7,-1,40,10,4
2,00:03:56,1,False,6,14,-8,39,10,4
2,00:02:22,1,True,14,6,8,48,10,4
2,00:01:48,1,True,14,6,8,12,10,4
2,00:01:41,1,True,14,6,8,24,10,4
2,00:00:30,1,False,6,14,-8,42,10,4
3,00:14:48,1,True,14,6,8,36,10,4
3,00:13:39,1,False,6,14,-8,43,10,4
3,00:12:26,3,False,6,14,-8,53,0,4
3,00:10:46,3,True,14,6,8,42,1,4
3,00:09:25,1,True,14,6,8,11,10,4
3,00:06:16,2,False,9,14,-5,28,2,4
3,00:04:32,2,False,9,21,-12,28,3,4
3,00:03:18,2,False,9,21,-12,39,3,4
3,00:02:20,1,True,21,9,12,25,10,4
4,00:09:37,2,True,24,12,12,52,2,4
4,00:07:15,1,True,24,12,12,26,10,4
4,00:05:26,1,True,24,12,12,55,10,4
4,00:04:43,2,False,12,24,-12,49,4,4
4,00:03:04,1,False,12,24,-12,1,1,4
4,00:02:24,2,False,12,24,-12,1,1,4
4,00:02:16,1,False,12,31,-19,21,10,4
4,00:01:50,1,False,12,31,-19,29,15,4
4,00:01:43,2,False,12,31,-19,25,11,4
4,00:00:56,1,False,12,31,-19,11,10,4
4,00:00:51,1,False,12,38,-26,22,10,4
4,00:00:18,3,False,12,38,-26,53,10,4
1,00:11:40,1,False,0,0,0,45,10,4
1,00:10:26,1,False,0,1,-1,35,10,4
1,00:07:36,1,True,1,0,1,12,10,4
1,00:06:11,1,True,1,0,1,51,10,4
1,00:04:13,1,True,1,1,0,36,10,4
2,00:13:20,1,True,8,1,7,25,10,4
2,00:12:41,2,True,8,1,7,32,3,4
2,00:12:10,1,True,8,1,7,35,10,4
2,00:11:11,1,False,1,8,-7,38,10,4
2,00:10:32,2,False,1,8,-7,38,10,4
2,00:09:59,3,False,1,8,-7,29,1,4
2,00:08:41,1,False,1,8,-7,9,9,4
2,00:07:05,1,False,1,15,-14,35,5,4
2,00:04:53,1,True,15,1,14,25,10,4
2,00:02:08,1,False,1,15,-14,39,10,4
3,00:13:48,1,False,1,15,-14,24,10,4
3,00:08:58,1,False,1,15,-14,3,3,4
3,00:08:33,1,False,1,22,-21,25,10,4
3,00:08:11,1,False,1,22,-21,53,10,4
3,00:06:55,3,True,22,1,21,48,1,4
3,00:05:13,1,True,22,4,18,35,10,4
3,00:03:38,1,False,4,22,-18,13,10,4
3,00:02:24,1,False,4,22,-18,54,10,4
3,00:00:48,1,True,22,4,18,49,10,4
3,00:00:27,1,True,22,11,11,46,10,4
4,00:13:42,3,False,11,22,-11,40,0,4
4,00:12:51,1,True,22,11,11,54,10,4
4,00:11:47,1,True,22,11,11,22,10,4
4,00:07:50,1,True,22,19,3,35,10,4
4,00:07:11,2,True,22,19,3,27,2,4
4,00:05:50,2,True,22,19,3,15,2,4
4,00:03:00,1,True,22,20,2,5,5,4
4,00:02:36,1,False,27,22,5,45,10,4
4,00:00:35,1,True,22,34,-12,37,10,4
4,00:00:31,2,True,22,34,-12,31,4,4
1,00:14:53,1,False,0,0,0,32,10,4
1,00:14:14,2,False,0,0,0,40,2,4
1,00:13:47,3,False,0,0,0,42,0,4
1,00:11:42,1,False,0,0,0,51,5,4
1,00:11:08,2,False,0,0,0,48,2,4
1,00:08:47,1,False,0,3,-3,43,10,4
1,00:07:30,1,True,3,0,3,47,10,4
1,00:05:51,2,True,3,0,3,17,1,4
1,00:03:47,1,True,3,3,0,35,10,4
1,00:02:01,1,False,3,3,0,23,10,4
2,00:14:00,1,True,3,3,0,49,10,4
2,00:12:33,1,False,3,3,0,41,15,4
2,00:10:25,1,False,3,6,-3,53,10,4
2,00:09:46,2,True,6,3,3,49,2,4
2,00:09:10,1,True,6,3,3,46,10,4
2,00:07:00,1,True,6,3,3,8,8,4
2,00:06:34,1,True,6,10,-4,40,10,4
2,00:06:01,2,True,6,10,-4,46,4,4
2,00:03:20,1,True,6,10,-4,37,10,4
2,00:02:39,2,True,6,10,-4,13,0,4
2,00:00:58,2,True,6,17,-11,41,1,4
3,00:14:53,1,True,6,17,-11,32,10,4
3,00:13:11,1,False,17,6,11,50,10,4
3,00:08:20,1,False,17,8,9,42,10,4
3,00:06:55,1,True,8,17,-9,50,10,4
3,00:04:51,2,True,8,20,-12,43,2,4
3,00:04:29,3,True,8,20,-12,44,1,4
3,00:01:19,1,False,20,8,12,5,5,4
3,00:00:29,2,False,20,15,5,52,0,4
4,00:15:00,1,True,15,20,-5,54,10,4
4,00:14:29,2,True,15,20,-5,50,6,4
4,00:12:11,1,True,15,27,-12,42,10,4
4,00:10:47,1,False,27,15,12,33,10,4
4,00:09:20,1,False,27,15,12,48,10,4
4,00:08:44,2,False,27,15,12,52,6,4
4,00:05:06,1,False,27,22,5,29,10,4
4,00:04:25,2,False,27,22,5,37,2,4
4,00:03:25,1,True,22,27,-5,43,10,4
4,00:02:45,1,True,22,27,-5,21,10,4
4,00:01:16,1,False,30,28,2,14,10,4
4,00:00:49,1,False,30,28,2,26,10,4
4,00:00:17,1,True,28,30,-2,35,10,4
1,00:14:48,1,False,0,0,0,29,10,4
1,00:13:46,1,False,0,0,0,40,10,4
1,00:09:48,2,False,7,0,7,47,0,4
1,00:09:25,1,False,7,0,7,46,10,4
1,00:07:51,1,False,7,0,7,21,5,4
1,00:06:03,1,False,7,0,7,24,15,4
1,00:05:00,1,True,0,7,-7,52,10,4
2,00:14:36,1,False,8,3,5,43,10,4
2,00:11:09,2,True,3,8,-5,50,5,4
2,00:10:01,2,True,3,8,-5,36,1,4
2,00:08:05,2,True,3,8,-5,25,3,4
2,00:06:40,1,True,3,15,-12,40,10,4
2,00:02:54,1,True,3,15,-12,14,10,4
2,00:02:18,1,True,3,15,-12,2,2,4
2,00:01:58,2,True,3,15,-12,1,1,4
2,00:01:20,1,False,22,3,19,35,10,4
2,00:00:26,1,False,22,6,16,51,10,4
2,00:00:22,2,False,22,6,16,52,9,4
3,00:13:48,1,True,6,22,-16,45,10,4
3,00:12:08,1,False,22,6,16,29,10,4
3,00:11:37,1,False,22,6,16,9,9,4
3,00:09:57,1,False,22,9,13,21,10,4
3,00:08:23,1,False,22,9,13,1,1,4
3,00:08:04,1,False,22,16,6,23,10,4
3,00:07:35,2,False,22,16,6,29,4,4
3,00:07:00,3,False,22,16,6,32,1,4
3,00:03:25,1,True,16,22,-6,33,10,4
3,00:02:22,1,False,22,16,6,53,10,4
4,00:13:21,1,True,16,23,-7,35,10,4
4,00:12:24,1,False,23,16,7,43,10,4
4,00:10:55,1,False,23,19,4,35,10,4
4,00:08:32,1,True,19,23,-4,48,10,4
4,00:04:27,2,False,30,19,11,45,5,4
4,00:03:06,2,False,30,19,11,51,10,4
4,00:02:35,1,True,19,30,-11,43,10,4
4,00:01:48,1,True,19,30,-11,38,20,4
4,00:01:43,2,True,19,30,-11,30,12,4
1,00:11:12,1,False,0,3,-3,36,10,4
1,00:10:32,2,False,0,3,-3,40,6,4
1,00:09:14,2,True,3,0,3,31,4,4
1,00:07:31,2,False,0,3,-3,44,1,4
1,00:07:03,1,False,0,3,-3,45,10,4
1,00:05:18,2,True,3,0,3,39,10,4
1,00:04:23,1,True,3,1,2,35,10,4
1,00:03:15,1,True,3,1,2,35,10,4
1,00:02:46,2,True,3,1,2,25,0,4
1,00:01:19,1,True,3,1,2,2,10,4
1,00:01:02,1,True,3,8,-5,39,10,4
1,00:00:22,2,True,3,8,-5,39,10,4
2,00:14:40,1,False,8,3,5,25,10,4
2,00:14:08,2,False,8,3,5,30,5,4
2,00:12:38,2,False,8,3,5,50,3,4
2,00:09:58,2,True,3,9,-6,43,2,4
2,00:07:00,1,False,9,10,-1,31,10,4
2,00:06:39,2,False,9,10,-1,41,0,4
2,00:03:38,1,False,9,17,-8,35,5,4
2,00:03:03,1,False,9,17,-8,41,10,4
2,00:01:50,1,True,17,9,8,5,5,4
2,00:00:59,1,False,16,17,-1,23,10,4
2,00:00:02,2,True,17,16,1,43,14,4
3,00:13:32,1,False,16,17,-1,26,10,4
3,00:11:20,1,True,17,16,1,34,10,4
3,00:10:42,2,True,17,16,1,36,8,4
3,00:08:13,1,False,16,17,-1,47,10,4
3,00:07:23,2,False,16,17,-1,53,4,4
3,00:06:42,1,True,17,16,1,52,10,4
3,00:05:27,1,True,17,17,0,35,10,4
4,00:11:49,1,False,17,17,0,1,10,4
4,00:08:20,1,False,17,19,-2,21,10,4
4,00:05:42,1,True,26,17,9,40,10,4
4,00:05:25,2,True,26,17,9,34,4,4
4,00:04:41,1,True,26,20,6,35,10,4
4,00:04:11,2,True,26,20,6,43,2,4
4,00:02:38,1,False,20,26,-6,39,10,4
4,00:01:32,2,False,20,27,-7,37,10,4
4,00:01:24,3,False,20,27,-7,46,1,4
4,00:01:12,1,False,20,27,-7,47,10,4
4,00:01:08,2,False,20,27,-7,42,5,4
1,00:14:53,1,False,0,0,0,34,10,4
1,00:13:07,1,False,0,0,0,46,10,4
1,00:11:42,1,True,0,0,0,50,10,4
1,00:06:57,3,False,0,0,0,28,0,4
1,00:03:54,1,True,3,0,3,30,10,4
1,00:03:25,2,True,3,0,3,39,1,4
1,00:01:54,1,True,3,0,3,52,10,4
2,00:14:21,1,True,3,0,3,44,10,4
2,00:12:54,1,False,0,3,-3,49,10,4
2,00:11:02,1,True,3,7,-4,35,10,4
2,00:07:54,1,False,7,3,4,32,10,4
2,00:05:34,1,True,3,7,-4,12,10,4
2,00:03:48,1,True,3,7,-4,1,1,4
2,00:03:23,1,True,3,15,-12,36,10,4
2,00:02:38,1,True,3,15,-12,33,10,4
2,00:02:16,3,True,3,15,-12,24,1,4
2,00:01:54,1,True,3,15,-12,28,5,4
3,00:14:58,1,True,3,16,-13,45,10,4
3,00:13:06,1,False,16,3,13,1,1,4
3,00:12:39,1,False,16,10,6,48,10,4
3,00:10:32,1,True,10,16,-6,6,6,4
3,00:10:16,1,True,10,23,-13,26,10,4
3,00:07:16,1,False,23,10,13,24,10,4
3,00:04:40,1,False,23,10,13,22,10,4
3,00:03:21,1,True,10,23,-13,27,10,4
3,00:01:35,1,True,10,23,-13,2,10,4
3,00:00:56,2,True,10,23,-13,3,9,4
4,00:07:53,2,False,25,10,15,52,8,4
4,00:07:30,1,True,10,25,-15,45,10,4
4,00:07:20,2,True,10,25,-15,39,4,4
4,00:01:51,1,True,17,28,-11,41,10,4
4,00:01:31,1,True,17,28,-11,28,10,4
4,00:01:17,2,True,17,28,-11,26,8,4
1,00:12:10,1,False,7,0,7,42,10,4
1,00:11:46,2,False,7,0,7,50,2,4
1,00:09:07,1,True,0,7,-7,16,10,4
1,00:05:39,1,False,14,0,14,45,10,4
1,00:03:08,1,False,21,0,21,45,10,4
1,00:00:31,1,True,0,21,-21,3,10,4
1,00:00:02,2,True,0,21,-21,10,3,4
2,00:13:41,1,True,0,21,-21,42,10,4
2,00:12:00,2,False,21,0,21,15,2,4
2,00:10:28,1,False,21,0,21,40,10,4
2,00:09:38,1,False,21,0,21,50,10,4
2,00:07:51,1,True,0,21,-21,5,10,4
2,00:02:21,1,True,0,28,-28,49,10,4
2,00:01:58,2,True,0,28,-28,40,1,4
2,00:00:14,3,False,31,0,31,46,4,4
3,00:14:47,1,False,31,3,28,31,10,4
3,00:12:56,1,True,3,31,-28,53,10,4
3,00:12:39,2,False,31,3,28,47,0,4
3,00:12:07,1,False,31,3,28,42,10,4
3,00:10:28,3,False,31,3,28,33,1,4
3,00:09:29,2,False,31,3,28,26,10,4
3,00:07:29,1,False,31,3,28,43,10,4
3,00:07:11,2,False,31,3,28,50,3,4
3,00:05:27,1,True,3,31,-28,40,20,4
3,00:03:56,1,True,3,32,-29,35,10,4
3,00:02:18,1,False,32,3,29,28,10,4
3,00:01:41,2,False,32,3,29,36,2,4
4,00:14:02,1,False,32,10,22,22,10,4
4,00:11:59,2,False,32,10,22,51,3,4
4,00:11:10,2,False,32,10,22,41,4,4
4,00:09:55,1,False,32,10,22,21,10,4
4,00:09:28,1,False,32,10,22,10,10,4
4,00:08:31,1,False,32,13,19,35,10,4
4,00:08:10,2,False,32,13,19,40,5,4
4,00:07:26,3,False,32,13,19,44,1,4
4,00:06:50,1,False,32,13,19,46,10,4
4,00:05:03,1,True,13,32,-19,33,10,4
4,00:04:40,2,True,13,32,-19,32,9,4
4,00:02:27,1,False,35,13,22,42,10,4
4,00:02:22,2,False,35,13,22,45,7,4
4,00:01:23,1,True,13,35,-22,33,10,4
4,00:01:16,2,True,13,35,-22,29,6,4
1,00:13:42,1,False,0,0,0,10,10,4
1,00:12:18,1,False,0,0,0,14,10,4
1,00:11:55,1,False,0,7,-7,24,10,4
1,00:09:32,3,False,0,7,-7,51,1,4
1,00:08:50,1,False,0,7,-7,50,10,4
1,00:07:44,1,False,0,7,-7,25,10,4
1,00:07:05,2,False,0,7,-7,16,1,4
1,00:06:05,1,False,0,7,-7,2,2,4
1,00:03:52,1,False,0,13,-13,44,10,4
1,00:02:29,1,True,13,0,13,52,10,4
1,00:01:08,1,False,0,13,-13,38,10,4
1,00:00:32,2,False,0,13,-13,35,7,4
1,00:00:03,1,False,0,13,-13,27,10,4
2,00:15:00,2,False,0,13,-13,21,4,4
2,00:11:33,2,True,16,0,16,30,2,4
2,00:09:13,1,True,16,7,9,55,10,4
2,00:07:44,1,False,7,16,-9,7,10,4
2,00:05:08,2,True,16,7,9,34,3,4
2,00:03:44,1,True,16,7,9,55,10,4
2,00:02:06,1,False,7,16,-9,32,10,4
2,00:01:30,2,True,23,7,16,36,3,4
2,00:01:26,1,True,23,7,16,41,10,4
2,00:00:55,3,True,23,7,16,51,0,4
2,00:00:45,1,True,23,7,16,53,10,4
3,00:14:54,1,False,7,26,-19,39,10,4
3,00:14:13,1,True,26,7,19,39,10,4
3,00:12:05,1,True,26,10,16,35,10,4
3,00:09:58,1,True,26,10,16,17,10,4
3,00:06:08,1,False,17,26,-9,23,10,4
3,00:03:07,1,True,26,17,9,46,10,4
3,00:02:20,2,True,26,17,9,25,10,4
3,00:00:03,1,True,26,20,6,49,10,4
4,00:14:19,1,False,20,26,-6,23,10,4
4,00:12:39,1,True,26,20,6,51,10,4
4,00:07:15,2,False,20,35,-15,44,1,4
4,00:06:16,1,True,35,20,15,39,10,4
4,00:06:03,2,True,35,20,15,31,2,4
4,00:04:08,2,False,27,35,-8,54,2,4
4,00:02:17,2,False,27,42,-15,47,3,4
4,00:01:41,3,True,42,27,15,36,1,4
4,00:01:20,1,True,42,27,15,30,10,4
4,00:01:16,2,True,42,27,15,35,5,4
1,00:11:40,1,True,0,0,0,34,10,4
1,00:07:59,1,True,0,7,-7,49,10,4
1,00:05:34,1,False,7,0,7,30,10,4
1,00:04:13,1,True,0,7,-7,31,10,4
1,00:01:00,1,False,14,0,14,17,10,4
2,00:15:00,1,False,14,3,11,35,10,4
2,00:13:30,2,True,3,14,-11,44,10,4
2,00:12:43,1,True,3,14,-11,30,10,4
2,00:11:54,2,True,3,14,-11,22,2,4
2,00:10:22,1,True,3,14,-11,1,1,4
2,00:06:32,2,True,3,21,-18,47,3,4
2,00:04:52,1,True,3,21,-18,33,10,4
2,00:03:44,1,True,3,24,-21,35,10,4
2,00:02:42,1,True,3,24,-21,49,10,4
2,00:01:00,1,False,31,3,28,25,10,4
3,00:14:53,1,False,31,3,28,26,10,4
3,00:12:17,2,False,31,3,28,54,4,4
3,00:08:50,2,False,31,3,28,34,1,4
3,00:07:32,1,False,31,3,28,30,10,4
3,00:06:31,1,False,31,3,28,55,5,4
3,00:06:14,1,True,3,31,-28,45,10,4
3,00:02:45,1,False,32,3,29,45,10,4
3,00:01:23,1,True,3,32,-29,54,10,4
4,00:12:50,1,True,3,39,-36,51,10,4
4,00:12:17,2,True,3,39,-36,41,0,4
4,00:09:50,1,False,40,3,37,36,10,4
4,00:08:47,1,False,40,10,30,45,10,4
4,00:08:17,2,False,40,10,30,53,2,4
4,00:07:38,1,True,10,40,-30,52,10,4
4,00:06:12,1,True,10,40,-30,31,10,4
4,00:02:57,1,True,24,40,-16,48,10,4
4,00:02:23,1,True,24,40,-16,14,10,4
4,00:02:18,2,True,24,40,-16,7,3,4
4,00:01:24,2,True,24,40,-16,7,7,4
4,00:01:18,1,True,24,47,-23,41,10,4
1,00:14:35,1,False,0,0,0,40,10,4
1,00:12:38,1,True,0,0,0,31,10,4
1,00:10:45,1,True,0,3,-3,54,10,4
1,00:10:07,2,True,0,3,-3,54,10,4
1,00:05:45,2,True,0,3,-3,20,2,4
2,00:14:38,1,True,0,10,-10,7,10,4
2,00:13:20,1,True,0,10,-10,31,10,4
2,00:12:00,1,False,10,0,10,51,10,4
2,00:10:49,1,False,10,0,10,25,10,4
2,00:09:49,1,False,10,0,10,15,10,4
2,00:07:11,1,False,10,7,3,43,10,4
2,00:05:40,1,True,7,10,-3,29,10,4
2,00:04:57,2,True,7,10,-3,37,2,4
2,00:03:56,1,False,10,7,3,48,10,4
2,00:01:57,1,True,7,17,-10,50,5,4
2,00:01:53,2,True,7,17,-10,52,3,4
2,00:01:17,2,False,17,7,10,46,2,4
2,00:01:11,3,False,17,7,10,44,0,4
2,00:00:14,1,True,7,17,-10,4,10,4
2,00:00:01,2,True,7,17,-10,12,2,4
3,00:12:40,1,True,7,17,-10,42,10,4
3,00:09:48,1,True,7,17,-10,18,10,4
3,00:08:29,1,False,17,7,10,38,10,4
3,00:07:25,1,True,7,17,-10,52,10,4
3,00:04:18,1,False,17,7,10,50,10,4
3,00:01:03,1,True,7,17,-10,1,1,4
3,00:00:40,1,True,7,24,-17,54,10,4
4,00:10:18,1,True,11,24,-13,50,10,4
4,00:05:44,1,True,11,27,-16,15,10,4
4,00:02:38,1,True,18,34,-16,52,10,4
4,00:01:21,1,True,18,34,-16,43,10,4
4,00:01:16,2,True,18,34,-16,34,1,4
4,00:00:56,1,True,18,34,-16,29,10,4
4,00:00:35,2,True,18,34,-16,24,5,4
1,00:14:27,1,True,0,0,0,50,10,4
1,00:13:33,1,False,0,0,0,50,10,4
1,00:12:53,2,False,0,0,0,44,4,4
1,00:11:45,2,False,0,0,0,31,0,4
1,00:11:17,3,False,0,0,0,30,0,4
1,00:06:45,2,False,0,3,-3,50,4,4
1,00:06:31,1,False,0,10,-10,32,10,4
1,00:04:02,1,False,3,10,-7,43,10,4
1,00:01:28,1,False,3,10,-7,7,7,4
2,00:14:33,1,False,3,17,-14,52,10,4
2,00:11:49,1,True,17,3,14,50,10,4
2,00:07:51,1,False,3,18,-15,50,10,4
2,00:05:35,1,False,3,18,-15,26,10,4
2,00:05:15,2,False,3,18,-15,35,1,4
2,00:02:42,1,True,18,4,14,46,10,4
2,00:02:27,2,True,18,4,14,49,7,4
2,00:00:35,2,True,25,4,21,49,10,4
2,00:00:02,1,False,4,25,-21,21,10,4
3,00:14:55,1,False,4,25,-21,34,10,4
3,00:14:15,1,False,4,25,-21,48,10,4
3,00:12:57,3,True,25,4,21,53,1,4
3,00:11:41,1,True,25,4,21,46,10,4
3,00:11:10,1,False,4,25,-21,51,10,4
3,00:10:23,1,False,4,25,-21,11,10,4
3,00:07:46,1,True,28,4,24,52,10,4
3,00:07:10,1,True,28,4,24,41,10,4
3,00:05:15,2,True,28,4,24,10,3,4
3,00:02:06,1,True,35,11,24,23,10,4
4,00:14:36,1,True,35,11,24,37,10,4
4,00:12:34,1,False,11,38,-27,35,10,4
4,00:11:01,1,True,38,11,27,37,10,4
4,00:10:28,2,True,38,11,27,42,5,4
4,00:06:35,2,False,11,38,-27,37,1,4
4,00:03:35,1,False,11,38,-27,38,10,4
4,00:02:40,2,False,11,38,-27,31,3,4
4,00:02:35,1,False,11,38,-27,28,10,4
4,00:02:13,2,False,11,38,-27,24,6,4
4,00:01:39,1,False,11,38,-27,10,10,4
4,00:01:11,2,False,11,38,-27,7,7,4
4,00:00:52,3,False,11,38,-27,5,5,4
4,00:00:31,1,False,11,38,-27,5,10,4
4,00:00:05,1,False,11,38,-27,16,10,4
1,00:14:50,1,False,0,0,0,32,10,4
1,00:12:22,1,True,0,0,0,48,10,4
1,00:08:32,1,False,3,0,3,32,10,4
1,00:07:59,2,False,3,0,3,32,10,4
1,00:04:40,1,True,7,3,4,30,10,4
1,00:04:10,2,True,7,3,4,34,6,4
1,00:02:23,1,False,3,7,-4,37,10,4
1,00:01:43,2,False,3,7,-4,42,5,4
1,00:01:10,3,False,3,7,-4,47,0,4
1,00:00:35,1,False,3,7,-4,51,10,4
1,00:00:01,1,True,7,3,4,41,10,4
2,00:14:26,1,True,7,4,3,37,10,4
2,00:14:26,1,True,7,4,3,37,10,4
2,00:10:52,1,False,4,8,-4,35,10,4
2,00:10:16,1,False,4,8,-4,45,10,4
2,00:08:10,2,True,8,4,4,8,1,4
2,00:07:33,1,True,8,4,4,6,6,4
2,00:07:00,2,True,8,4,4,2,2,4
2,00:05:46,1,True,8,7,1,35,10,4
2,00:05:24,2,True,8,7,1,42,3,4
2,00:01:40,2,True,8,7,1,49,2,4
2,00:01:28,1,False,7,8,-1,54,10,4
2,00:01:10,2,False,7,8,-1,48,4,4
2,00:00:15,2,False,7,8,-1,42,9,4
3,00:12:49,1,True,8,10,-2,35,10,4
3,00:12:07,2,True,8,10,-2,42,3,4
3,00:10:11,1,True,9,10,-1,41,10,4
3,00:07:57,1,False,10,9,1,28,10,4
3,00:04:45,1,True,9,11,-2,40,10,4
3,00:03:19,2,False,11,9,2,11,10,4
3,00:02:14,1,True,11,11,0,40,10,4
3,00:00:01,1,False,11,11,0,15,15,4
4,00:14:22,1,False,11,14,-3,29,10,4
4,00:12:54,1,True,14,11,3,46,10,4
4,00:12:00,1,True,14,11,3,35,10,4
4,00:10:37,1,True,14,14,0,35,10,4
4,00:07:16,1,True,14,14,0,31,10,4
4,00:05:18,1,True,14,14,0,50,10,4
4,00:04:04,1,True,14,14,0,39,10,4
4,00:02:20,1,True,14,14,0,51,10,4
4,00:00:28,1,False,21,21,0,38,10,4
4,00:00:24,2,False,21,21,0,33,5,4
1,00:14:24,1,False,0,0,0,23,10,4
1,00:12:33,2,False,0,0,0,8,8,4
1,00:11:37,1,True,3,0,3,53,10,4
1,00:10:35,1,True,3,0,3,33,10,4
1,00:10:20,1,True,3,0,3,51,10,4
1,00:09:38,2,True,3,0,3,54,7,4
1,00:09:03,3,False,0,3,-3,50,1,4
1,00:06:16,1,False,0,3,-3,43,10,4
1,00:05:14,1,False,0,3,-3,14,10,4
1,00:03:41,1,False,0,10,-10,25,10,4
1,00:02:29,1,False,0,10,-10,49,10,4
2,00:13:20,1,True,13,3,10,32,10,4
2,00:12:31,1,False,3,13,-10,35,10,4
2,00:10:20,2,True,16,3,13,40,2,4
2,00:08:43,2,True,16,4,12,42,2,4
2,00:06:52,1,False,4,16,-12,52,10,4
3,00:13:54,1,True,19,11,8,48,10,4
3,00:11:55,1,False,11,19,-8,3,10,4
3,00:09:27,1,False,11,26,-15,31,10,4
3,00:09:08,2,False,11,26,-15,38,3,4
3,00:08:33,1,False,11,26,-15,50,10,4
3,00:06:04,1,True,26,11,15,1,1,4
3,00:05:09,2,True,26,11,15,1,1,4
3,00:03:24,1,True,26,18,8,54,10,4
3,00:02:07,1,True,26,18,8,19,10,4
3,00:01:44,2,True,26,18,8,23,6,4
3,00:00:16,2,False,18,26,-8,47,3,4
4,00:14:41,1,True,26,18,8,43,10,4
4,00:13:14,2,False,18,26,-8,40,1,4
4,00:11:04,1,True,26,18,8,33,10,4
4,00:09:09,2,True,26,18,8,8,0,4
4,00:07:30,1,False,26,26,0,49,10,4
4,00:05:02,1,True,33,26,7,52,10,4
4,00:02:48,1,True,33,26,7,41,10,4
4,00:00:53,2,False,26,40,-14,46,5,4
4,00:00:42,1,False,26,40,-14,51,10,4
1,00:14:31,1,True,0,0,0,45,10,4
1,00:10:32,2,True,7,0,7,54,4,4
1,00:08:31,1,False,0,7,-7,34,10,4
1,00:06:55,1,True,7,0,7,39,10,4
1,00:02:55,3,True,7,0,7,2,0,4
1,00:01:55,2,True,7,0,7,2,2,4
1,00:01:06,1,False,7,14,-7,30,10,4
1,00:00:01,2,False,7,14,-7,55,0,4
2,00:15:00,1,True,14,7,7,54,10,4
2,00:08:47,2,True,14,7,7,8,10,4
2,00:04:19,1,False,16,14,2,28,10,4
2,00:02:43,1,False,16,14,2,1,1,4
2,00:02:39,1,False,16,21,-5,34,10,4
2,00:02:11,1,True,21,16,5,45,10,4
2,00:02:03,1,False,16,21,-5,53,10,4
2,00:01:10,1,False,16,21,-5,26,10,4
3,00:14:54,1,False,16,21,-5,43,10,4
3,00:14:13,2,False,16,21,-5,47,6,4
3,00:12:41,1,True,21,16,5,31,10,4
3,00:08:55,1,True,21,16,5,30,10,4
3,00:05:55,1,True,21,16,5,41,10,4
3,00:04:37,2,True,21,16,5,20,1,4
3,00:00:02,1,True,21,19,2,52,10,4
4,00:14:06,1,False,19,21,-2,18,10,4
4,00:12:21,1,False,19,24,-5,46,10,4
4,00:11:45,2,False,19,24,-5,54,2,4
4,00:11:01,1,True,24,19,5,37,10,4
4,00:09:56,1,True,24,19,5,12,10,4
4,00:07:13,1,False,19,24,-5,48,10,4
4,00:03:11,1,False,22,24,-2,47,10,4
4,00:02:10,1,True,26,22,4,35,10,4
4,00:02:04,2,True,26,22,4,42,3,4
4,00:01:58,1,True,26,22,4,46,10,4
4,00:01:43,2,True,26,22,4,48,8,4
4,00:01:01,2,True,26,22,4,52,4,4
1,00:13:37,1,True,0,0,0,27,10,4
1,00:12:26,1,True,0,0,0,38,10,4
1,00:11:51,2,True,0,0,0,36,12,4
1,00:10:53,1,False,0,0,0,25,10,4
1,00:10:09,1,False,0,0,0,37,10,4
1,00:09:54,2,False,0,0,0,47,0,4
1,00:09:42,1,False,0,0,0,49,10,4
1,00:08:33,1,True,0,0,0,49,10,4
1,00:06:55,1,True,0,3,-3,35,10,4
1,00:03:38,1,True,0,3,-3,40,10,4
1,00:01:23,3,False,3,0,3,46,2,4
1,00:00:01,1,False,3,0,3,27,10,4
2,00:12:21,1,False,3,7,-4,44,10,4
2,00:11:31,2,False,3,7,-4,22,3,4
2,00:11:04,1,False,3,7,-4,16,10,4
2,00:10:29,2,False,3,7,-4,6,0,4
2,00:09:30,1,False,3,7,-4,5,5,4
2,00:07:49,1,True,14,3,11,46,10,4
2,00:07:03,1,False,3,14,-11,35,10,4
2,00:06:31,2,False,3,14,-11,39,6,4
2,00:05:25,1,True,14,3,11,38,10,4
2,00:04:12,1,True,14,3,11,52,10,4
2,00:02:46,1,False,3,14,-11,15,10,4
2,00:02:21,3,False,3,14,-11,24,1,4
2,00:01:48,1,True,14,3,11,25,10,4
2,00:00:53,1,True,14,3,11,2,10,4
2,00:00:46,1,True,14,3,11,13,10,4
3,00:14:50,1,False,3,14,-11,32,10,4
3,00:12:18,2,True,14,4,10,35,10,4
3,00:11:23,1,False,4,14,-10,46,10,4
3,00:09:55,1,True,14,4,10,19,10,4
3,00:08:17,1,False,4,14,-10,40,10,4
3,00:04:12,1,True,14,4,10,45,10,4
3,00:02:50,1,True,14,7,7,35,10,4
3,00:00:01,1,True,14,9,5,12,10,4
4,00:14:24,1,True,14,9,5,36,10,4
4,00:12:42,1,False,9,14,-5,41,10,4
4,00:12:27,2,False,9,14,-5,33,2,4
4,00:12:03,1,False,9,14,-5,27,10,4
4,00:10:21,2,False,9,14,-5,9,3,4
4,00:09:47,3,False,9,14,-5,7,1,4
4,00:04:59,1,True,14,9,5,38,10,4
4,00:02:59,1,False,9,14,-5,41,10,4
4,00:02:26,2,True,14,9,5,45,2,4
4,00:01:57,1,True,14,9,5,8,10,4
4,00:01:26,3,True,14,9,5,1,1,4
4,00:01:18,1,True,14,9,5,1,10,4
4,00:01:15,2,True,14,9,5,3,8,4
4,00:00:51,1,True,14,9,5,14,10,4
1,00:13:21,1,True,0,0,0,7,10,4
1,00:12:53,2,True,0,0,0,15,2,4
1,00:11:22,1,True,0,0,0,10,10,4
1,00:10:32,1,True,0,3,-3,35,10,4
1,00:09:22,1,False,3,0,3,29,10,4
1,00:08:19,1,False,3,0,3,38,10,4
1,00:06:22,1,True,0,3,-3,39,10,4
1,00:03:13,1,False,3,0,3,37,10,4
1,00:00:05,1,True,0,10,-10,36,10,4
2,00:13:17,1,False,10,0,10,27,10,4
2,00:11:30,1,True,0,10,-10,50,10,4
2,00:10:25,1,False,10,0,10,48,10,4
2,00:09:22,1,False,10,0,10,35,10,4
2,00:06:15,3,False,10,7,3,54,0,4
2,00:03:09,2,False,10,7,3,46,1,4
2,00:02:35,2,False,10,7,3,33,1,4
2,00:02:09,1,False,10,7,3,1,1,4
3,00:14:26,1,False,17,17,0,52,10,4
3,00:13:19,3,False,17,17,0,42,0,4
3,00:12:20,1,False,17,17,0,18,10,4
3,00:11:09,2,False,17,17,0,2,2,4
3,00:08:18,1,True,20,17,3,31,10,4
3,00:06:28,1,True,20,17,3,1,1,4
3,00:05:46,2,True,20,17,3,1,1,4
3,00:03:54,1,False,24,20,4,43,10,4
3,00:00:47,2,False,24,23,1,49,0,4
4,00:15:00,2,False,24,23,1,49,10,4
4,00:14:14,1,True,23,24,-1,13,10,4
4,00:13:46,1,True,23,24,-1,33,10,4
4,00:11:01,1,False,24,26,-2,32,10,4
4,00:10:35,2,False,24,26,-2,40,2,4
4,00:09:47,1,True,26,24,2,1,1,4
4,00:08:22,2,True,26,24,2,1,1,4
4,00:03:43,2,False,31,26,5,30,2,4
4,00:02:37,1,False,31,27,4,35,10,4
4,00:02:09,1,False,31,27,4,54,10,4
4,00:00:56,1,True,27,31,-4,31,10,4
4,00:00:51,2,True,27,31,-4,30,9,4
1,00:13:40,1,True,0,0,0,41,10,4
1,00:13:14,2,True,0,0,0,50,1,4
1,00:09:18,2,True,0,0,0,48,12,4
1,00:08:14,1,True,0,3,-3,35,10,4
1,00:06:47,1,False,5,0,5,43,10,4
1,00:03:58,1,True,0,12,-12,29,10,4
1,00:02:14,1,True,0,12,-12,52,10,4
2,00:13:21,1,True,0,12,-12,41,10,4
2,00:12:07,2,True,0,12,-12,31,0,4
2,00:10:59,2,True,0,12,-12,22,2,4
2,00:10:20,3,True,0,12,-12,21,1,4
2,00:09:40,1,True,0,12,-12,21,10,4
2,00:03:15,1,False,15,7,8,33,10,4
2,00:02:52,2,False,15,7,8,40,3,4
2,00:02:23,1,True,7,15,-8,13,10,4
2,00:02:13,2,True,7,15,-8,20,3,4
2,00:00:57,1,True,7,15,-8,44,10,4
2,00:00:36,1,True,7,18,-11,35,10,4
2,00:00:14,1,True,7,18,-11,22,10,4
3,00:14:47,1,False,21,7,14,27,10,4
3,00:13:59,1,False,21,7,14,16,10,4
3,00:13:17,1,False,21,14,7,37,10,4
3,00:10:54,1,False,28,14,14,5,5,4
3,00:09:12,2,False,28,14,14,6,6,4
3,00:07:23,2,True,21,28,-7,19,10,4
3,00:06:56,1,True,21,28,-7,35,10,4
3,00:05:18,2,False,28,21,7,47,10,4
3,00:04:36,3,False,28,21,7,37,0,4
3,00:04:25,1,False,28,21,7,36,10,4
3,00:02:14,1,False,28,24,4,42,10,4
4,00:14:42,1,False,28,24,4,26,10,4
4,00:05:00,1,False,38,33,5,31,10,4
4,00:04:35,2,False,38,33,5,31,10,4
4,00:03:41,1,False,38,36,2,35,10,4
4,00:02:42,1,False,38,36,2,17,10,4
4,00:01:54,1,True,36,38,-2,52,10,4
4,00:01:24,1,True,36,38,-2,42,10,4
4,00:01:17,2,True,36,38,-2,48,16,4
1,00:13:23,2,False,0,0,0,45,1,4
1,00:12:10,2,False,0,0,0,34,1,4
1,00:10:55,2,False,0,0,0,24,2,4
1,00:09:32,1,False,0,7,-7,30,10,4
1,00:08:54,1,False,0,7,-7,40,10,4
1,00:07:56,1,False,0,7,-7,51,10,4
1,00:05:36,1,False,2,7,-5,55,10,4
1,00:02:20,2,True,7,4,3,50,2,4
2,00:14:39,1,True,7,4,3,1,1,4
2,00:13:48,2,True,7,4,3,1,1,4
2,00:10:30,1,False,7,7,0,55,10,4
2,00:09:14,1,True,7,7,0,45,10,4
2,00:08:38,2,True,7,7,0,39,4,4
2,00:06:42,1,True,7,14,-7,49,10,4
2,00:05:28,1,False,14,7,7,24,10,4
2,00:02:44,1,False,14,7,7,14,10,4
2,00:01:52,1,False,14,7,7,2,2,4
2,00:00:28,2,False,21,14,7,40,10,4
3,00:14:33,2,True,14,21,-7,29,10,4
3,00:13:16,1,False,21,14,7,10,10,4
3,00:12:45,2,False,21,14,7,16,4,4
3,00:11:48,1,False,21,14,7,52,10,4
3,00:11:15,2,False,21,14,7,52,10,4
3,00:10:16,2,False,21,14,7,21,2,4
3,00:05:48,1,True,14,21,-7,51,10,4
3,00:03:56,1,False,21,14,7,37,10,4
3,00:03:14,2,False,21,14,7,47,0,4
3,00:01:27,3,True,14,21,-7,52,1,4
3,00:01:06,1,True,14,21,-7,48,10,4
4,00:15:00,2,True,14,21,-7,27,2,4
4,00:13:54,2,True,14,21,-7,24,11,4
4,00:12:02,2,True,14,22,-8,14,3,4
4,00:10:56,1,True,14,22,-8,11,10,4
4,00:09:12,1,False,29,14,15,40,10,4
4,00:05:30,1,False,29,14,15,45,10,4
4,00:04:11,1,True,14,29,-15,54,10,4
4,00:03:44,2,True,14,29,-15,48,4,4
4,00:02:44,1,True,14,29,-15,26,10,4
4,00:02:38,2,True,14,29,-15,24,8,4
4,00:02:32,1,True,14,29,-15,13,10,4
4,00:02:09,2,True,14,29,-15,14,11,4
4,00:01:40,1,True,14,32,-18,35,10,4
4,00:01:11,1,True,14,32,-18,35,10,4
4,00:01:04,2,True,14,32,-18,30,5,4
4,00:00:15,1,True,14,35,-21,35,10,4
4,00:00:08,1,True,14,35,-21,47,10,4
1,00:14:54,1,False,0,0,0,30,10,4
1,00:14:30,2,False,0,0,0,38,2,4
1,00:13:45,3,False,0,0,0,40,0,4
1,00:10:59,1,True,0,0,0,48,10,4
1,00:08:25,2,True,0,0,0,23,4,4
1,00:07:03,1,True,0,1,-1,53,10,4
1,00:06:28,2,False,1,0,1,51,4,4
1,00:03:39,1,False,1,2,-1,34,5,4
1,00:03:00,2,False,1,2,-1,30,1,4
1,00:00:58,1,False,1,2,-1,1,1,4
2,00:13:05,2,True,9,1,8,35,3,4
2,00:10:16,3,True,9,1,8,50,1,4
2,00:07:36,1,False,1,9,-8,1,1,4
2,00:06:46,1,False,1,16,-15,47,10,4
2,00:04:33,1,True,16,1,15,25,10,4
2,00:01:13,1,True,16,8,8,28,10,4
2,00:01:08,2,True,16,8,8,37,1,4
2,00:00:19,2,True,16,8,8,47,19,4
3,00:10:59,1,False,8,16,-8,2,2,4
3,00:09:59,2,False,8,23,-15,41,2,4
3,00:09:12,1,True,23,8,15,20,10,4
3,00:08:53,1,True,23,8,15,31,10,4
3,00:07:38,1,True,23,8,15,45,10,4
3,00:07:10,2,True,23,8,15,54,1,4
3,00:03:51,1,False,8,24,-16,50,10,4
4,00:15:00,2,True,24,11,13,34,2,4
4,00:13:35,1,False,11,24,-13,47,10,4
4,00:10:43,1,True,24,11,13,51,10,4
4,00:10:00,1,True,24,11,13,39,10,4
4,00:06:30,2,True,24,18,6,48,5,4
4,00:05:42,1,True,24,18,6,54,10,4
4,00:03:35,2,False,18,24,-6,12,2,4
4,00:02:23,2,False,18,24,-6,43,2,4
4,00:01:11,1,True,24,18,6,25,10,4
4,00:01:03,1,False,18,24,-6,51,10,4
4,00:00:58,2,False,18,24,-6,53,12,4
1,00:11:19,1,False,0,7,-7,35,10,4
1,00:08:31,1,False,0,7,-7,50,10,4
1,00:07:38,2,False,0,7,-7,42,2,4
1,00:03:50,1,False,0,10,-10,51,10,4
1,00:02:32,2,False,0,10,-10,31,0,4
1,00:01:12,1,False,0,10,-10,12,10,4
2,00:14:35,2,False,0,17,-17,44,10,4
2,00:11:11,1,False,0,17,-17,34,10,4
2,00:09:37,1,True,17,0,17,31,10,4
2,00:07:11,1,True,24,0,24,50,10,4
2,00:06:49,2,True,24,0,24,46,6,4
2,00:01:57,1,True,24,3,21,50,10,4
2,00:01:49,2,True,24,3,21,42,2,4
2,00:01:42,3,True,24,3,21,41,1,4
3,00:13:59,1,False,6,24,-18,50,10,4
3,00:13:24,1,True,24,6,18,46,10,4
3,00:12:01,1,True,24,7,17,35,10,4
3,00:11:55,2,True,24,7,17,45,0,4
3,00:10:21,2,False,7,24,-17,54,1,4
3,00:06:46,1,False,7,24,-17,29,10,4
3,00:02:55,1,True,24,7,17,38,10,4
3,00:02:12,1,False,7,24,-17,46,10,4
3,00:01:33,1,False,7,24,-17,35,10,4
3,00:00:26,1,False,7,24,-17,7,7,4
4,00:11:24,1,True,27,7,20,44,10,4
4,00:11:05,1,True,27,14,13,39,10,4
4,00:06:57,1,False,14,27,-13,27,10,4
4,00:05:12,1,True,27,14,13,51,10,4
4,00:02:08,1,False,14,27,-13,4,4,4
4,00:01:23,1,False,14,34,-20,35,10,4
4,00:01:18,2,False,14,34,-20,39,14,4
4,00:00:41,1,False,14,37,-23,35,10,4
1,00:14:15,1,True,0,0,0,42,10,4
1,00:14:02,2,True,0,0,0,50,2,4
1,00:13:31,1,False,0,0,0,43,10,4
1,00:10:54,1,True,3,0,3,29,10,4
1,00:10:30,2,True,3,0,3,23,4,4
1,00:06:47,1,True,3,3,0,26,10,4
1,00:05:22,1,False,3,3,0,27,10,4
1,00:02:06,1,False,3,3,0,44,10,4
1,00:01:41,2,False,3,3,0,54,0,4
2,00:14:11,1,True,3,6,-3,35,10,4
2,00:11:12,1,False,6,10,-4,25,10,4
2,00:10:30,2,False,6,10,-4,27,8,4
2,00:10:04,3,False,6,10,-4,35,0,4
2,00:09:28,1,False,6,10,-4,36,10,4
2,00:07:25,1,True,10,6,4,46,10,4
2,00:07:01,2,True,10,6,4,54,2,4
2,00:06:26,1,False,6,10,-4,40,10,4
2,00:05:25,1,True,10,6,4,43,10,4
2,00:04:08,1,True,10,6,4,30,10,4
2,00:00:40,1,True,10,12,-2,35,10,4
2,00:00:31,2,True,10,12,-2,42,3,4
3,00:14:53,1,False,12,10,2,39,10,4
3,00:14:13,2,False,12,10,2,46,3,4
3,00:13:46,3,False,12,10,2,49,0,4
3,00:12:29,1,True,10,12,-2,38,10,4
3,00:11:48,2,True,10,12,-2,34,6,4
3,00:10:14,2,True,10,15,-5,43,2,4
3,00:09:46,1,True,10,15,-5,53,10,4
3,00:08:12,1,False,15,10,5,14,10,4
3,00:06:42,1,False,15,17,-2,36,10,4
3,00:04:22,1,True,17,15,2,28,10,4
3,00:03:09,1,True,17,15,2,10,10,4
3,00:02:56,1,True,17,22,-5,32,10,4
4,00:14:20,1,True,24,22,2,15,10,4
4,00:13:14,1,True,24,22,2,38,10,4
4,00:13:06,1,True,24,22,2,50,10,4
4,00:11:56,2,False,22,24,-2,45,8,4
4,00:09:12,1,True,27,22,5,28,10,4
4,00:08:19,2,True,27,22,5,18,0,4
4,00:03:44,1,False,29,27,2,51,20,4
4,00:03:04,2,False,29,27,2,53,18,4
4,00:02:05,1,True,27,30,-3,35,10,4
4,00:01:45,2,True,27,30,-3,41,4,4
4,00:01:18,1,True,27,30,-3,53,10,4
4,00:01:10,2,True,27,30,-3,45,2,4
4,00:00:46,1,True,27,30,-3,42,10,4
4,00:00:42,2,True,27,30,-3,38,6,4
1,00:14:22,1,False,0,0,0,51,10,4
1,00:13:20,1,False,0,0,0,24,10,4
1,00:08:18,2,True,3,3,0,43,1,4
1,00:07:39,1,True,3,3,0,46,10,4
1,00:06:15,1,False,3,3,0,45,10,4
1,00:05:28,1,True,3,3,0,50,10,4
2,00:14:41,1,False,10,3,7,49,10,4
2,00:11:41,1,True,3,17,-14,29,10,4
2,00:09:54,1,False,17,3,14,33,10,4
2,00:08:38,1,True,3,17,-14,42,10,4
2,00:06:26,1,True,3,17,-14,50,10,4
2,00:02:38,1,False,20,3,17,48,10,4
2,00:01:28,2,False,20,3,17,28,1,4
2,00:01:07,1,False,20,3,17,30,10,4
3,00:13:57,3,True,3,23,-20,54,0,4
3,00:09:24,1,False,23,3,20,1,1,4
3,00:06:59,1,True,10,23,-13,23,10,4
3,00:04:15,1,True,10,23,-13,27,10,4
3,00:03:59,1,True,10,23,-13,40,10,4
3,00:00:01,1,False,23,10,13,36,10,4
4,00:13:50,2,True,10,23,-13,24,2,4
4,00:12:38,3,True,10,23,-13,43,0,4
4,00:11:51,1,True,10,23,-13,44,10,4
4,00:08:32,1,False,23,17,6,47,10,4
4,00:03:52,2,False,23,17,6,37,0,4
4,00:02:05,1,False,23,20,3,35,10,4
4,00:01:37,1,True,20,23,-3,30,10,4
4,00:00:22,2,False,26,20,6,47,12,4
1,00:13:42,1,True,0,0,0,33,10,4
1,00:12:12,1,False,0,0,0,27,10,4
1,00:11:41,1,False,0,0,0,55,10,4
1,00:09:40,2,True,0,0,0,17,1,4
1,00:05:25,1,False,7,0,7,47,10,4
1,00:04:32,1,False,7,0,7,28,10,4
1,00:02:37,1,True,3,7,-4,52,10,4
1,00:00:40,1,False,7,10,-3,54,10,4
2,00:13:35,1,False,7,13,-6,39,10,4
2,00:11:10,1,True,20,7,13,54,10,4
2,00:10:13,1,False,7,20,-13,45,10,4
2,00:09:14,1,False,7,20,-13,3,3,4
2,00:08:03,2,False,7,20,-13,1,1,4
2,00:07:45,1,False,7,27,-20,30,10,4
2,00:06:46,1,False,7,27,-20,42,10,4
2,00:05:42,1,True,27,7,20,28,10,4
2,00:05:12,2,True,27,7,20,33,5,4
2,00:04:45,1,True,27,7,20,40,10,4
2,00:02:29,1,False,7,28,-21,36,10,4
2,00:02:18,2,False,7,28,-21,35,11,4
2,00:01:42,1,True,28,7,21,46,10,4
2,00:01:34,2,True,28,7,21,55,1,4
2,00:01:16,3,False,7,28,-21,54,0,4
2,00:00:15,1,False,7,31,-24,35,10,4
3,00:13:29,1,True,31,7,24,36,10,4
3,00:12:37,3,True,31,7,24,45,1,4
3,00:11:59,1,True,31,7,24,47,10,4
3,00:11:08,1,True,31,7,24,51,10,4
3,00:10:44,2,True,31,7,24,45,4,4
3,00:07:57,1,True,31,14,17,11,10,4
3,00:07:20,2,True,31,14,17,16,5,4
3,00:07:03,1,True,31,14,17,23,10,4
3,00:05:13,1,True,31,14,17,51,10,4
3,00:04:12,1,True,31,14,17,10,10,4
3,00:01:58,2,True,31,14,17,54,1,4
4,00:15:00,2,False,14,31,-17,35,1,4
4,00:13:13,2,True,31,14,17,39,20,4
4,00:11:38,1,True,32,14,18,47,10,4
4,00:10:40,2,False,14,32,-18,51,10,4
4,00:07:49,1,True,32,14,18,44,10,4
4,00:02:04,1,False,14,32,-18,34,10,4
4,00:01:58,2,False,14,32,-18,35,11,4
4,00:01:09,1,True,35,14,21,44,10,4
4,00:00:47,2,True,35,14,21,45,9,4
4,00:00:12,1,False,14,35,-21,25,10,4
4,00:00:01,2,False,14,35,-21,29,7,4
1,00:13:28,1,True,0,0,0,42,10,4
1,00:12:16,1,False,0,0,0,43,10,4
1,00:11:05,1,True,0,0,0,54,10,4
1,00:04:18,1,False,0,7,-7,9,9,4
1,00:01:51,2,False,0,14,-14,36,13,4
2,00:12:39,1,True,14,3,11,35,10,4
2,00:10:53,1,False,3,14,-11,41,10,4
2,00:10:27,1,False,3,14,-11,30,10,4
2,00:09:14,1,False,3,14,-11,19,10,4
2,00:08:54,1,True,21,3,18,50,10,4
2,00:04:17,2,False,3,21,-18,42,3,4
2,00:03:19,1,False,3,21,-18,27,10,4
2,00:01:48,1,True,24,3,21,52,10,4
3,00:14:35,1,True,31,3,28,40,20,4
3,00:12:03,1,False,3,31,-28,25,10,4
3,00:11:39,2,False,3,31,-28,16,1,4
3,00:10:44,1,False,3,31,-28,14,10,4
3,00:08:58,1,False,3,34,-31,37,10,4
3,00:05:43,1,True,34,3,31,10,10,4
3,00:04:11,3,True,34,3,31,35,1,4
3,00:03:50,1,True,34,3,31,37,10,4
3,00:01:45,2,False,3,34,-31,40,0,4
3,00:01:16,1,False,3,34,-31,42,10,4
3,00:00:01,1,True,34,3,31,15,10,4
4,00:13:32,2,False,5,34,-29,53,2,4
4,00:08:38,1,True,36,5,31,35,10,4
4,00:06:16,0,True,36,5,31,11,0,4
4,00:04:31,3,False,5,36,-31,46,1,4
4,00:02:37,1,True,36,5,31,26,10,4
4,00:01:48,1,True,36,5,31,21,10,4
4,00:01:11,1,False,5,36,-31,49,10,4
1,00:14:25,1,True,0,0,0,45,10,4
1,00:10:44,1,True,0,0,0,33,10,4
1,00:09:04,1,False,0,7,-7,24,10,4
1,00:04:37,2,False,0,10,-10,44,1,4
1,00:02:42,1,True,10,0,10,11,10,4
1,00:02:01,1,True,10,0,10,6,6,4
1,00:00:42,1,True,10,7,3,35,10,4
2,00:12:10,2,False,7,13,-6,40,2,4
2,00:11:38,1,False,7,13,-6,43,10,4
2,00:10:13,1,True,13,7,6,45,10,4
2,00:08:13,1,True,13,10,3,49,10,4
2,00:07:14,2,False,10,13,-3,45,5,4
2,00:03:40,1,False,10,21,-11,55,10,4
2,00:02:21,2,True,21,10,11,38,2,4
3,00:13:02,2,True,21,17,4,43,2,4
3,00:10:30,1,False,17,21,-4,21,10,4
3,00:08:16,2,True,21,17,4,48,1,4
4,00:14:37,1,True,27,20,7,48,10,4
4,00:12:58,1,False,20,27,-7,7,10,4
4,00:11:53,1,False,20,27,-7,18,10,4
4,00:09:44,1,False,20,27,-7,54,10,4
4,00:04:43,2,False,21,27,-6,1,10,4
4,00:03:51,1,True,29,21,8,40,10,4
4,00:01:49,1,False,21,36,-15,49,10,4
4,00:01:35,2,False,21,36,-15,50,11,4
1,00:12:53,1,False,7,0,7,55,10,4
1,00:11:36,1,True,0,7,-7,18,10,4
1,00:07:35,1,True,0,10,-10,46,10,4
1,00:06:18,1,False,10,0,10,20,10,4
1,00:03:46,2,True,0,10,-10,52,3,4
1,00:00:35,1,True,1,10,-9,15,10,4
2,00:11:49,2,False,12,1,11,31,10,4
2,00:10:59,1,True,1,12,-11,29,10,4
2,00:10:00,1,True,1,12,-11,41,10,4
2,00:09:22,2,True,1,12,-11,44,7,4
2,00:08:39,1,False,12,1,11,32,10,4
2,00:05:01,1,False,12,1,11,49,10,4
2,00:03:39,1,False,12,1,11,54,10,4
2,00:02:32,1,True,8,12,-4,13,10,4
2,00:01:37,1,True,8,15,-7,35,10,4
3,00:14:53,1,True,15,15,0,33,10,4
3,00:14:25,1,False,15,15,0,42,10,4
3,00:13:01,1,False,15,22,-7,34,10,4
3,00:11:31,1,True,22,15,7,50,10,4
3,00:08:25,2,False,15,22,-7,52,5,4
3,00:07:19,1,False,15,22,-7,3,3,4
3,00:04:45,1,False,15,29,-14,26,10,4
3,00:04:03,2,False,15,29,-14,33,3,4
3,00:01:45,1,True,29,15,14,50,10,4
3,00:00:16,1,False,15,29,-14,20,10,4
4,00:15:00,1,False,15,29,-14,31,10,4
4,00:14:48,2,False,15,29,-14,39,2,4
4,00:13:25,1,False,15,29,-14,35,10,4
4,00:12:47,2,False,15,29,-14,27,2,4
4,00:12:04,3,False,15,29,-14,25,0,4
4,00:11:25,1,False,15,29,-14,24,10,4
4,00:09:34,1,False,15,29,-14,2,2,4
4,00:05:10,1,True,36,22,14,27,10,4
4,00:04:30,2,True,36,22,14,35,2,4
4,00:03:50,1,True,36,22,14,43,10,4
4,00:03:15,1,False,22,36,-14,18,10,4
4,00:02:48,1,False,22,36,-14,4,4,4
4,00:00:48,1,True,43,22,21,2,2,4
4,00:00:46,1,False,29,43,-14,50,10,4
1,00:12:20,1,True,0,0,0,55,10,4
1,00:11:08,1,False,0,0,0,27,10,4
1,00:10:04,1,True,0,0,0,15,10,4
1,00:07:14,2,True,0,7,-7,39,2,4
1,00:06:35,1,True,0,7,-7,43,10,4
1,00:06:00,2,True,0,7,-7,50,3,4
1,00:03:44,1,True,0,14,-14,47,5,4
1,00:03:13,2,True,0,14,-14,51,1,4
1,00:02:20,2,False,14,0,14,42,2,4
1,00:01:55,3,False,14,0,14,43,1,4
1,00:01:13,1,False,14,0,14,46,10,4
1,00:00:33,2,False,14,0,14,54,2,4
2,00:10:13,1,False,16,0,16,53,10,4
2,00:09:01,1,True,0,16,-16,32,10,4
2,00:06:45,1,True,0,16,-16,11,10,4
2,00:06:27,1,True,0,16,-16,30,10,4
2,00:04:56,1,False,16,0,16,38,10,4
2,00:03:30,1,True,0,16,-16,52,10,4
2,00:01:05,1,False,16,3,13,35,10,4
3,00:14:55,1,False,16,3,13,42,10,4
3,00:12:19,2,False,16,3,13,41,1,4
3,00:11:43,1,False,16,3,13,22,10,4
3,00:11:29,2,False,16,3,13,19,7,4
3,00:10:35,3,False,16,3,13,15,3,4
3,00:08:10,2,False,16,10,6,32,9,4
3,00:07:34,1,False,16,10,6,41,10,4
3,00:05:55,1,True,10,23,-13,43,10,4
3,00:04:27,1,False,23,10,13,54,10,4
3,00:03:22,1,False,23,10,13,4,10,4
3,00:02:57,1,False,23,10,13,22,10,4
3,00:01:09,1,False,23,10,13,41,10,4
4,00:13:44,3,True,10,23,-13,47,1,4
4,00:11:51,1,False,23,10,13,45,10,4
4,00:08:08,1,False,23,20,3,35,10,4
4,00:07:49,2,False,23,20,3,43,2,4
4,00:05:51,1,True,20,23,-3,36,10,4
4,00:02:18,1,True,27,24,3,35,10,4
4,00:01:47,1,True,27,24,3,46,10,4
4,00:01:01,1,False,24,27,-3,52,10,4
4,00:00:49,2,True,27,24,3,52,16,4
1,00:14:07,1,True,0,0,0,42,10,4
1,00:10:54,0,True,0,3,-3,54,0,4
1,00:06:47,1,False,3,0,3,50,10,4
1,00:05:47,2,False,3,0,3,21,2,4
1,00:04:36,1,False,3,0,3,16,10,4
1,00:03:12,1,False,3,3,0,35,10,4
1,00:01:38,1,True,3,3,0,26,10,4
2,00:12:58,1,False,3,3,0,29,10,4
2,00:10:25,1,True,10,3,7,51,10,4
2,00:04:42,1,True,10,6,4,16,10,4
2,00:03:38,1,True,10,6,4,26,10,4
2,00:02:14,1,True,10,6,4,41,10,4
2,00:00:54,3,True,10,9,1,2,0,4
2,00:00:37,1,True,10,9,1,1,1,4
2,00:00:28,1,True,10,15,-5,33,10,4
2,00:00:17,2,True,10,15,-5,38,5,4
3,00:14:53,1,False,15,10,5,31,10,4
3,00:13:36,1,False,15,13,2,35,10,4
3,00:10:34,2,True,13,15,-2,29,2,4
3,00:07:45,1,False,15,13,2,1,1,4
3,00:06:47,2,True,19,15,4,54,2,4
3,00:05:08,3,True,19,15,4,40,0,4
3,00:03:42,2,True,19,15,4,30,1,4
3,00:01:57,1,True,19,18,1,35,10,4
3,00:01:17,1,True,19,18,1,45,10,4
3,00:00:55,2,True,19,18,1,54,1,4
4,00:10:25,1,False,18,22,-4,35,10,4
4,00:09:59,2,False,18,22,-4,35,10,4
4,00:07:01,2,False,18,22,-4,42,0,4
4,00:06:21,2,True,22,18,4,53,0,4
4,00:04:45,1,True,22,25,-3,30,10,4
4,00:03:43,1,False,25,22,3,54,10,4
4,00:03:00,2,False,25,22,3,45,1,4
4,00:01:48,1,False,25,22,3,3,3,4
4,00:01:05,1,False,25,29,-4,35,10,4
4,00:00:58,2,False,25,29,-4,28,3,4
1,00:13:28,1,False,0,0,0,48,10,4
1,00:13:08,2,True,0,0,0,54,2,4
1,00:11:08,1,False,0,7,-7,27,10,4
1,00:08:55,1,True,7,0,7,16,10,4
1,00:01:42,1,False,0,10,-10,35,10,4
1,00:00:32,1,True,10,0,10,34,10,4
2,00:15:00,1,True,10,0,10,53,10,4
2,00:13:50,1,False,0,10,-10,35,10,4
2,00:12:00,1,True,10,7,3,34,10,4
2,00:10:39,1,True,10,7,3,3,3,4
2,00:09:15,1,True,10,14,-4,34,10,4
2,00:06:35,1,False,14,11,3,35,10,4
2,00:06:10,2,False,14,11,3,42,3,4
2,00:05:22,1,False,14,11,3,51,10,4
2,00:02:35,1,True,11,15,-4,35,10,4
2,00:01:33,2,False,15,11,4,48,4,4
2,00:00:43,1,True,11,15,-4,24,10,4
3,00:14:25,1,False,15,11,4,42,10,4
3,00:13:02,1,True,11,15,-4,34,10,4
3,00:12:51,2,True,11,15,-4,42,2,4
3,00:11:07,1,False,15,11,4,35,10,4
3,00:10:42,2,False,15,11,4,26,1,4
3,00:10:01,3,False,15,11,4,25,0,4
3,00:07:19,1,False,15,17,-2,18,10,4
3,00:06:14,1,False,15,17,-2,34,10,4
3,00:04:34,2,True,17,15,2,29,10,4
3,00:02:32,1,False,15,17,-2,52,10,4
3,00:01:05,1,False,15,17,-2,6,10,4
4,00:14:22,1,True,19,15,4,46,15,4
4,00:14:09,2,True,19,15,4,55,6,4
4,00:11:14,1,False,15,19,-4,50,10,4
4,00:10:49,1,False,15,19,-4,37,10,4
4,00:09:08,1,False,15,20,-5,35,10,4
4,00:08:55,1,False,15,20,-5,50,10,4
4,00:06:43,1,False,15,20,-5,35,10,4
4,00:03:37,1,True,20,15,5,40,10,4
4,00:02:33,2,True,20,23,-3,50,3,4
4,00:01:46,1,True,20,23,-3,53,10,4
4,00:01:40,2,True,20,23,-3,50,7,4
4,00:01:04,1,True,20,23,-3,48,10,4
1,00:14:27,2,False,0,0,0,26,10,4
1,00:13:58,1,False,0,0,0,39,10,4
1,00:13:21,2,False,0,0,0,45,4,4
1,00:12:43,1,False,0,0,0,50,10,4
1,00:10:37,1,True,0,0,0,34,10,4
1,00:08:00,1,False,3,0,3,55,10,4
1,00:06:22,1,False,3,0,3,50,10,4
1,00:04:55,1,False,3,0,3,25,10,4
1,00:01:42,1,False,3,0,3,1,1,4
2,00:14:22,2,True,7,4,3,33,12,4
2,00:13:42,1,True,7,4,3,46,10,4
2,00:12:04,1,False,4,7,-3,12,10,4
2,00:10:27,2,False,4,7,-3,40,0,4
2,00:09:41,1,False,4,7,-3,39,10,4
2,00:07:47,1,False,4,10,-6,46,10,4
2,00:06:26,1,True,10,4,6,22,10,4
2,00:05:48,2,True,10,4,6,22,10,4
2,00:05:00,1,True,10,4,6,42,10,4
2,00:04:01,1,True,10,4,6,53,10,4
2,00:02:45,1,False,4,10,-6,1,1,4
2,00:01:58,1,True,17,4,13,21,10,4
2,00:01:27,1,True,17,4,13,35,10,4
2,00:00:10,1,True,17,4,13,54,10,4
3,00:14:53,1,True,17,4,13,38,10,4
3,00:12:15,1,True,17,4,13,27,10,4
3,00:11:37,1,True,17,4,13,39,10,4
3,00:10:32,1,False,4,17,-13,30,10,4
3,00:09:43,2,False,4,17,-13,46,5,4
3,00:08:15,2,False,4,17,-13,50,15,4
3,00:07:25,1,True,17,4,13,15,10,4
3,00:06:57,2,True,17,4,13,24,1,4
3,00:03:14,1,True,17,7,10,40,10,4
3,00:00:54,1,False,7,17,-10,19,10,4
4,00:13:24,1,False,7,17,-10,45,10,4
4,00:12:40,2,False,7,17,-10,38,3,4
4,00:08:42,1,False,7,20,-13,24,10,4
4,00:07:42,1,False,7,20,-13,1,1,4
4,00:05:05,1,True,23,7,16,32,10,4
4,00:03:25,2,False,7,23,-16,40,10,4
4,00:02:40,1,True,23,7,16,30,10,4
4,00:02:33,1,True,23,7,16,43,10,4
4,00:02:06,2,True,23,7,16,46,7,4
4,00:01:40,3,True,23,7,16,52,1,4
4,00:01:06,1,False,7,23,-16,22,10,4
4,00:00:58,2,False,7,23,-16,20,8,4
1,00:14:55,1,True,0,0,0,27,10,4
1,00:08:55,2,False,0,0,0,25,1,4
1,00:05:15,1,False,0,3,-3,43,10,4
1,00:01:07,1,True,3,3,0,37,10,4
2,00:11:14,1,False,3,6,-3,49,10,4
2,00:10:36,2,True,6,3,3,53,2,4
2,00:08:19,2,True,6,3,3,11,5,4
2,00:04:34,1,False,10,6,4,53,10,4
2,00:01:59,1,True,6,10,-4,41,10,4
2,00:01:41,2,True,6,10,-4,32,1,4
3,00:14:51,1,False,17,6,11,43,10,4
3,00:12:35,1,True,6,20,-14,35,10,4
3,00:10:39,2,False,20,6,14,34,4,4
3,00:08:30,1,True,6,27,-21,34,10,4
3,00:07:49,2,True,6,27,-21,43,1,4
3,00:06:02,2,False,27,6,21,29,7,4
3,00:05:06,2,True,6,27,-21,54,1,4
3,00:02:34,1,False,27,6,21,47,10,4
3,00:01:12,1,True,6,27,-21,45,10,4
4,00:14:25,2,True,6,27,-21,19,11,4
4,00:11:42,1,False,30,7,23,35,10,4
4,00:06:18,2,False,30,7,23,14,3,4
4,00:03:50,1,True,7,37,-30,39,10,4
4,00:02:27,1,False,37,7,30,54,10,4
4,00:02:22,2,False,37,7,30,55,9,4
4,00:01:58,1,True,7,37,-30,45,10,4
4,00:01:33,2,True,7,37,-30,48,13,4
4,00:00:40,2,True,7,37,-30,1,10,4
1,00:14:54,1,False,0,0,0,43,10,4
1,00:11:35,1,True,0,0,0,6,5,4
1,00:10:25,1,True,0,0,0,27,10,4
1,00:09:19,1,True,0,0,0,51,10,4
1,00:08:59,1,True,0,0,0,40,10,4
1,00:07:25,1,True,0,3,-3,35,10,4
1,00:06:14,1,True,0,10,-10,27,10,4
1,00:04:07,1,False,10,0,10,51,10,4
1,00:03:11,1,False,10,0,10,32,10,4
1,00:02:37,1,False,10,0,10,16,10,4
1,00:00:01,1,True,3,10,-7,7,10,4
2,00:15:00,1,True,3,10,-7,21,10,4
2,00:14:04,1,True,3,10,-7,31,10,4
2,00:12:20,2,False,10,3,7,29,3,4
2,00:11:36,1,False,10,3,7,33,10,4
2,00:10:55,2,False,10,3,7,42,1,4
2,00:10:10,1,False,10,3,7,50,10,4
2,00:07:25,1,False,10,3,7,45,10,4
2,00:07:00,2,False,10,3,7,37,2,4
2,00:05:12,2,False,10,3,7,11,2,4
2,00:03:09,2,True,10,10,0,40,15,4
2,00:01:59,1,False,13,10,3,17,10,4
3,00:14:49,1,True,10,13,-3,32,10,4
3,00:14:22,2,True,10,13,-3,41,1,4
3,00:13:13,1,False,13,10,3,44,10,4
3,00:12:12,2,False,13,10,3,37,3,4
3,00:11:06,2,False,13,10,3,34,10,4
3,00:10:26,3,False,13,10,3,25,1,4
3,00:09:07,1,False,13,10,3,9,9,4
3,00:07:02,1,True,13,13,0,41,10,4
3,00:06:18,2,True,13,13,0,38,7,4
3,00:05:53,1,True,13,13,0,27,10,4
3,00:05:19,2,True,13,13,0,20,3,4
3,00:04:12,1,True,13,16,-3,35,10,4
3,00:01:49,1,False,16,13,3,8,8,4
3,00:01:29,1,False,16,20,-4,49,10,4
3,00:00:48,1,True,20,16,4,50,10,4
4,00:14:52,1,True,20,23,-3,40,10,4
4,00:14:20,1,True,20,23,-3,51,10,4
4,00:11:27,2,False,23,20,3,16,6,4
4,00:07:48,1,False,23,23,0,47,10,4
4,00:07:19,2,False,23,23,0,39,2,4
4,00:06:43,1,False,23,23,0,23,10,4
4,00:05:54,1,False,23,23,0,1,1,4
4,00:04:42,1,False,23,23,0,1,1,4
4,00:04:07,2,False,23,23,0,1,1,4
4,00:02:49,2,False,23,26,-3,50,10,4
4,00:02:21,1,True,26,23,3,13,10,4
4,00:01:54,1,True,26,23,3,28,10,4
4,00:01:49,2,True,26,23,3,27,11,4
1,00:14:56,1,False,0,0,0,38,10,4
1,00:14:34,2,False,0,0,0,46,2,4
1,00:14:02,1,False,0,0,0,50,10,4
1,00:11:56,2,True,0,0,0,15,2,4
1,00:11:16,1,True,0,0,0,22,10,4
1,00:08:08,1,True,0,1,-1,35,10,4
1,00:06:37,1,False,1,0,1,53,10,4
1,00:03:50,1,True,0,2,-2,31,10,4
2,00:14:08,1,True,0,2,-2,23,10,4
2,00:10:18,1,False,2,0,2,20,10,4
2,00:08:58,1,False,2,0,2,27,10,4
2,00:07:59,1,False,2,0,2,8,8,4
2,00:07:38,2,False,2,0,2,3,3,4
2,00:06:57,3,False,2,0,2,2,2,4
2,00:05:54,2,False,2,0,2,15,1,4
2,00:01:51,2,True,0,2,-2,49,2,4
2,00:01:19,1,False,2,0,2,10,10,4
2,00:01:11,1,False,2,0,2,31,10,4
2,00:00:49,2,False,2,0,2,35,6,4
3,00:11:45,1,False,2,3,-1,35,10,4
3,00:09:51,1,False,2,3,-1,19,10,4
3,00:08:25,1,False,2,3,-1,31,10,4
3,00:05:51,1,True,6,2,4,40,10,4
3,00:02:52,3,False,9,6,3,51,0,4
3,00:00:44,1,False,9,6,3,13,10,4
4,00:14:32,1,True,6,9,-3,43,10,4
4,00:13:17,1,False,9,6,3,44,10,4
4,00:11:20,1,True,6,9,-3,52,10,4
4,00:09:52,1,True,6,10,-4,35,10,4
4,00:09:31,2,True,6,10,-4,44,1,4
4,00:07:48,1,False,10,6,4,50,10,4
4,00:07:25,1,True,6,10,-4,50,10,4
4,00:05:09,2,True,6,10,-4,21,2,4
4,00:02:04,2,False,10,6,4,24,0,4
4,00:00:57,1,False,10,13,-3,43,10,4
4,00:00:46,2,False,10,13,-3,51,2,4
4,00:00:38,1,True,13,10,3,38,10,4
4,00:00:26,2,True,13,10,3,30,2,4
5,00:00:00,2,False,16,13,3,26,1,4
5,00:00:00,3,False,16,13,3,25,0,4
5,00:00:00,2,False,16,13,3,15,1,4
5,00:00:00,3,False,16,13,3,14,0,4
5,00:00:00,1,False,16,13,3,13,10,4
5,00:15:00,1,False,16,13,3,2,2,4
1,00:14:54,1,True,0,0,0,32,10,4
1,00:13:32,2,True,0,0,0,51,3,4
1,00:12:17,2,True,0,0,0,53,13,4
1,00:10:00,2,False,0,0,0,37,9,4
1,00:08:50,1,False,0,0,0,25,10,4
1,00:07:43,1,False,0,0,0,37,10,4
1,00:05:43,1,True,0,0,0,32,10,4
1,00:02:25,1,True,3,0,3,53,10,4
1,00:01:46,2,True,3,0,3,48,5,4
2,00:14:14,1,False,7,3,4,26,10,4
2,00:12:28,1,False,7,6,1,52,10,4
2,00:11:42,2,False,7,6,1,54,8,4
2,00:09:22,1,True,6,7,-1,35,10,4
2,00:07:50,1,True,6,7,-1,15,10,4
2,00:07:11,2,True,6,7,-1,6,1,4
2,00:06:04,1,True,6,7,-1,5,5,4
2,00:04:43,2,True,6,7,-1,2,2,4
2,00:02:33,1,False,14,13,1,37,10,4
2,00:02:00,2,False,14,13,1,54,10,4
3,00:14:54,1,False,17,16,1,33,10,4
3,00:14:28,2,False,17,16,1,40,3,4
3,00:13:53,1,False,17,16,1,55,10,4
3,00:13:18,2,True,16,17,-1,50,5,4
3,00:11:48,0,False,17,16,1,22,0,4
3,00:10:33,1,True,16,17,-1,1,1,4
3,00:10:09,1,True,16,24,-8,31,10,4
3,00:08:32,2,False,24,16,8,47,3,4
3,00:03:02,3,True,16,24,-8,50,2,4
3,00:02:50,1,True,16,24,-8,51,10,4
3,00:02:21,2,True,16,24,-8,52,11,4
3,00:02:21,2,True,16,24,-8,52,11,4
3,00:00:39,1,True,16,25,-9,49,10,4
3,00:00:01,2,True,16,25,-9,50,9,4
4,00:14:45,2,False,25,16,9,45,10,4
4,00:13:57,1,False,25,16,9,10,10,4
4,00:12:53,1,False,25,23,2,36,10,4
4,00:12:24,2,False,25,23,2,43,3,4
4,00:09:29,2,True,23,25,-2,32,1,4
4,00:09:04,1,True,23,25,-2,44,10,4
4,00:08:27,2,True,23,25,-2,48,6,4
4,00:07:44,1,False,25,23,2,52,10,4
4,00:06:35,1,False,25,23,2,40,10,4
4,00:04:57,1,False,25,26,-1,35,10,4
4,00:04:24,1,True,26,25,1,52,10,4
4,00:02:56,1,True,26,25,1,23,10,4
4,00:02:36,2,True,26,25,1,23,10,4
4,00:01:47,1,False,25,26,-1,42,10,4
4,00:01:42,2,False,25,26,-1,39,7,4
4,00:01:18,1,False,25,26,-1,26,10,4
1,00:14:07,1,False,0,0,0,46,10,4
1,00:13:10,1,True,0,0,0,52,10,4
1,00:11:05,0,False,0,0,0,49,0,4
1,00:10:19,1,False,0,0,0,27,10,4
1,00:09:16,1,False,0,0,0,37,10,4
1,00:07:51,1,False,0,0,0,8,8,4
1,00:06:43,1,False,0,3,-3,35,10,4
1,00:05:47,1,True,3,0,3,53,10,4
1,00:04:59,2,True,3,0,3,32,1,4
1,00:03:59,1,True,3,0,3,5,5,4
1,00:01:49,1,False,7,3,4,28,10,4
1,00:00:15,1,False,7,6,1,35,10,4
2,00:14:37,1,False,7,6,1,48,10,4
2,00:13:53,2,False,7,6,1,52,6,4
2,00:13:12,1,True,6,7,-1,49,10,4
2,00:12:42,2,True,6,7,-1,42,3,4
2,00:10:59,1,True,6,7,-1,23,10,4
2,00:10:21,2,True,6,7,-1,14,1,4
2,00:09:42,1,True,6,7,-1,9,9,4
2,00:07:54,1,False,14,6,8,16,10,4
2,00:06:55,1,False,14,6,8,34,10,4
2,00:06:35,1,False,14,6,8,48,10,4
2,00:06:10,2,False,14,6,8,55,3,4
2,00:05:39,1,True,6,14,-8,47,10,4
2,00:02:36,1,True,6,22,-16,32,10,4
2,00:01:37,1,False,22,6,16,29,10,4
3,00:14:54,1,True,6,22,-16,38,10,4
3,00:14:25,2,True,6,22,-16,45,3,4
3,00:13:12,1,False,22,6,16,30,10,4
3,00:11:41,1,True,6,22,-16,47,10,4
3,00:11:09,2,False,22,6,16,54,1,4
3,00:07:54,1,True,13,22,-9,20,10,4
3,00:06:13,1,True,13,22,-9,10,10,4
3,00:04:28,1,False,22,13,9,18,10,4
3,00:00:08,2,False,22,13,9,36,2,4
4,00:14:38,2,False,22,13,9,41,9,4
4,00:13:30,3,False,22,13,9,48,2,4
4,00:12:59,1,False,22,13,9,53,10,4
4,00:12:15,2,True,13,22,-9,49,2,4
4,00:11:40,1,True,13,22,-9,45,10,4
4,00:10:55,2,True,13,22,-9,35,0,4
4,00:10:11,1,True,13,22,-9,25,10,4
4,00:09:10,1,True,13,22,-9,13,10,4
4,00:07:23,1,True,13,25,-12,35,10,4
4,00:05:58,1,False,25,13,12,26,10,4
4,00:05:16,2,False,25,13,12,28,8,4
4,00:04:12,1,True,13,25,-12,32,10,4
4,00:02:59,1,True,13,28,-15,35,10,4
4,00:02:13,1,True,13,28,-15,42,10,4
4,00:02:07,2,True,13,28,-15,39,7,4
4,00:01:44,1,True,13,28,-15,31,10,4
4,00:01:12,1,True,13,28,-15,1,1,4
4,00:00:40,3,True,13,35,-22,36,4,4
4,00:00:26,1,False,35,13,22,50,10,4
1,00:05:07,1,False,3,7,-4,20,10,4
1,00:02:37,1,True,7,3,4,21,10,4
1,00:01:58,2,True,7,3,4,13,2,4
2,00:14:30,1,False,10,7,3,29,10,4
2,00:11:20,1,True,14,10,4,44,10,4
2,00:09:34,1,False,10,14,-4,26,5,4
2,00:09:10,2,False,10,14,-4,30,1,4
2,00:06:55,1,False,10,14,-4,1,1,4
2,00:04:55,2,False,10,21,-11,44,1,4
2,00:02:06,2,True,24,10,14,33,5,4
2,00:01:12,2,True,24,10,14,18,4,4
3,00:14:43,1,False,17,24,-7,42,10,4
3,00:11:53,1,True,24,17,7,13,10,4
3,00:08:01,2,False,24,24,0,23,2,4
3,00:07:30,3,False,24,24,0,25,0,4
3,00:01:10,1,True,24,24,0,16,5,4
4,00:13:29,1,False,27,24,3,11,10,4
4,00:12:59,2,False,27,24,3,17,4,4
4,00:11:15,2,False,27,24,3,32,2,4
4,00:07:50,2,True,24,27,-3,34,8,4
4,00:06:55,1,False,27,24,3,38,10,4
4,00:03:02,1,True,24,27,-3,38,10,4
4,00:02:33,3,True,24,27,-3,28,0,4
4,00:02:25,1,True,24,27,-3,27,10,4
4,00:02:07,2,True,24,27,-3,20,3,4
4,00:01:45,1,True,24,27,-3,16,10,4
4,00:00:51,2,False,30,24,6,42,12,4
1,00:13:43,1,True,0,0,0,26,10,4
1,00:11:51,2,True,0,0,0,47,2,4
1,00:08:48,1,False,3,0,3,28,5,4
1,00:08:26,2,False,3,0,3,26,3,4
1,00:07:54,1,False,3,0,3,16,10,4
1,00:04:32,1,True,7,3,4,21,10,4
1,00:03:56,2,True,7,3,4,23,8,4
1,00:03:20,1,True,7,3,4,32,10,4
1,00:00:41,1,True,7,3,4,49,10,4
1,00:00:01,2,False,3,7,-4,51,0,4
2,00:09:33,1,False,3,10,-7,18,10,4
2,00:09:00,1,False,3,10,-7,3,3,4
2,00:08:02,1,False,3,17,-14,8,8,4
2,00:05:31,1,False,3,17,-14,1,1,4
2,00:03:46,1,True,24,3,21,17,10,4
2,00:02:47,1,True,24,6,18,35,10,4
2,00:02:40,1,True,24,6,18,53,10,4
2,00:01:25,1,True,31,6,25,29,10,4
2,00:01:18,1,True,31,6,25,49,10,4
2,00:00:34,2,False,6,31,-25,52,11,4
3,00:13:31,1,True,31,6,25,39,10,4
3,00:09:48,1,True,31,6,25,36,10,4
3,00:08:04,1,False,6,31,-25,23,10,4
3,00:06:59,1,False,6,31,-25,49,10,4
3,00:05:53,1,True,31,6,25,35,10,4
3,00:05:26,2,True,31,6,25,41,4,4
3,00:02:52,1,True,31,6,25,18,10,4
3,00:02:39,1,True,31,13,18,45,10,4
4,00:13:11,2,False,16,31,-15,23,10,4
4,00:11:13,1,True,31,16,15,28,10,4
4,00:09:59,2,True,31,16,15,19,19,4
4,00:09:36,1,True,31,16,15,40,10,4
4,00:09:06,1,False,16,31,-15,54,10,4
4,00:08:22,2,False,16,31,-15,47,3,4
4,00:07:17,1,False,16,31,-15,34,10,4
4,00:05:23,1,False,16,31,-15,4,4,4
4,00:03:11,1,True,45,16,29,44,10,4
4,00:01:56,1,True,45,16,29,2,2,4
4,00:01:54,1,False,23,45,-22,53,10,4
4,00:01:48,2,False,23,45,-22,48,5,4
4,00:01:24,1,False,23,45,-22,40,10,4
1,00:14:53,1,True,0,0,0,29,10,4
1,00:10:03,1,False,0,0,0,41,10,4
1,00:08:43,1,False,0,3,-3,25,10,4
1,00:07:36,1,False,0,3,-3,48,10,4
1,00:05:18,1,True,3,0,3,24,10,4
1,00:03:29,1,True,3,0,3,1,1,4
1,00:03:04,1,True,3,7,-4,26,10,4
1,00:02:35,1,True,3,7,-4,42,10,4
1,00:00:18,1,False,7,3,4,14,10,4
2,00:15:00,1,False,7,3,4,34,10,4
2,00:13:30,2,True,3,7,-4,47,1,4
2,00:12:59,1,True,3,7,-4,44,10,4
2,00:11:57,2,True,3,7,-4,13,2,4
2,00:11:36,1,True,3,14,-11,34,10,4
2,00:09:23,1,False,14,3,11,48,10,4
2,00:07:38,2,False,14,3,11,12,4,4
2,00:04:11,1,False,14,10,4,49,10,4
2,00:02:44,2,False,14,13,1,27,10,4
2,00:00:24,1,True,13,14,-1,38,10,4
2,00:00:01,1,False,14,13,1,54,10,4
3,00:13:26,1,True,13,14,-1,37,10,4
3,00:09:16,2,False,14,13,1,30,10,4
3,00:08:23,1,True,13,14,-1,27,10,4
3,00:06:58,1,True,13,14,-1,35,10,4
3,00:03:12,1,True,13,14,-1,16,10,4
3,00:01:29,1,True,13,14,-1,9,9,4
4,00:14:17,1,False,17,13,4,40,10,4
4,00:12:32,1,True,13,17,-4,41,10,4
4,00:10:47,1,False,17,13,4,30,10,4
4,00:07:52,1,True,16,17,-1,20,10,4
4,00:05:30,1,True,16,24,-8,10,10,4
4,00:03:52,1,False,24,16,8,37,10,4
4,00:03:03,1,False,24,16,8,26,10,4
4,00:02:16,1,False,24,22,2,27,10,4
4,00:01:44,1,True,22,24,-2,51,10,4
4,00:01:20,2,True,22,24,-2,45,4,4
4,00:01:20,3,True,22,24,-2,42,1,4
1,00:13:55,1,False,0,0,0,49,10,4
1,00:12:42,1,True,0,0,0,43,10,4
1,00:07:55,1,True,0,0,0,45,10,4
1,00:05:32,1,False,0,7,-7,36,10,4
1,00:04:59,2,False,0,7,-7,46,0,4
1,00:03:45,1,True,7,0,7,35,10,4
1,00:01:30,3,True,7,3,4,44,1,4
2,00:14:42,1,False,3,7,-4,31,10,4
2,00:14:00,2,False,3,7,-4,40,1,4
2,00:09:38,1,False,3,7,-4,15,10,4
2,00:08:35,2,False,3,7,-4,33,3,4
2,00:07:35,2,True,7,3,4,26,10,4
2,00:03:03,1,False,4,7,-3,40,10,4
2,00:02:15,1,True,7,4,3,12,10,4
2,00:01:38,1,True,7,4,3,9,10,4
2,00:01:34,1,True,7,4,3,20,10,4
2,00:00:38,1,False,4,7,-3,13,10,4
2,00:00:20,2,False,4,7,-3,9,6,4
3,00:13:43,1,True,10,4,6,49,10,4
3,00:13:03,2,False,4,10,-6,54,3,4
3,00:11:55,2,False,4,10,-6,40,0,4
3,00:11:24,1,False,4,10,-6,39,10,4
3,00:09:45,1,False,4,10,-6,18,10,4
3,00:09:17,2,False,4,10,-6,26,2,4
3,00:08:31,1,True,10,4,6,47,10,4
4,00:13:26,2,False,4,11,-7,21,17,4
4,00:12:43,1,False,4,11,-7,54,10,4
4,00:10:25,1,True,11,4,7,30,10,4
4,00:09:30,1,True,11,4,7,25,10,4
4,00:07:50,1,True,11,4,7,37,10,4
4,00:06:44,2,False,4,11,-7,42,10,4
4,00:06:13,3,False,4,11,-7,52,0,4
4,00:05:38,1,False,4,11,-7,33,10,4
4,00:00:45,1,True,11,11,0,25,10,4
4,00:00:25,2,True,11,11,0,27,12,4
1,00:12:48,1,False,0,0,0,29,10,4
1,00:11:35,1,False,0,0,0,39,10,4
1,00:07:55,2,True,0,0,0,55,7,4
1,00:07:29,1,False,0,0,0,43,10,4
1,00:05:27,1,True,0,0,0,1,1,4
1,00:03:24,1,False,7,0,7,18,10,4
1,00:01:21,1,False,7,0,7,1,1,4
1,00:00:45,2,False,7,0,7,1,1,4
1,00:00:00,3,False,7,0,7,1,1,4
2,00:13:54,1,True,7,7,0,37,10,4
2,00:13:20,2,True,7,7,0,36,11,4
2,00:12:40,1,False,7,7,0,36,10,4
2,00:11:51,2,False,7,7,0,42,4,4
2,00:07:55,2,False,7,7,0,52,2,4
2,00:07:25,1,True,7,7,0,54,10,4
2,00:05:39,2,True,7,7,0,35,2,4
2,00:03:41,1,True,7,10,-3,39,10,4
2,00:02:04,2,True,7,10,-3,41,2,4
2,00:00:22,1,False,17,7,10,11,10,4
2,00:00:17,2,False,17,7,10,10,11,4
3,00:09:23,1,False,20,7,13,10,10,4
3,00:07:18,1,True,14,20,-6,48,10,4
3,00:03:55,2,True,14,20,-6,53,1,4
3,00:02:03,1,False,20,21,-1,27,10,4
3,00:00:47,2,False,20,21,-1,53,2,4
4,00:14:49,2,True,21,20,1,30,10,4
4,00:13:59,1,True,21,20,1,15,10,4
4,00:12:43,1,True,21,23,-2,35,10,4
4,00:11:54,2,True,21,23,-2,37,8,4
4,00:11:17,3,True,21,23,-2,44,1,4
4,00:10:17,2,True,21,23,-2,54,3,4
4,00:06:55,1,False,23,21,2,48,10,4
4,00:04:51,1,False,23,28,-5,40,10,4
4,00:02:15,1,False,23,28,-5,32,10,4
4,00:01:42,1,True,28,23,5,30,10,4
4,00:01:36,2,True,28,23,5,40,0,4
4,00:01:15,1,True,28,23,5,42,10,4
4,00:00:52,2,True,28,23,5,45,7,4
4,00:00:16,1,False,23,28,-5,11,10,4
1,00:14:48,1,False,0,0,0,36,10,4
1,00:13:17,1,False,0,0,0,1,1,4
1,00:12:58,1,False,0,7,-7,38,10,4
1,00:11:43,1,True,7,0,7,33,10,4
1,00:10:52,1,True,7,0,7,50,10,4
1,00:08:49,2,False,0,7,-7,35,2,4
1,00:05:18,1,False,0,7,-7,43,10,4
1,00:03:43,1,False,0,10,-10,33,10,4
1,00:00:51,1,True,10,7,3,34,10,4
2,00:13:41,1,False,7,10,-3,12,10,4
2,00:12:44,1,False,7,10,-3,25,10,4
2,00:11:45,1,False,7,10,-3,39,10,4
2,00:11:29,1,False,7,10,-3,49,10,4
2,00:10:25,1,True,10,7,3,33,10,4
2,00:09:48,2,True,10,7,3,23,0,4
2,00:08:56,1,True,10,14,-4,22,10,4
2,00:07:00,1,True,10,14,-4,40,10,4
2,00:04:28,1,False,14,10,4,54,10,4
2,00:03:30,1,True,10,14,-4,45,10,4
2,00:02:17,2,True,10,14,-4,32,2,4
2,00:01:56,1,True,10,14,-4,35,10,4
2,00:01:21,1,False,14,10,4,23,10,4
2,00:00:58,2,False,14,10,4,24,9,4
3,00:14:48,1,False,14,10,4,35,10,4
3,00:13:03,1,False,14,10,4,20,10,4
3,00:11:23,1,True,10,14,-4,9,9,4
3,00:10:15,1,True,10,21,-11,23,10,4
3,00:08:43,1,False,21,10,11,52,10,4
3,00:07:54,2,False,21,10,11,51,11,4
3,00:05:38,1,True,10,21,-11,28,10,4
3,00:05:01,1,True,10,21,-11,40,10,4
3,00:04:23,2,True,10,21,-11,47,3,4
3,00:03:53,3,True,10,21,-11,49,1,4
3,00:01:49,1,False,21,17,4,36,10,4
3,00:00:40,3,False,21,17,4,45,1,4
3,00:00:01,1,False,21,17,4,51,10,4
4,00:14:36,2,False,21,17,4,43,18,4
4,00:13:41,1,True,17,21,-4,19,10,4
4,00:13:19,1,True,17,21,-4,38,10,4
4,00:11:29,1,False,21,17,4,26,10,4
4,00:11:05,1,False,21,17,4,41,10,4
4,00:09:44,1,True,17,21,-4,42,10,4
4,00:09:12,1,True,17,21,-4,52,10,4
4,00:07:41,1,True,17,21,-4,47,10,4
4,00:06:03,2,True,17,21,-4,14,1,4
4,00:04:23,1,True,17,21,-4,28,15,4
4,00:03:21,1,False,21,17,4,52,10,4
4,00:03:07,2,False,21,17,4,52,10,4
4,00:01:57,2,True,17,21,-4,25,3,4
1,00:14:40,1,False,0,0,0,52,10,4
1,00:13:34,1,False,0,0,0,33,10,4
1,00:12:31,1,False,0,0,0,1,1,4
1,00:11:40,1,False,0,7,-7,36,10,4
1,00:09:08,1,True,7,0,7,12,10,4
1,00:08:45,2,True,7,0,7,18,4,4
1,00:08:09,1,True,7,0,7,25,10,4
1,00:07:15,1,True,7,0,7,39,10,4
1,00:05:44,2,False,0,7,-7,21,4,4
1,00:05:05,1,False,0,7,-7,25,10,4
1,00:00:25,1,False,0,7,-7,18,10,4
2,00:14:24,1,False,0,14,-14,47,10,4
2,00:10:58,2,True,14,3,11,43,4,4
2,00:09:33,2,False,3,14,-11,46,10,4
2,00:08:47,3,False,3,14,-11,38,2,4
2,00:05:23,1,False,3,17,-14,55,10,4
2,00:03:53,1,True,17,4,13,48,10,4
2,00:03:13,2,True,17,4,13,55,3,4
2,00:02:14,2,False,4,17,-13,55,0,4
3,00:14:54,1,False,7,17,-10,27,10,4
3,00:12:06,1,True,17,7,10,18,10,4
3,00:09:38,1,True,17,10,7,27,10,4
3,00:08:38,1,False,10,17,-7,33,10,4
3,00:08:04,2,False,10,17,-7,41,2,4
3,00:07:30,3,False,10,17,-7,43,0,4
3,00:05:58,2,True,17,10,7,49,3,4
3,00:04:23,1,True,17,10,7,26,10,4
3,00:02:03,1,True,17,17,0,46,10,4
3,00:01:20,1,False,17,17,0,50,10,4
3,00:00:46,2,False,17,17,0,50,10,4
3,00:00:10,3,False,17,17,0,40,0,4
4,00:12:43,2,False,17,17,0,28,10,4
4,00:11:32,1,False,17,17,0,41,10,4
4,00:10:10,2,True,17,17,0,34,0,4
4,00:05:25,1,True,17,20,-3,25,10,4
4,00:04:51,2,True,17,20,-3,31,4,4
4,00:03:23,1,False,20,17,3,32,10,4
4,00:02:31,1,False,20,17,3,48,10,4
4,00:00:44,1,False,20,20,0,47,10,4
4,00:00:28,2,False,20,20,0,41,4,4
4,00:00:16,1,False,20,20,0,40,20,4
1,00:13:21,2,False,0,0,0,21,10,4
1,00:11:47,1,False,0,0,0,46,10,4
1,00:11:08,1,True,0,0,0,50,10,4
1,00:10:36,2,True,0,0,0,41,1,4
1,00:05:58,1,False,3,7,-4,35,10,4
1,00:00:11,1,True,14,3,11,3,3,4
2,00:14:38,1,True,14,6,8,35,10,4
2,00:13:42,1,True,14,6,8,45,10,4
2,00:13:26,2,True,14,6,8,54,1,4
2,00:11:40,1,False,6,14,-8,14,10,4
2,00:09:47,1,False,6,21,-15,29,10,4
2,00:05:25,1,True,21,6,15,42,10,4
2,00:02:13,1,True,21,6,15,38,10,4
2,00:00:40,2,True,21,13,8,28,26,4
3,00:14:50,1,False,13,21,-8,37,10,4
3,00:12:39,1,True,21,13,8,25,10,4
3,00:11:42,1,False,13,21,-8,30,10,4
3,00:10:40,0,True,21,13,8,12,0,4
3,00:08:28,1,False,13,28,-15,50,5,4
3,00:04:01,1,True,28,13,15,45,10,4
3,00:03:37,1,False,13,28,-15,53,10,4
3,00:02:13,1,False,13,28,-15,24,10,4
4,00:15:00,2,True,35,13,22,30,2,4
4,00:11:42,1,True,35,13,22,35,10,4
4,00:09:02,1,False,16,35,-19,45,10,4
4,00:07:06,1,True,35,16,19,18,10,4
4,00:05:24,1,True,35,23,12,29,10,4
4,00:04:58,1,True,35,23,12,39,10,4
4,00:03:38,1,True,35,23,12,53,10,4
4,00:01:47,1,False,23,38,-15,36,10,4
4,00:01:42,2,False,23,38,-15,35,9,4
1,00:12:56,1,True,0,0,0,51,10,4
1,00:10:56,1,False,0,0,0,14,10,4
1,00:08:41,1,False,0,0,0,51,10,4
1,00:08:15,2,False,0,0,0,50,9,4
1,00:07:11,1,False,0,1,-1,35,10,4
1,00:06:40,2,False,0,1,-1,41,4,4
1,00:05:36,1,True,1,0,1,24,10,4
1,00:02:44,1,True,1,0,1,3,3,4
1,00:01:53,1,False,7,1,6,27,10,4
1,00:00:32,1,False,7,4,3,45,10,4
2,00:14:16,1,True,4,7,-3,1,1,4
2,00:09:20,2,True,4,14,-10,47,4,4
2,00:08:28,2,True,4,14,-10,33,4,4
2,00:06:50,1,True,4,15,-11,49,10,4
2,00:06:10,2,False,15,4,11,53,2,4
2,00:05:25,3,False,15,4,11,52,1,4
2,00:04:35,1,False,15,4,11,46,10,4
2,00:02:05,1,False,15,4,11,21,10,4
3,00:13:20,1,True,7,22,-15,49,10,4
3,00:12:46,2,True,7,22,-15,44,5,4
3,00:11:43,2,True,7,23,-16,35,10,4
3,00:07:40,1,False,23,7,16,24,10,4
3,00:07:13,1,False,23,7,16,13,10,4
3,00:05:55,1,False,23,10,13,36,10,4
3,00:02:59,1,False,23,10,13,43,10,4
3,00:01:10,1,True,10,23,-13,15,10,4
3,00:00:07,3,True,10,23,-13,24,1,4
4,00:15:00,1,True,10,23,-13,24,10,4
4,00:14:30,2,True,10,23,-13,18,4,4
4,00:10:25,1,False,26,10,16,47,10,4
4,00:08:50,1,True,10,26,-16,41,10,4
4,00:07:33,1,False,26,10,16,33,10,4
4,00:07:04,1,False,26,10,16,44,10,4
4,00:03:35,3,False,26,10,16,46,6,4
4,00:03:08,1,False,26,10,16,46,10,4
4,00:01:21,1,False,26,10,16,54,10,4
4,00:01:10,2,False,26,10,16,54,10,4
1,00:10:18,1,False,0,0,0,45,10,4
1,00:06:39,1,True,0,0,0,5,10,4
1,00:05:45,2,True,0,0,0,13,2,4
1,00:05:12,1,True,0,0,0,19,10,4
1,00:04:12,1,True,0,0,0,39,10,4
1,00:03:29,2,True,0,0,0,48,1,4
1,00:02:43,1,True,0,0,0,48,15,4
1,00:00:01,1,False,0,0,0,27,10,4
2,00:14:27,1,False,0,7,-7,47,10,4
2,00:12:55,1,True,7,0,7,33,10,4
2,00:09:59,2,False,0,7,-7,39,4,4
2,00:09:30,3,False,0,7,-7,36,1,4
2,00:08:59,1,False,0,7,-7,35,10,4
2,00:07:31,1,False,0,14,-14,35,10,4
2,00:05:10,1,True,14,1,13,35,10,4
2,00:03:03,1,False,1,14,-13,26,10,4
2,00:02:34,1,False,1,14,-13,46,10,4
2,00:01:55,1,False,1,14,-13,45,10,4
2,00:01:30,1,True,14,1,13,53,10,4
3,00:13:45,1,True,14,2,12,21,10,4
3,00:10:55,1,False,9,14,-5,16,10,4
3,00:08:50,1,True,14,9,5,41,10,4
3,00:08:26,1,True,14,16,-2,34,10,4
3,00:07:10,1,True,14,16,-2,52,10,4
3,00:06:02,1,False,16,14,2,49,10,4
3,00:04:19,1,True,14,16,-2,23,10,4
3,00:03:51,2,True,14,16,-2,26,7,4
3,00:02:57,1,False,16,14,2,45,10,4
3,00:01:32,1,True,14,16,-2,37,10,4
3,00:00:47,2,True,14,16,-2,38,9,4
3,00:00:26,1,False,16,14,2,54,10,4
4,00:14:27,1,False,16,14,2,30,10,4
4,00:14:02,2,False,16,14,2,24,4,4
4,00:09:49,1,True,14,16,-2,25,10,4
4,00:08:14,1,False,16,14,2,50,10,4
4,00:06:01,2,True,14,16,-2,24,10,4
4,00:04:12,2,False,16,14,2,37,2,4
4,00:03:05,1,False,16,14,2,35,15,4
4,00:02:58,2,False,16,14,2,37,13,4
4,00:02:10,1,True,14,16,-2,36,10,4
4,00:02:03,2,True,14,16,-2,40,6,4
4,00:01:44,1,True,14,16,-2,40,10,4
4,00:01:29,2,True,14,16,-2,32,2,4
4,00:01:05,1,True,14,16,-2,30,15,4
1,00:13:50,1,False,0,0,0,47,10,4
1,00:12:44,1,True,0,0,0,36,10,4
1,00:07:42,1,False,0,14,-14,42,5,4
1,00:07:06,2,False,0,14,-14,42,5,4
1,00:04:59,1,True,14,0,14,19,10,4
1,00:03:27,1,False,0,14,-14,31,10,4
1,00:01:09,1,False,0,17,-17,51,10,4
2,00:15:00,1,False,0,18,-18,35,10,4
2,00:14:31,2,False,0,18,-18,42,3,4
2,00:13:17,2,False,0,18,-18,52,4,4
2,00:12:38,1,True,18,0,18,51,10,4
2,00:09:14,1,True,18,3,15,35,10,4
2,00:07:06,1,True,18,3,15,30,10,4
2,00:05:16,2,True,18,10,8,40,7,4
2,00:04:03,1,False,10,18,-8,42,10,4
2,00:03:23,2,False,10,18,-8,40,8,4
2,00:02:19,1,True,21,10,11,46,10,4
2,00:00:53,1,False,10,21,-11,19,10,4
2,00:00:48,2,False,10,21,-11,25,4,4
3,00:12:20,3,False,13,21,-8,45,3,4
3,00:08:21,2,False,13,24,-11,13,1,4
3,00:05:58,1,True,24,13,11,42,10,4
3,00:03:42,1,False,13,24,-11,5,10,4
3,00:02:08,2,False,13,31,-18,42,4,4
3,00:00:09,1,False,13,31,-18,45,10,4
4,00:11:47,1,False,13,34,-21,22,10,4
4,00:08:35,1,True,37,13,24,51,10,4
4,00:07:20,1,False,13,37,-24,45,10,4
4,00:06:03,1,False,13,37,-24,13,10,4
4,00:04:12,1,True,37,13,24,54,10,4
4,00:02:30,1,False,13,37,-24,11,10,4
4,00:02:17,2,False,13,37,-24,17,4,4
4,00:01:43,1,False,13,37,-24,54,10,4
4,00:01:32,2,False,13,37,-24,50,6,4
4,00:00:51,2,False,13,37,-24,26,10,4
4,00:00:45,3,False,13,37,-24,35,1,4
4,00:00:33,1,False,13,37,-24,39,10,4
1,00:14:55,1,True,0,0,0,34,10,4
1,00:12:24,1,False,0,0,0,30,10,4
1,00:10:38,1,False,0,7,-7,51,10,4
1,00:06:47,1,False,0,7,-7,35,10,4
1,00:05:32,1,False,0,7,-7,19,10,4
1,00:01:15,1,False,0,14,-14,1,1,4
1,00:00:30,2,False,0,14,-14,1,1,4
2,00:12:20,1,True,17,0,17,15,5,4
2,00:11:52,1,True,17,0,17,40,10,4
2,00:11:15,2,True,17,0,17,43,7,4
2,00:09:41,1,False,0,17,-17,26,10,4
2,00:06:40,1,False,0,17,-17,42,10,4
2,00:05:37,1,True,17,0,17,16,10,4
2,00:03:53,1,False,0,17,-17,32,10,4
2,00:02:39,2,True,24,0,24,17,1,4
2,00:02:01,1,True,24,7,17,29,10,4
3,00:13:28,1,False,7,24,-17,48,10,4
3,00:12:06,1,False,7,24,-17,22,10,4
3,00:10:55,1,False,7,24,-17,1,1,4
3,00:09:55,2,False,7,31,-24,42,1,4
3,00:09:20,1,False,7,31,-24,46,10,4
3,00:02:07,2,True,38,14,24,22,3,4
3,00:00:38,1,True,38,14,24,8,10,4
4,00:14:13,1,True,38,14,24,43,5,4
4,00:13:40,1,True,38,14,24,48,10,4
4,00:11:42,1,False,14,38,-24,43,10,4
4,00:11:14,1,False,14,38,-24,23,10,4
4,00:09:50,3,False,14,38,-24,14,1,4
4,00:09:14,1,False,14,38,-24,11,10,4
4,00:05:27,1,True,45,14,31,25,10,4
4,00:03:20,1,False,21,45,-24,42,10,4
4,00:02:34,3,False,21,45,-24,34,2,4
4,00:02:10,1,False,21,45,-24,30,10,4
4,00:01:49,2,False,21,45,-24,27,7,4
4,00:00:59,1,False,21,45,-24,27,20,4
1,00:14:57,1,True,0,0,0,41,10,4
1,00:14:18,1,True,0,0,0,51,10,4
1,00:11:31,1,True,1,0,1,52,10,4
1,00:09:59,1,True,1,0,1,33,10,4
1,00:09:59,2,True,1,0,1,25,2,4
1,00:06:25,1,True,1,0,1,15,10,4
1,00:05:26,1,True,1,0,1,34,10,4
1,00:02:49,1,False,0,4,-4,35,10,4
1,00:02:14,2,False,0,4,-4,44,1,4
2,00:14:58,1,False,0,11,-11,44,10,4
2,00:14:19,1,True,11,0,11,54,10,4
2,00:09:13,1,False,0,11,-11,45,10,4
2,00:04:51,2,False,0,11,-11,31,2,4
2,00:04:10,1,False,0,11,-11,37,10,4
2,00:01:50,1,True,11,0,11,2,10,4
2,00:01:40,2,True,11,0,11,10,2,4
2,00:01:23,3,True,11,0,11,11,1,4
2,00:01:11,1,True,11,0,11,13,10,4
2,00:00:49,2,True,11,0,11,15,8,4
3,00:14:20,1,False,0,11,-11,47,10,4
3,00:12:48,1,False,0,11,-11,28,10,4
3,00:11:56,1,False,0,11,-11,18,10,4
3,00:05:51,1,True,14,0,14,40,10,4
3,00:04:30,1,False,0,15,-15,35,10,4
3,00:01:43,1,True,15,0,15,39,10,4
4,00:15:00,1,False,1,15,-14,30,10,4
4,00:14:40,2,False,1,15,-14,20,0,4
4,00:13:36,1,False,1,15,-14,18,10,4
4,00:11:27,1,True,22,1,21,2,10,4
4,00:09:22,2,False,1,22,-21,26,8,4
4,00:08:46,1,False,1,22,-21,21,10,4
4,00:04:42,1,True,29,1,28,47,10,4
4,00:04:10,2,True,29,1,28,55,2,4
4,00:03:28,1,False,1,29,-28,50,10,4
4,00:02:59,2,False,1,29,-28,47,7,4
4,00:01:58,1,False,1,29,-28,46,10,4
4,00:01:54,2,False,1,29,-28,43,7,4
4,00:00:00,1,True,29,1,28,1,1,4
1,00:12:21,2,False,0,7,-7,35,7,4
1,00:09:36,1,True,7,0,7,31,10,4
1,00:08:29,2,True,7,0,7,34,10,4
1,00:06:02,1,True,7,7,0,41,10,4
1,00:05:28,2,True,7,7,0,46,5,4
1,00:02:17,1,False,7,7,0,2,2,4
2,00:14:44,1,True,14,7,7,41,5,4
2,00:12:06,1,True,14,10,4,27,10,4
2,00:04:17,1,True,14,13,1,48,5,4
2,00:03:43,1,False,13,14,-1,51,10,4
2,00:01:51,2,False,13,14,-1,14,2,4
2,00:01:23,1,False,13,14,-1,10,10,4
2,00:00:43,1,False,13,17,-4,35,10,4
2,00:00:38,2,False,13,17,-4,42,3,4
2,00:00:14,3,False,13,17,-4,45,0,4
3,00:14:46,1,False,13,17,-4,36,10,4
3,00:13:21,1,True,17,13,4,33,10,4
3,00:10:56,1,False,13,17,-4,29,10,4
3,00:08:35,1,False,13,17,-4,35,10,4
3,00:06:20,1,False,13,17,-4,25,10,4
3,00:05:01,1,True,17,13,4,46,10,4
3,00:03:15,2,True,17,13,4,36,6,4
4,00:14:57,1,False,20,17,3,46,10,4
4,00:14:35,2,False,20,17,3,55,1,4
4,00:13:32,1,True,17,20,-3,32,10,4
4,00:13:04,2,True,17,20,-3,38,4,4
4,00:12:05,2,False,20,17,3,45,1,4
4,00:10:19,2,True,17,20,-3,37,0,4
4,00:04:36,1,False,27,17,10,46,10,4
4,00:03:00,2,False,27,20,7,41,4,4
4,00:02:05,1,False,27,20,7,40,10,4
4,00:01:08,1,False,27,20,7,33,10,4
4,00:01:04,2,False,27,20,7,37,6,4
1,00:14:51,1,True,0,0,0,40,10,4
1,00:13:54,2,False,0,0,0,47,0,4
1,00:12:36,1,False,0,0,0,32,10,4
1,00:08:01,1,False,0,3,-3,28,5,4
1,00:07:38,1,False,0,3,-3,18,10,4
1,00:05:57,1,False,0,10,-10,11,10,4
1,00:00:29,1,False,0,12,-12,47,10,4
2,00:13:50,1,False,0,12,-12,1,1,4
2,00:13:08,1,False,0,19,-19,46,10,4
2,00:12:35,2,False,0,19,-19,43,7,4
2,00:11:01,1,False,0,19,-19,19,10,4
2,00:09:35,1,True,21,0,21,45,10,4
2,00:08:56,2,True,21,0,21,47,8,4
2,00:06:57,1,True,21,1,20,35,10,4
2,00:03:38,1,False,1,21,-20,14,10,4
2,00:03:10,2,False,1,21,-20,23,1,4
2,00:02:44,3,False,1,21,-20,23,1,4
2,00:01:34,2,False,1,21,-20,13,4,4
3,00:13:16,1,True,24,1,23,31,10,4
3,00:12:07,1,False,1,24,-23,49,10,4
3,00:11:38,2,False,1,24,-23,44,5,4
3,00:10:53,1,False,1,24,-23,30,10,4
3,00:06:19,1,True,31,1,30,2,10,4
3,00:05:45,2,True,31,1,30,5,7,4
3,00:03:12,3,False,3,31,-28,44,1,4
3,00:01:31,1,True,31,3,28,33,10,4
3,00:00:56,1,True,31,3,28,50,10,4
3,00:00:01,2,True,31,3,28,51,9,4
4,00:12:53,1,True,31,3,28,7,10,4
4,00:10:42,2,False,3,31,-28,50,5,4
4,00:09:21,2,True,31,3,28,25,1,4
4,00:06:27,2,True,31,10,21,9,6,4
4,00:03:51,1,True,31,10,21,22,20,4
4,00:01:48,1,True,31,10,21,32,10,4
4,00:01:35,2,True,31,10,21,35,7,4
4,00:00:01,3,True,31,10,21,48,6,4
1,00:12:23,1,True,0,0,0,7,7,4
1,00:11:20,2,True,0,0,0,3,3,4
1,00:10:42,1,True,0,7,-7,19,10,4
1,00:09:15,1,True,0,7,-7,43,10,4
1,00:06:32,1,False,14,0,14,11,10,4
1,00:06:07,2,False,14,0,14,3,2,4
1,00:05:14,1,False,14,0,14,1,1,4
1,00:04:11,2,False,14,0,14,1,1,4
1,00:02:40,1,True,7,14,-7,49,10,4
1,00:00:58,2,True,7,14,-7,25,6,4
2,00:13:39,2,False,21,7,14,51,8,4
2,00:12:33,1,False,21,7,14,45,10,4
2,00:10:50,2,True,7,21,-14,31,1,4
2,00:06:26,1,False,21,7,14,4,4,4
2,00:06:01,1,False,21,14,7,39,10,4
2,00:01:24,1,False,21,14,7,29,10,4
3,00:14:52,1,False,21,17,4,35,10,4
3,00:10:37,1,False,21,20,1,35,10,4
3,00:10:00,1,False,21,20,1,45,10,4
3,00:07:28,1,True,20,21,-1,38,10,4
3,00:06:45,2,True,20,21,-1,30,2,4
3,00:06:02,1,True,20,22,-2,35,10,4
3,00:01:51,2,True,20,22,-2,39,10,4
3,00:00:45,1,True,20,25,-5,35,10,4
4,00:13:39,1,True,20,25,-5,31,10,4
4,00:12:26,1,True,20,25,-5,16,10,4
4,00:10:22,1,False,28,26,2,43,10,4
4,00:08:40,1,True,26,28,-2,22,5,4
4,00:03:21,1,False,28,26,2,8,8,4
4,00:02:33,2,False,28,26,2,3,3,4
4,00:01:55,1,True,33,28,5,30,10,4
4,00:01:43,1,False,28,33,-5,30,10,4
4,00:01:17,2,False,28,33,-5,30,10,4
4,00:00:30,1,False,28,36,-8,35,10,4
1,00:14:53,1,True,0,0,0,29,10,4
1,00:13:19,1,False,0,0,0,35,10,4
1,00:11:10,2,True,0,0,0,26,0,4
1,00:10:33,1,True,0,0,0,27,10,4
1,00:09:55,2,True,0,0,0,35,2,4
1,00:09:28,3,True,0,0,0,37,0,4
1,00:06:00,1,True,7,0,7,39,10,4
1,00:04:25,2,False,0,7,-7,45,1,4
1,00:03:52,3,False,0,7,-7,44,0,4
1,00:02:27,3,False,0,7,-7,34,1,4
1,00:01:33,1,False,0,7,-7,32,10,4
1,00:00:01,1,False,0,14,-14,48,10,4
2,00:13:24,1,False,0,14,-14,25,10,4
2,00:13:08,2,False,0,14,-14,35,0,4
2,00:12:27,1,False,0,14,-14,36,10,4
2,00:11:05,1,False,0,14,-14,54,10,4
2,00:09:24,3,True,14,0,14,18,0,4
2,00:09:09,1,False,0,14,-14,51,10,4
2,00:07:03,1,False,0,14,-14,23,10,4
2,00:04:52,2,False,0,14,-14,43,10,4
2,00:03:07,1,False,0,17,-17,35,10,4
2,00:01:58,1,True,17,0,17,28,10,4
2,00:00:28,1,False,0,17,-17,29,10,4
2,00:00:07,1,False,0,20,-20,37,10,4
2,00:00:01,2,False,0,20,-20,44,3,4
3,00:14:45,1,False,0,20,-20,37,10,4
3,00:14:14,2,False,0,20,-20,42,5,4
3,00:13:31,1,True,20,0,20,29,10,4
3,00:13:10,2,True,20,0,20,36,3,4
3,00:10:23,1,True,20,0,20,16,10,4
3,00:08:45,2,True,20,3,17,23,10,4
3,00:06:51,3,True,20,3,17,50,2,4
3,00:05:40,1,False,3,20,-17,45,10,4
3,00:05:04,2,False,3,20,-17,43,8,4
3,00:04:30,3,False,3,20,-17,36,1,4
3,00:03:26,2,False,3,20,-17,42,3,4
3,00:00:53,2,True,20,3,17,48,10,4
4,00:14:18,1,True,20,3,17,14,10,4
4,00:13:20,1,True,20,3,17,44,10,4
4,00:12:34,1,False,3,20,-17,49,10,4
4,00:09:34,1,False,3,21,-18,35,10,4
4,00:09:11,2,False,3,21,-18,41,4,4
4,00:06:51,1,True,21,3,18,19,10,4
4,00:06:25,2,True,21,3,18,23,6,4
4,00:05:36,1,True,21,3,18,44,10,4
4,00:04:04,1,False,3,21,-18,44,10,4
4,00:01:20,1,False,9,24,-15,51,10,4
4,00:01:15,2,False,9,24,-15,44,3,4
4,00:00:50,3,False,9,24,-15,41,0,4
1,00:14:53,1,False,0,0,0,28,10,4
1,00:13:02,1,True,0,0,0,40,10,4
1,00:10:08,1,False,0,0,0,14,10,4
1,00:08:53,1,False,0,0,0,2,2,4
1,00:07:31,1,False,0,7,-7,29,10,4
1,00:03:38,2,True,7,0,7,7,1,4
1,00:02:17,2,True,7,0,7,2,2,4
1,00:00:29,1,True,7,7,0,45,10,4
2,00:14:41,1,False,7,7,0,16,10,4
2,00:12:57,2,False,7,7,0,43,1,4
2,00:10:01,2,False,7,7,0,10,0,4
2,00:09:27,1,False,7,7,0,8,8,4
2,00:05:03,1,True,10,7,3,50,10,4
2,00:03:47,1,True,10,7,3,17,10,4
2,00:02:57,2,True,10,7,3,12,5,4
3,00:11:46,1,True,10,10,0,7,7,4
3,00:11:20,1,True,10,17,-7,24,10,4
3,00:10:30,2,True,10,17,-7,32,2,4
3,00:09:32,1,False,17,10,7,51,10,4
3,00:06:01,1,True,13,17,-4,17,10,4
3,00:04:13,1,False,17,13,4,19,10,4
3,00:03:38,2,False,17,13,4,23,6,4
3,00:01:57,1,True,13,17,-4,24,10,4
4,00:13:48,2,True,13,17,-4,48,1,4
4,00:06:06,2,False,24,22,2,32,13,4
4,00:05:48,3,False,24,22,2,44,1,4
4,00:02:33,1,False,24,22,2,38,10,4
4,00:01:12,2,False,24,25,-1,11,4,4
1,00:12:18,1,True,0,0,0,51,10,4
1,00:11:52,2,False,0,0,0,54,5,4
1,00:09:44,2,False,0,0,0,1,1,4
1,00:09:23,1,False,0,7,-7,31,10,4
1,00:07:39,1,True,7,0,7,40,10,4
1,00:05:34,1,True,7,0,7,15,10,4
1,00:04:26,1,False,0,7,-7,55,10,4
1,00:04:01,2,True,7,0,7,52,7,4
1,00:01:19,1,True,7,0,7,44,10,4
2,00:14:34,1,False,0,10,-10,35,10,4
2,00:13:35,1,False,0,10,-10,49,10,4
2,00:10:36,2,False,0,17,-17,37,0,4
2,00:07:27,1,False,0,17,-17,38,10,4
2,00:05:01,1,True,17,1,16,35,10,4
2,00:04:27,2,True,17,1,16,43,2,4
2,00:03:50,1,True,17,1,16,50,10,4
2,00:02:17,1,False,1,17,-16,18,10,4
2,00:01:08,1,True,17,1,16,20,10,4
3,00:14:55,1,False,1,17,-16,36,10,4
3,00:11:39,1,True,17,1,16,51,10,4
3,00:06:55,1,False,1,24,-23,46,10,4
3,00:05:23,1,False,1,25,-24,35,10,4
3,00:00:39,1,False,15,25,-10,40,10,4
3,00:00:06,2,False,15,25,-10,31,1,4
4,00:14:40,1,False,15,28,-13,35,10,4
4,00:11:42,1,False,15,28,-13,49,10,4
4,00:11:15,1,False,15,28,-13,36,10,4
4,00:10:40,2,False,15,28,-13,32,6,4
4,00:09:23,2,False,15,28,-13,13,3,4
4,00:06:16,1,False,15,34,-19,42,10,4
4,00:04:27,2,False,15,34,-19,17,4,4
4,00:02:15,1,False,15,48,-33,24,10,4
4,00:02:07,1,False,15,48,-33,36,10,4
4,00:00:16,1,True,48,15,33,39,10,4
1,00:14:45,1,True,0,0,0,41,10,4
1,00:14:12,2,True,0,0,0,31,0,4
1,00:10:50,2,True,0,3,-3,53,2,4
1,00:10:18,1,False,3,0,3,50,10,4
1,00:09:25,1,False,3,7,-4,41,10,4
1,00:06:04,1,True,7,3,4,1,1,4
1,00:05:39,1,True,7,10,-3,32,10,4
1,00:05:05,2,True,7,10,-3,40,2,4
1,00:02:00,1,True,7,10,-3,42,10,4
2,00:14:37,1,False,10,10,0,35,10,4
2,00:09:41,2,True,10,10,0,26,0,4
2,00:07:52,1,False,10,10,0,10,10,4
2,00:05:14,3,False,10,10,0,31,1,4
2,00:03:04,2,False,16,10,6,47,3,4
2,00:02:37,1,False,16,10,6,40,10,4
2,00:02:24,2,False,16,10,6,32,2,4
3,00:13:35,1,True,13,19,-6,45,10,4
3,00:12:46,2,True,13,19,-6,55,0,4
3,00:10:47,1,False,19,20,-1,47,10,4
3,00:09:14,1,True,20,19,1,30,10,4
3,00:07:04,1,True,20,19,1,25,10,4
3,00:05:42,1,True,20,22,-2,33,10,4
3,00:02:01,1,False,22,23,-1,22,10,4
4,00:14:37,1,False,22,23,-1,35,10,4
4,00:13:57,2,False,22,23,-1,27,2,4
4,00:12:00,1,False,22,23,-1,10,10,4
4,00:09:30,1,True,30,22,8,22,10,4
4,00:08:12,1,True,30,28,2,25,10,4
4,00:05:42,1,True,30,28,2,26,10,4
4,00:04:21,1,True,30,28,2,50,10,4
4,00:02:59,1,False,28,30,-2,15,10,4
4,00:02:14,2,False,28,33,-5,35,10,4
1,00:14:55,1,False,0,0,0,18,10,4
1,00:12:45,2,True,0,0,0,40,10,4
1,00:11:05,1,True,0,0,0,29,10,4
1,00:06:48,2,True,0,0,0,16,4,4
1,00:06:05,1,True,0,0,0,21,10,4
1,00:04:50,1,True,0,0,0,40,10,4
1,00:03:10,2,True,0,0,0,50,10,4
2,00:15:00,1,True,1,0,1,29,10,4
2,00:13:38,1,False,0,1,-1,44,10,4
2,00:09:26,1,True,1,0,1,51,10,4
2,00:07:23,1,False,0,1,-1,45,10,4
2,00:06:58,1,True,1,7,-6,25,10,4
2,00:06:21,2,True,1,7,-6,32,3,4
2,00:04:17,1,False,7,1,6,12,10,4
2,00:03:21,1,False,7,1,6,32,10,4
2,00:02:27,2,False,7,1,6,47,10,4
2,00:02:02,2,True,1,7,-6,25,7,4
3,00:11:30,1,True,10,7,3,38,10,4
3,00:11:05,2,True,10,7,3,45,3,4
3,00:09:55,1,True,10,7,3,53,5,4
3,00:07:56,1,False,7,11,-4,35,10,4
3,00:06:54,1,False,7,11,-4,45,10,4
3,00:05:10,1,True,11,7,4,3,10,4
3,00:03:13,1,True,11,7,4,27,10,4
3,00:00:16,2,False,8,11,-3,40,1,4
4,00:15:00,1,False,8,11,-3,34,10,4
4,00:13:19,2,False,8,18,-10,23,2,4
4,00:12:38,3,False,8,18,-10,25,0,4
4,00:12:04,1,False,8,18,-10,25,10,4
4,00:11:35,1,False,8,18,-10,14,10,4
4,00:03:45,1,True,25,11,14,20,10,4
4,00:03:01,1,True,25,11,14,44,10,4
4,00:02:07,1,True,27,11,16,35,10,4
4,00:00:48,2,True,27,11,16,44,4,4
1,00:14:33,1,False,0,0,0,45,10,4
1,00:07:38,2,False,3,3,0,33,2,4
1,00:07:16,3,False,3,3,0,32,1,4
1,00:05:53,1,False,3,3,0,15,10,4
1,00:03:32,1,True,6,3,3,37,10,4
1,00:01:56,1,False,3,6,-3,14,10,4
1,00:00:57,1,False,3,6,-3,46,10,4
2,00:14:49,1,True,6,10,-4,34,10,4
2,00:14:07,2,True,6,10,-4,41,3,4
2,00:08:58,2,True,6,17,-11,43,2,4
2,00:08:12,1,True,6,17,-11,48,10,4
2,00:07:36,2,True,6,17,-11,52,6,4
2,00:06:36,1,False,17,6,11,16,10,4
2,00:05:03,1,False,17,6,11,27,10,4
2,00:04:54,2,False,17,6,11,35,2,4
2,00:03:30,1,False,17,6,11,48,10,4
2,00:00:40,2,False,17,9,8,35,10,4
2,00:00:25,1,False,17,9,8,51,10,4
2,00:00:11,1,True,9,17,-8,39,10,4
3,00:14:53,1,False,17,9,8,23,10,4
3,00:12:33,1,True,9,17,-8,28,10,4
3,00:10:02,2,False,24,9,15,45,2,4
3,00:07:34,2,False,24,12,12,44,1,4
3,00:06:58,3,False,24,12,12,45,0,4
3,00:02:51,1,False,31,15,16,35,10,4
4,00:14:42,1,False,31,15,16,48,10,4
4,00:13:30,2,True,15,31,-16,54,2,4
4,00:12:34,1,True,15,31,-16,34,10,4
4,00:10:59,1,True,15,31,-16,10,10,4
4,00:08:37,2,False,34,15,19,49,1,4
4,00:07:01,1,True,15,34,-19,40,10,4
4,00:05:42,1,True,15,34,-19,18,10,4
4,00:03:09,2,False,34,15,19,53,3,4
4,00:02:19,1,False,34,15,19,53,10,4
4,00:02:06,2,False,34,15,19,55,8,4
4,00:01:02,0,False,34,15,19,42,0,4
1,00:14:18,1,False,0,0,0,52,10,4
1,00:13:13,1,True,0,1,-1,35,10,4
1,00:12:18,1,True,0,1,-1,45,10,4
1,00:11:27,2,True,0,1,-1,52,3,4
1,00:11:07,3,True,0,1,-1,54,1,4
1,00:08:59,2,False,1,0,1,18,2,4
1,00:07:58,1,False,1,0,1,37,10,4
1,00:05:21,1,True,0,1,-1,35,10,4
1,00:04:18,2,True,0,1,-1,12,3,4
1,00:02:19,1,True,0,4,-4,35,10,4
1,00:01:51,1,True,0,4,-4,46,10,4
1,00:00:24,1,False,4,0,4,52,10,4
1,00:00:01,1,True,0,11,-11,27,10,4
2,00:13:56,1,True,0,11,-11,52,10,4
2,00:13:18,2,False,11,0,11,50,2,4
2,00:10:50,1,False,11,3,8,35,10,4
2,00:09:44,1,True,3,11,-8,38,10,4
2,00:08:50,1,False,11,3,8,43,10,4
2,00:05:46,1,False,11,6,5,40,10,4
2,00:03:44,1,False,11,6,5,28,10,4
2,00:02:23,1,False,11,13,-2,30,10,4
2,00:01:10,2,True,13,11,2,51,10,4
2,00:00:38,1,True,13,11,2,17,10,4
3,00:14:52,1,False,14,13,1,45,10,4
3,00:13:45,1,True,13,14,-1,49,10,4
3,00:13:37,2,True,13,14,-1,41,2,4
3,00:13:09,1,True,13,14,-1,39,10,4
3,00:11:46,1,True,13,14,-1,16,10,4
3,00:10:43,1,False,14,13,1,40,10,4
3,00:09:28,1,False,14,13,1,52,10,4
3,00:07:59,1,True,13,14,-1,12,10,4
3,00:07:24,2,True,13,14,-1,9,13,4
3,00:05:47,1,False,14,13,1,55,10,4
3,00:02:49,1,False,16,13,3,52,10,4
3,00:01:52,2,True,13,16,-3,49,1,4
3,00:01:11,1,True,13,16,-3,28,10,4
4,00:14:37,1,True,13,16,-3,50,10,4
4,00:13:33,1,True,13,16,-3,39,10,4
4,00:12:51,2,True,13,16,-3,31,2,4
4,00:09:57,1,False,19,13,6,46,10,4
4,00:08:57,1,True,13,19,-6,37,10,4
4,00:06:43,1,True,13,19,-6,18,10,4
4,00:02:33,1,True,13,26,-13,41,10,4
4,00:02:13,2,True,13,26,-13,37,6,4
4,00:01:54,3,True,13,26,-13,33,2,4
4,00:01:32,1,False,26,13,13,52,10,4
4,00:01:13,2,False,26,13,13,51,11,4
1,00:14:54,1,True,0,0,0,9,10,4
1,00:13:20,2,False,0,0,0,45,10,4
1,00:12:22,3,False,0,0,0,55,0,4
1,00:11:44,1,True,0,0,0,54,10,4
1,00:11:06,2,True,0,0,0,52,8,4
1,00:08:13,1,True,0,7,-7,28,10,4
1,00:07:04,1,True,0,7,-7,50,10,4
1,00:03:53,1,True,0,7,-7,44,10,4
1,00:02:45,1,False,7,0,7,30,10,4
1,00:01:29,1,True,0,7,-7,42,10,4
2,00:15:00,1,False,7,0,7,21,10,4
2,00:13:59,1,False,7,0,7,40,10,4
2,00:12:00,2,True,0,7,-7,39,2,4
2,00:10:15,2,True,0,7,-7,19,10,4
2,00:06:00,2,False,10,0,10,45,10,4
2,00:02:46,1,True,0,13,-13,35,10,4
2,00:02:37,2,True,0,13,-13,42,3,4
2,00:01:01,2,False,13,3,10,35,10,4
3,00:14:55,1,False,13,3,10,23,10,4
3,00:12:32,1,True,3,13,-10,43,10,4
3,00:10:17,2,False,13,3,10,54,1,4
3,00:07:24,2,True,3,13,-10,15,0,4
3,00:06:06,2,True,3,13,-10,25,1,4
3,00:05:39,1,True,3,13,-10,26,10,4
3,00:04:40,1,True,3,13,-10,55,10,4
3,00:03:43,1,False,13,3,10,39,10,4
3,00:02:54,1,False,13,3,10,18,10,4
4,00:15:00,1,False,13,3,10,40,10,4
4,00:14:35,2,False,13,3,10,43,7,4
4,00:13:42,3,False,13,3,10,48,2,4
4,00:12:57,1,False,13,3,10,51,10,4
4,00:12:21,1,True,3,13,-10,45,10,4
4,00:11:38,1,True,3,13,-10,24,10,4
4,00:11:01,2,True,3,13,-10,16,2,4
4,00:09:43,1,True,3,20,-17,7,10,4
4,00:08:19,1,True,3,20,-17,41,10,4
4,00:07:54,1,True,3,20,-17,27,10,4
4,00:06:56,1,True,3,23,-20,35,10,4
4,00:05:37,1,False,23,3,20,40,10,4
4,00:04:10,1,True,3,23,-20,27,10,4
4,00:02:07,1,False,26,3,23,23,10,4
4,00:02:02,2,False,26,3,23,30,3,4
4,00:01:39,1,False,26,3,23,34,10,4
4,00:01:17,1,False,26,3,23,46,10,4
1,00:12:30,3,True,0,0,0,51,1,4
1,00:11:46,1,True,0,0,0,49,10,4
1,00:11:15,2,True,0,0,0,40,1,4
1,00:09:36,1,True,0,3,-3,33,10,4
1,00:08:06,1,False,3,0,3,7,10,4
1,00:07:05,1,False,3,0,3,51,10,4
1,00:05:20,1,False,3,0,3,21,10,4
1,00:04:12,1,False,3,3,0,31,10,4
1,00:02:42,2,True,3,3,0,48,10,4
1,00:01:33,1,False,3,3,0,35,10,4
2,00:15:00,2,True,3,3,0,51,6,4
2,00:12:30,3,True,3,4,-1,35,10,4
2,00:12:10,1,False,4,3,1,41,10,4
2,00:03:55,1,False,7,6,1,30,10,4
2,00:03:10,2,False,7,6,1,36,4,4
2,00:02:36,1,True,6,7,-1,21,10,4
2,00:02:16,1,True,6,7,-1,49,10,4
2,00:01:48,2,False,7,6,1,52,2,4
2,00:01:31,3,False,7,6,1,51,0,4
3,00:13:47,2,True,9,7,2,30,25,4
3,00:10:11,2,False,7,9,-2,35,1,4
3,00:08:45,1,True,9,7,2,35,10,4
3,00:01:21,1,False,7,12,-5,51,10,4
4,00:13:53,1,True,12,14,-2,28,10,4
4,00:11:38,1,False,14,12,2,41,10,4
4,00:06:39,1,False,14,12,2,47,10,4
4,00:05:07,1,False,14,15,-1,35,10,4
4,00:04:28,2,False,14,15,-1,35,10,4
4,00:03:53,3,False,14,15,-1,45,0,4
4,00:02:22,1,True,15,14,1,39,10,4
4,00:01:26,2,True,15,17,-2,40,5,4
4,00:01:00,1,False,17,15,2,21,10,4
4,00:00:37,2,False,17,15,2,21,10,4
1,00:14:58,1,True,0,1,-1,35,10,4
1,00:11:14,1,True,0,1,-1,28,10,4
1,00:09:39,1,True,0,1,-1,49,10,4
1,00:08:16,2,True,0,1,-1,15,10,4
1,00:07:13,1,True,0,1,-1,50,10,4
1,00:03:35,1,True,0,1,-1,34,10,4
1,00:00:55,1,True,0,4,-4,47,10,4
2,00:13:08,1,True,0,4,-4,25,10,4
2,00:12:55,2,True,0,4,-4,34,1,4
2,00:08:01,1,False,4,0,4,26,10,4
2,00:07:48,1,False,4,7,-3,28,10,4
2,00:06:29,1,False,4,7,-3,41,10,4
2,00:05:56,1,True,7,4,3,36,5,4
2,00:05:20,2,True,7,4,3,32,1,4
2,00:03:35,1,True,7,4,3,35,10,4
2,00:03:00,2,True,7,4,3,43,2,4
2,00:02:39,3,True,7,4,3,45,0,4
2,00:01:51,1,False,4,7,-3,13,10,4
2,00:01:46,2,False,4,7,-3,20,3,4
2,00:00:48,1,False,4,7,-3,5,10,4
2,00:00:40,2,False,4,7,-3,4,11,4
3,00:13:10,1,False,4,7,-3,52,10,4
3,00:11:20,1,True,7,4,3,41,10,4
3,00:08:09,1,False,4,7,-3,26,5,4
3,00:07:23,2,False,4,7,-3,28,3,4
3,00:06:24,1,True,7,4,3,5,10,4
3,00:02:05,1,False,7,7,0,54,10,4
3,00:01:05,3,True,7,7,0,46,0,4
3,00:00:29,1,True,7,7,0,44,10,4
4,00:10:54,1,True,7,7,0,20,10,4
4,00:10:20,2,True,7,7,0,30,0,4
4,00:05:41,2,True,10,7,3,35,0,4
4,00:04:25,2,True,10,7,3,25,1,4
4,00:01:54,2,True,10,7,3,35,5,4
4,00:00:58,1,False,7,10,-3,49,10,4
4,00:00:54,2,False,7,10,-3,45,6,4
1,00:11:30,1,False,3,0,3,32,10,4
1,00:10:03,1,False,3,3,0,36,10,4
1,00:09:24,2,False,3,3,0,41,5,4
1,00:05:44,1,True,3,10,-7,23,10,4
1,00:04:20,1,False,10,3,7,35,10,4
1,00:03:50,2,False,10,3,7,37,8,4
1,00:01:50,1,True,3,10,-7,32,10,4
1,00:01:15,1,True,3,10,-7,52,10,4
1,00:00:49,2,False,10,3,7,53,5,4
2,00:14:37,1,False,10,3,7,1,1,4
2,00:14:23,1,False,10,10,0,20,10,4
2,00:10:17,1,False,10,10,0,31,10,4
2,00:09:15,2,False,10,10,0,50,3,4
2,00:06:07,1,True,10,10,0,30,10,4
2,00:05:05,1,True,10,10,0,45,10,4
2,00:04:33,2,True,10,10,0,40,5,4
2,00:02:28,1,False,13,10,3,47,10,4
2,00:01:41,1,False,13,10,3,36,10,4
2,00:01:10,1,False,13,13,0,35,10,4
2,00:00:29,2,True,13,13,0,6,10,4
2,00:00:26,3,True,13,13,0,6,10,4
3,00:14:53,1,True,13,20,-7,33,10,4
3,00:13:31,1,False,20,13,7,25,10,4
3,00:12:06,0,False,20,13,7,40,0,4
3,00:09:44,2,False,20,13,7,30,3,4
3,00:09:08,3,False,20,13,7,32,1,4
3,00:07:59,1,False,20,20,0,19,15,4
3,00:07:04,1,True,20,20,0,24,10,4
3,00:05:00,1,True,20,20,0,44,10,4
3,00:03:08,2,True,20,20,0,19,2,4
3,00:01:15,1,True,20,23,-3,35,10,4
3,00:00:20,1,True,20,23,-3,52,10,4
3,00:00:01,2,True,20,23,-3,55,7,4
4,00:14:46,1,False,23,20,3,25,10,4
4,00:13:20,1,False,23,20,3,47,10,4
4,00:12:51,2,False,23,20,3,54,3,4
4,00:08:13,1,True,20,26,-6,45,10,4
4,00:07:32,2,False,26,20,6,54,10,4
4,00:06:31,1,False,26,20,6,20,10,4
4,00:06:03,2,False,26,20,6,29,1,4
4,00:02:56,1,False,26,20,6,25,10,4
4,00:01:05,2,False,26,20,6,18,12,4
1,00:14:50,1,False,0,0,0,40,10,4
1,00:13:26,1,True,0,0,0,17,15,4
1,00:12:05,1,True,0,0,0,38,10,4
1,00:10:35,1,True,0,0,0,46,10,4
1,00:09:41,1,True,0,0,0,16,10,4
1,00:08:26,1,True,0,3,-3,25,10,4
1,00:07:57,2,True,0,3,-3,34,1,4
1,00:06:53,1,False,3,0,3,39,10,4
1,00:06:13,2,False,3,0,3,47,2,4
1,00:05:34,1,False,3,0,3,51,10,4
1,00:04:53,2,True,0,3,-3,50,1,4
1,00:03:43,1,True,0,3,-3,28,10,4
1,00:03:04,2,True,0,3,-3,21,3,4
1,00:00:12,1,False,6,0,6,51,10,4
2,00:14:15,1,True,0,6,-6,32,10,4
2,00:13:39,2,True,0,6,-6,41,1,4
2,00:11:17,2,True,0,6,-6,27,10,4
2,00:09:34,1,True,0,9,-9,38,10,4
2,00:08:56,1,True,0,9,-9,49,10,4
2,00:08:06,1,False,9,0,9,33,10,4
2,00:06:02,1,False,9,0,9,18,10,4
2,00:04:42,1,False,9,0,9,6,6,4
2,00:02:13,2,True,3,9,-6,24,1,4
2,00:01:59,3,True,3,9,-6,23,0,4
2,00:01:07,1,True,3,9,-6,52,10,4
2,00:00:46,0,True,3,9,-6,49,0,4
3,00:14:11,1,True,6,9,-3,47,10,4
3,00:10:44,1,True,6,9,-3,42,10,4
3,00:09:21,1,True,6,12,-6,35,10,4
3,00:06:04,1,True,6,20,-14,35,10,4
3,00:05:26,2,True,6,20,-14,43,2,4
3,00:04:35,3,True,6,20,-14,44,1,4
3,00:02:31,2,True,6,20,-14,46,0,4
3,00:00:37,1,True,6,23,-17,35,10,4
3,00:00:25,1,True,6,23,-17,47,10,4
4,00:14:34,1,False,23,6,17,34,10,4
4,00:13:25,1,False,23,6,17,49,10,4
4,00:06:48,1,True,6,23,-17,45,10,4
4,00:04:30,1,False,23,6,17,21,10,4
4,00:03:48,2,False,23,6,17,19,12,4
4,00:03:06,1,False,23,6,17,34,10,4
4,00:02:15,1,False,23,6,17,48,10,4
1,00:13:38,1,False,0,7,-7,14,10,4
1,00:12:00,2,True,7,0,7,52,1,4
1,00:10:21,1,True,7,0,7,38,10,4
1,00:06:40,2,True,7,7,0,29,10,4
1,00:05:29,1,False,7,7,0,47,10,4
1,00:05:04,1,False,7,14,-7,39,10,4
1,00:03:53,1,True,14,7,7,9,10,4
1,00:02:24,2,True,14,7,7,49,2,4
1,00:01:32,3,True,14,7,7,47,0,4
1,00:01:06,1,True,14,7,7,46,10,4
1,00:00:44,2,True,14,7,7,36,0,4
1,00:00:01,2,True,14,7,7,29,4,4
2,00:15:00,3,True,14,7,7,25,0,4
2,00:12:26,1,True,14,14,0,30,10,4
2,00:08:52,1,True,14,14,0,23,10,4
2,00:07:51,1,True,14,14,0,3,3,4
2,00:06:26,1,True,14,17,-3,30,15,4
2,00:05:37,1,True,14,17,-3,47,10,4
2,00:04:12,3,True,14,17,-3,55,2,4
2,00:03:41,1,False,17,14,3,53,10,4
2,00:02:46,1,False,17,14,3,24,10,4
2,00:02:28,1,False,17,14,3,5,5,4
3,00:14:08,1,False,17,20,-3,50,10,4
3,00:11:37,1,False,17,20,-3,45,10,4
3,00:06:09,1,False,20,23,-3,35,10,4
3,00:04:59,1,True,23,20,3,22,10,4
3,00:04:20,2,True,23,20,3,24,8,4
3,00:02:54,1,False,20,23,-3,28,10,4
4,00:10:19,1,True,23,23,0,35,10,4
4,00:10:00,2,True,23,23,0,41,4,4
4,00:09:18,1,False,23,23,0,28,10,4
4,00:09:04,1,False,23,23,0,38,10,4
4,00:06:10,1,False,23,23,0,1,1,4
4,00:05:16,2,False,23,23,0,1,1,4
4,00:03:59,1,False,23,30,-7,47,10,4
4,00:02:24,1,False,23,30,-7,42,10,4
4,00:02:19,2,False,23,30,-7,35,3,4
4,00:02:07,1,False,23,30,-7,28,10,4
4,00:01:43,2,False,23,30,-7,25,7,4
1,00:14:51,1,False,0,0,0,42,10,4
1,00:13:49,1,False,0,0,0,23,10,4
1,00:13:34,2,False,0,0,0,16,3,4
1,00:12:36,1,False,0,0,0,10,10,4
1,00:11:21,1,False,0,7,-7,27,10,4
1,00:10:35,2,False,0,7,-7,20,3,4
1,00:08:23,1,True,14,0,14,42,10,4
1,00:07:23,1,True,14,0,14,40,10,4
1,00:06:33,2,True,14,0,14,18,2,4
1,00:06:03,1,True,14,0,14,11,10,4
1,00:04:40,1,True,14,3,11,35,10,4
1,00:01:40,1,True,14,6,8,35,10,4
2,00:14:15,1,True,14,6,8,32,10,4
2,00:06:26,2,False,6,14,-8,38,3,4
2,00:03:37,1,False,6,14,-8,3,3,4
2,00:01:39,1,False,6,21,-15,2,2,4
2,00:01:15,2,False,6,28,-22,53,0,4
2,00:00:41,2,False,6,28,-22,41,10,4
3,00:14:51,1,True,28,6,22,36,10,4
3,00:13:30,1,False,6,28,-22,20,10,4
3,00:12:59,2,False,6,28,-22,29,1,4
3,00:12:10,3,False,6,28,-22,29,1,4
3,00:11:40,1,False,6,28,-22,31,10,4
3,00:09:27,2,False,6,28,-22,31,1,4
3,00:08:22,1,False,6,31,-25,35,10,4
3,00:07:28,2,True,31,6,25,51,3,4
3,00:05:06,1,True,31,6,25,35,10,4
3,00:04:28,2,True,31,6,25,27,2,4
3,00:01:53,1,True,31,9,22,35,10,4
4,00:14:14,1,False,9,31,-22,46,10,4
4,00:13:49,1,False,9,31,-22,35,10,4
4,00:11:57,1,False,9,34,-25,37,10,4
4,00:09:49,1,True,34,9,25,32,10,4
4,00:09:32,1,False,9,34,-25,40,10,4
4,00:06:55,1,True,37,9,28,30,10,4
4,00:05:29,1,False,9,37,-28,39,10,4
4,00:03:36,2,True,37,9,28,35,10,4
4,00:01:54,1,True,37,9,28,24,10,4
1,00:12:50,1,True,0,0,0,26,10,4
1,00:11:36,2,True,0,0,0,10,4,4
1,00:09:10,2,False,3,0,3,35,3,4
1,00:08:30,1,False,3,0,3,51,10,4
1,00:05:05,1,True,0,3,-3,24,10,4
1,00:02:46,2,True,0,6,-6,38,7,4
1,00:01:41,1,False,6,0,6,18,10,4
1,00:00:20,1,False,6,0,6,44,10,4
2,00:13:01,1,False,6,6,0,52,10,4
2,00:09:07,1,False,6,6,0,16,10,4
2,00:07:39,1,True,6,6,0,51,10,4
2,00:02:58,2,True,6,6,0,24,1,4
2,00:01:47,1,True,6,6,0,3,3,4
2,00:01:33,2,True,6,13,-7,25,2,4
2,00:00:25,2,True,6,13,-7,45,4,4
3,00:13:53,1,True,6,13,-7,34,10,4
3,00:12:22,1,True,6,13,-7,16,10,4
3,00:09:42,1,True,6,20,-14,48,10,4
3,00:08:00,1,False,20,13,7,16,10,4
3,00:07:28,1,False,20,13,7,31,10,4
3,00:01:10,2,False,20,13,7,47,1,4
3,00:00:02,2,False,20,13,7,9,5,4
4,00:14:48,1,False,20,13,7,2,2,4
4,00:12:15,1,False,20,27,-7,33,10,4
4,00:07:23,1,True,29,20,9,42,10,4
4,00:05:18,1,True,29,20,9,43,10,4
4,00:02:47,2,False,20,29,-9,15,5,4
4,00:02:20,1,True,29,20,9,45,10,4
4,00:01:32,1,False,20,29,-9,30,10,4
4,00:00:16,1,True,29,20,9,2,2,4
1,00:14:42,1,True,0,0,0,37,10,4
1,00:13:56,1,False,0,0,0,53,10,4
1,00:13:17,2,False,0,0,0,46,3,4
1,00:12:06,2,False,0,1,-1,35,10,4
1,00:10:09,2,False,0,1,-1,51,2,4
1,00:08:53,2,False,0,1,-1,41,2,4
1,00:08:15,1,False,0,1,-1,37,10,4
1,00:05:39,1,True,4,0,4,28,10,4
1,00:01:24,2,True,4,0,4,28,1,4
1,00:00:36,2,True,4,0,4,27,10,4
2,00:14:45,1,True,4,3,1,51,10,4
2,00:10:26,1,True,5,3,2,45,10,4
2,00:09:06,1,False,3,5,-2,20,10,4
2,00:07:02,1,True,5,3,2,46,10,4
2,00:03:53,2,True,5,3,2,34,10,4
2,00:03:11,3,True,5,3,2,43,1,4
2,00:00:37,1,True,5,10,-5,28,10,4
2,00:00:30,2,True,5,10,-5,36,2,4
3,00:13:44,2,True,5,10,-5,37,5,4
3,00:13:06,1,True,5,10,-5,29,10,4
3,00:11:00,1,False,17,5,12,46,10,4
3,00:10:01,1,False,17,5,12,11,10,4
3,00:09:32,2,False,17,5,12,15,6,4
3,00:09:04,1,False,17,5,12,22,10,4
3,00:07:59,1,True,5,17,-12,52,10,4
3,00:04:24,1,False,17,5,12,51,10,4
3,00:02:07,1,True,5,17,-12,25,10,4
3,00:00:10,1,False,17,5,12,47,10,4
4,00:11:03,1,True,5,19,-14,9,10,4
4,00:09:55,1,False,21,5,16,40,10,4
4,00:08:53,1,True,5,21,-16,51,10,4
4,00:05:51,1,False,21,5,16,22,10,4
4,00:05:08,2,False,21,5,16,27,5,4
4,00:02:37,1,True,5,21,-16,43,10,4
4,00:02:33,2,True,5,21,-16,42,9,4
4,00:00:56,1,True,5,31,-26,45,10,4
4,00:00:47,2,True,5,31,-26,42,7,4
4,00:00:28,3,True,5,31,-26,37,2,4
1,00:14:30,2,True,0,0,0,27,10,4
1,00:12:58,1,False,0,0,0,45,10,4
1,00:08:07,1,True,0,10,-10,35,10,4
1,00:07:12,1,True,0,10,-10,45,10,4
1,00:04:45,2,True,0,10,-10,1,1,4
1,00:04:08,1,True,0,17,-17,43,10,4
1,00:01:52,1,True,0,17,-17,1,1,4
2,00:13:57,2,False,24,0,24,34,1,4
2,00:13:01,2,False,24,0,24,45,1,4
2,00:12:26,1,False,24,0,24,51,10,4
2,00:09:59,1,True,0,24,-24,50,10,4
2,00:09:41,1,False,24,0,24,40,10,4
2,00:07:12,2,True,0,32,-32,39,6,4
2,00:06:27,1,True,0,32,-32,46,10,4
2,00:04:27,1,False,32,7,25,46,10,4
2,00:00:59,2,True,7,32,-25,15,2,4
3,00:14:34,2,True,7,32,-25,38,2,4
3,00:13:53,1,False,32,7,25,15,10,4
3,00:12:40,1,False,32,7,25,55,10,4
3,00:10:50,2,True,7,32,-25,24,12,4
3,00:09:56,1,False,32,7,25,33,10,4
3,00:09:21,1,True,7,32,-25,54,10,4
3,00:08:29,1,True,7,32,-25,16,10,4
3,00:05:58,1,True,7,35,-28,49,10,4
3,00:02:08,1,True,7,35,-28,54,10,4
3,00:01:35,2,False,35,7,28,52,6,4
3,00:00:54,3,False,35,7,28,51,5,4
4,00:14:21,1,False,35,7,28,31,10,4
4,00:13:54,2,False,35,7,28,40,1,4
4,00:09:00,1,True,7,35,-28,28,10,4
4,00:05:44,1,False,38,14,24,45,10,4
4,00:04:42,2,False,38,14,24,33,22,4
4,00:03:15,2,True,14,38,-24,46,1,4
4,00:02:47,1,False,38,14,24,13,10,4
4,00:02:42,2,False,38,14,24,17,6,4
4,00:02:17,1,False,38,14,24,25,10,4
4,00:00:43,1,False,38,14,24,38,10,4
4,00:00:26,2,False,38,14,24,42,6,4
1,00:14:54,1,True,0,0,0,40,10,4
1,00:13:37,1,True,0,0,0,50,10,4
1,00:11:20,1,False,0,0,0,53,10,4
1,00:06:58,2,True,0,3,-3,37,3,4
1,00:05:57,1,False,3,0,3,6,25,4
1,00:03:48,1,False,3,0,3,39,10,4
1,00:00:53,2,False,3,3,0,35,10,4
2,00:14:15,1,False,3,3,0,52,10,4
2,00:12:58,1,False,3,3,0,49,10,4
2,00:10:39,2,True,3,3,0,40,10,4
2,00:10:02,1,True,3,3,0,54,10,4
2,00:07:58,1,False,3,3,0,30,10,4
2,00:06:49,3,False,3,3,0,20,0,4
2,00:05:27,1,False,3,3,0,7,7,4
2,00:05:07,1,False,3,10,-7,45,10,4
2,00:04:02,1,True,10,3,7,43,10,4
2,00:02:34,1,True,10,3,7,8,10,4
2,00:01:37,1,True,10,3,7,45,15,4
2,00:00:37,1,False,3,10,-7,23,10,4
3,00:14:53,1,False,3,10,-7,31,10,4
3,00:11:59,3,True,10,3,7,39,0,4
3,00:11:25,1,True,10,3,7,42,10,4
3,00:05:42,1,False,3,10,-7,17,10,4
3,00:04:53,2,False,3,10,-7,25,2,4
3,00:02:50,1,True,10,3,7,27,10,4
3,00:01:42,1,True,10,10,0,24,10,4
3,00:01:03,2,True,10,10,0,18,4,4
3,00:00:22,1,True,10,10,0,10,10,4
4,00:12:46,1,False,13,11,2,20,10,4
4,00:12:17,2,False,13,11,2,21,9,4
4,00:11:04,1,False,13,11,2,44,10,4
4,00:10:32,2,False,13,11,2,53,1,4
4,00:09:54,1,False,13,11,2,55,10,4
4,00:09:23,2,True,11,13,-2,45,0,4
4,00:08:45,1,True,11,13,-2,39,10,4
4,00:08:02,2,True,11,13,-2,34,5,4
4,00:04:54,1,False,16,17,-1,33,10,4
4,00:04:20,2,False,16,17,-1,41,2,4
4,00:03:50,1,False,16,17,-1,50,10,4
4,00:02:44,1,True,17,16,1,19,10,4
4,00:01:53,1,True,17,22,-5,52,10,4
4,00:01:46,2,True,17,22,-5,47,5,4
4,00:01:20,1,True,17,22,-5,27,10,4
4,00:00:57,2,True,17,22,-5,22,5,4
1,00:13:35,1,False,0,0,0,51,10,4
1,00:12:57,2,False,0,0,0,55,6,4
1,00:11:55,1,True,0,7,-7,35,10,4
1,00:08:40,2,False,7,1,6,42,3,4
1,00:07:35,1,True,1,7,-6,20,10,4
1,00:04:14,1,True,1,10,-9,53,10,4
1,00:02:10,1,False,10,2,8,23,10,4
1,00:00:35,1,False,10,5,5,29,10,4
2,00:13:16,1,False,10,5,5,13,10,4
2,00:11:16,1,False,10,8,2,35,10,4
2,00:10:08,1,False,10,8,2,52,10,4
2,00:09:02,1,True,8,17,-9,34,10,4
2,00:07:48,1,True,8,20,-12,35,10,4
2,00:06:27,1,False,20,8,12,16,10,4
2,00:05:53,2,False,20,8,12,22,4,4
2,00:05:14,1,False,20,8,12,34,10,4
2,00:02:32,0,False,27,8,19,28,0,4
2,00:01:49,1,False,27,8,19,48,10,4
3,00:14:52,1,False,30,8,22,20,10,4
3,00:14:17,2,False,30,8,22,29,1,4
3,00:13:38,1,False,30,8,22,35,10,4
3,00:10:48,1,True,8,30,-22,48,10,4
3,00:10:15,2,True,8,30,-22,55,3,4
3,00:08:56,2,False,30,8,22,40,4,4
3,00:08:13,3,False,30,8,22,38,2,4
3,00:04:57,1,False,30,11,19,50,10,4
3,00:03:04,2,True,11,30,-19,25,2,4
3,00:01:14,3,True,11,30,-19,39,1,4
4,00:15:00,1,True,11,30,-19,52,10,4
4,00:14:34,1,False,30,11,19,47,10,4
4,00:13:52,2,False,30,11,19,40,3,4
4,00:13:18,3,False,30,11,19,39,2,4
4,00:11:33,1,False,30,14,16,35,10,4
4,00:11:04,2,False,30,14,16,32,13,4
4,00:07:51,1,False,30,14,16,33,10,4
4,00:07:12,2,False,30,14,16,37,6,4
4,00:06:18,2,False,30,14,16,49,10,4
4,00:03:02,2,False,30,17,13,43,2,4
4,00:01:50,1,True,17,30,-13,40,10,4
1,00:14:04,1,False,0,0,0,47,10,4
1,00:12:45,1,False,0,0,0,20,10,4
1,00:09:45,1,False,0,3,-3,52,10,4
1,00:09:14,2,False,0,3,-3,50,8,4
1,00:06:54,1,False,0,10,-10,35,10,4
1,00:06:06,2,True,10,0,10,7,5,4
1,00:05:12,1,False,3,10,-7,47,10,4
1,00:04:34,2,False,3,10,-7,45,12,4
1,00:02:44,1,True,10,3,7,42,10,4
1,00:00:00,1,False,3,10,-7,19,10,4
2,00:13:22,1,True,17,3,14,7,7,4
2,00:11:58,1,True,17,6,11,39,10,4
2,00:10:00,1,False,6,17,-11,55,10,4
2,00:06:45,1,True,17,13,4,24,10,4
2,00:05:51,1,True,17,13,4,38,10,4
2,00:01:35,1,True,17,16,1,27,10,4
3,00:12:07,2,False,19,17,2,55,3,4
3,00:11:19,1,False,19,17,2,45,10,4
3,00:05:02,1,False,19,20,-1,4,4,4
3,00:02:51,2,True,27,19,8,20,0,4
3,00:01:47,1,True,27,19,8,1,1,4
3,00:01:29,1,True,27,26,1,33,10,4
4,00:15:00,1,False,26,27,-1,44,10,4
4,00:12:48,1,True,27,26,1,32,10,4
4,00:06:00,1,False,29,30,-1,52,10,4
4,00:05:01,1,False,29,30,-1,50,10,4
4,00:01:56,1,True,33,29,4,38,10,4
4,00:01:31,1,True,33,29,4,48,10,4
4,00:01:01,1,False,29,33,-4,49,10,4
4,00:00:56,1,False,29,33,-4,38,10,4
4,00:00:50,2,False,29,33,-4,34,6,4
1,00:14:56,1,False,0,0,0,34,10,4
1,00:13:34,1,True,0,0,0,33,10,4
1,00:09:17,2,False,0,0,0,19,1,4
1,00:07:07,3,False,0,0,0,8,2,4
1,00:06:47,1,False,0,7,-7,19,10,4
1,00:02:14,1,True,7,0,7,35,10,4
1,00:01:33,2,True,7,0,7,43,2,4
2,00:13:09,1,False,0,7,-7,29,10,4
2,00:11:14,2,False,0,14,-14,33,1,4
2,00:10:36,1,False,0,14,-14,34,10,4
2,00:09:45,2,False,0,14,-14,43,1,4
2,00:09:08,1,False,0,14,-14,45,10,4
2,00:05:07,1,False,0,14,-14,32,10,4
2,00:03:48,1,False,0,14,-14,17,10,4
2,00:01:36,1,True,21,0,21,1,1,4
2,00:00:35,2,False,7,28,-21,30,15,4
3,00:14:49,1,True,28,7,21,37,10,4
3,00:13:42,1,True,28,7,21,50,10,4
3,00:10:06,1,False,7,28,-21,3,3,4
3,00:08:33,1,False,7,31,-24,51,10,4
3,00:06:33,2,True,31,7,24,38,3,4
3,00:03:01,1,False,14,31,-17,38,10,4
3,00:00:06,1,True,32,14,18,31,10,4
4,00:14:03,1,True,32,17,15,35,10,4
4,00:11:29,1,False,17,32,-15,42,10,4
4,00:08:42,2,False,17,35,-18,39,6,4
4,00:06:42,2,False,17,35,-18,24,5,4
4,00:05:37,2,False,17,38,-21,45,0,4
4,00:02:15,2,True,38,17,21,22,4,4
4,00:02:11,1,True,38,17,21,29,10,4
4,00:01:18,1,True,38,17,21,48,10,4
4,00:00:54,2,True,38,17,21,53,5,4
1,00:14:24,1,True,0,0,0,20,15,4
1,00:13:09,1,True,0,0,0,37,10,4
1,00:10:28,1,True,0,0,0,49,10,4
1,00:06:08,1,False,7,0,7,48,5,4
1,00:05:24,1,False,7,0,7,54,10,4
1,00:03:48,1,True,0,7,-7,20,10,4
1,00:03:23,2,True,0,7,-7,27,3,4
2,00:15:00,2,True,0,7,-7,35,1,4
2,00:14:30,1,True,0,7,-7,41,10,4
2,00:13:37,2,False,7,0,7,33,0,4
2,00:11:54,1,False,7,0,7,19,10,4
2,00:11:29,1,False,7,7,0,30,10,4
2,00:07:41,1,True,7,7,0,20,10,4
2,00:07:20,2,True,7,7,0,29,1,4
2,00:04:57,1,True,7,7,0,27,10,4
2,00:03:11,1,False,14,7,7,46,10,4
3,00:14:45,1,False,14,21,-7,16,10,4
3,00:09:58,2,True,21,14,7,17,7,4
3,00:09:31,3,True,21,14,7,11,1,4
3,00:08:28,1,True,21,14,7,8,8,4
3,00:04:07,3,True,21,21,0,49,1,4
3,00:02:58,1,False,21,21,0,48,10,4
3,00:00:02,1,False,21,21,0,25,10,4
4,00:15:00,2,False,21,21,0,16,1,4
4,00:11:35,1,False,21,28,-7,50,10,4
4,00:11:04,1,False,21,28,-7,31,10,4
4,00:09:46,1,False,21,28,-7,14,10,4
4,00:06:05,1,True,31,21,10,45,10,4
4,00:05:35,1,False,21,31,-10,47,10,4
4,00:04:53,2,False,21,31,-10,40,3,4
4,00:04:09,1,False,21,31,-10,33,10,4
4,00:01:47,2,True,38,21,17,41,16,4
4,00:01:19,1,True,38,21,17,34,10,4
4,00:01:13,2,True,38,21,17,39,5,4
1,00:14:53,1,True,0,0,0,40,10,4
1,00:11:11,1,False,0,1,-1,35,10,4
1,00:09:25,1,True,1,0,1,12,10,4
1,00:08:04,1,False,0,1,-1,31,10,4
1,00:06:57,1,True,1,0,1,51,10,4
1,00:04:07,1,False,0,1,-1,22,10,4
1,00:01:49,1,False,0,4,-4,35,10,4
1,00:01:07,2,False,0,4,-4,41,4,4
1,00:00:22,1,True,4,0,4,54,10,4
2,00:13:53,1,False,1,4,-3,20,10,4
2,00:11:30,1,True,7,1,6,45,10,4
2,00:08:47,1,False,4,7,-3,40,10,4
2,00:07:45,2,False,4,7,-3,47,17,4
2,00:06:56,1,False,4,8,-4,35,10,4
2,00:06:37,1,False,4,8,-4,48,10,4
2,00:05:08,1,True,8,4,4,21,10,4
2,00:03:45,1,True,8,4,4,37,10,4
2,00:02:39,1,False,4,8,-4,8,10,4
2,00:00:58,1,False,4,8,-4,32,10,4
2,00:00:38,1,True,8,4,4,48,10,4
3,00:12:44,1,True,8,4,4,31,10,4
3,00:10:59,2,True,8,4,4,11,2,4
3,00:09:20,1,True,8,4,4,27,10,4
3,00:05:25,2,True,8,4,4,35,5,4
3,00:03:35,1,True,8,7,1,35,10,4
3,00:02:24,1,False,7,8,-1,32,10,4
3,00:01:19,1,False,7,8,-1,45,10,4
4,00:15:00,1,True,8,7,1,51,10,4
4,00:14:25,2,False,7,8,-1,52,4,4
4,00:11:26,1,True,8,7,1,37,10,4
4,00:10:43,2,True,8,7,1,31,4,4
4,00:09:57,1,True,8,7,1,21,10,4
4,00:09:16,2,True,8,7,1,21,10,4
4,00:08:32,3,True,8,7,1,12,1,4
4,00:07:12,2,True,8,7,1,19,2,4
4,00:06:46,1,True,8,7,1,24,10,4
4,00:02:37,1,False,7,8,-1,42,10,4
4,00:02:26,1,False,7,8,-1,55,10,4
4,00:01:07,2,True,8,7,1,32,1,4
4,00:01:03,1,True,8,7,1,26,10,4
4,00:00:41,2,True,8,7,1,24,8,4
1,00:11:24,1,False,0,0,0,28,10,4
1,00:10:44,2,False,0,0,0,33,5,4
1,00:09:36,1,True,0,0,0,49,5,4
1,00:08:30,1,True,0,0,0,30,10,4
1,00:06:59,2,True,0,0,0,14,10,4
1,00:06:38,1,True,0,7,-7,30,10,4
1,00:04:19,1,True,7,7,0,46,10,4
1,00:01:25,1,True,7,10,-3,37,10,4
1,00:00:17,1,True,7,10,-3,49,10,4
2,00:14:29,1,True,7,10,-3,7,10,4
2,00:13:49,2,True,7,10,-3,16,1,4
2,00:11:35,1,False,10,7,3,30,10,4
2,00:10:50,1,False,10,7,3,52,10,4
2,00:08:47,1,True,7,10,-3,43,10,4
2,00:08:19,2,True,7,10,-3,52,1,4
2,00:06:20,3,False,10,7,3,48,2,4
2,00:01:34,3,False,17,7,10,40,0,4
2,00:00:43,1,True,7,17,-10,26,10,4
3,00:14:52,1,False,17,7,10,37,10,4
3,00:11:08,2,True,7,17,-10,33,1,4
3,00:10:31,1,True,7,17,-10,37,10,4
3,00:08:46,1,False,17,7,10,44,10,4
3,00:05:37,1,True,7,20,-13,46,10,4
3,00:05:03,1,False,20,7,13,50,10,4
3,00:00:28,1,False,20,10,10,33,10,4
4,00:14:24,1,True,17,20,-3,50,10,4
4,00:12:36,1,True,17,20,-3,11,10,4
4,00:10:54,2,True,17,20,-3,36,11,4
4,00:09:07,1,False,23,17,6,40,10,4
4,00:07:44,3,False,23,17,6,31,1,4
4,00:05:42,1,False,23,20,3,39,10,4
4,00:05:08,2,False,23,20,3,49,0,4
4,00:03:47,1,True,20,23,-3,49,10,4
4,00:03:07,2,True,20,23,-3,45,6,4
4,00:02:26,2,True,20,23,-3,19,1,4
4,00:01:49,1,True,20,23,-3,30,10,4
4,00:01:42,2,True,20,23,-3,24,4,4
4,00:01:19,1,True,20,23,-3,12,10,4
4,00:00:33,3,True,20,23,-3,2,0,4
1,00:13:20,1,False,0,0,0,46,10,4
1,00:11:42,2,True,0,0,0,40,3,4
1,00:09:26,1,True,0,0,0,18,10,4
1,00:08:12,1,False,0,0,0,40,10,4
1,00:07:52,2,False,0,0,0,48,2,4
1,00:06:22,1,True,0,0,0,40,10,4
1,00:01:51,1,False,0,1,-1,35,10,4
1,00:00:58,3,False,0,1,-1,44,1,4
1,00:00:01,1,False,0,1,-1,51,10,4
2,00:15:00,2,True,1,0,1,53,4,4
2,00:14:15,1,True,1,1,0,35,10,4
2,00:12:37,2,False,1,1,0,52,2,4
2,00:09:25,1,False,1,4,-3,38,10,4
2,00:08:53,2,False,1,4,-3,45,3,4
2,00:07:48,2,False,1,4,-3,51,10,4
2,00:07:05,1,True,4,1,3,42,10,4
2,00:04:10,2,True,4,4,0,41,17,4
2,00:01:39,2,True,4,4,0,38,2,4
2,00:00:28,3,False,4,4,0,43,1,4
3,00:13:23,1,False,4,4,0,46,10,4
3,00:12:02,1,False,4,5,-1,35,10,4
3,00:11:00,1,False,4,5,-1,50,10,4
3,00:09:15,1,True,5,4,1,24,10,4
3,00:08:31,1,True,5,4,1,41,10,4
3,00:07:27,1,True,5,4,1,52,10,4
3,00:06:53,2,False,4,5,-1,52,4,4
3,00:06:02,1,False,4,5,-1,30,10,4
3,00:05:33,2,False,4,5,-1,38,2,4
3,00:02:16,1,False,4,5,-1,22,10,4
3,00:00:45,1,True,5,4,1,48,10,4
4,00:13:35,1,True,12,4,8,48,10,4
4,00:12:31,1,True,12,4,8,6,10,4
4,00:12:02,1,True,12,4,8,31,10,4
4,00:10:15,2,True,12,4,8,49,2,4
4,00:09:22,2,True,12,4,8,55,10,4
4,00:07:10,1,False,4,12,-8,34,10,4
4,00:06:03,3,False,4,12,-8,25,1,4
4,00:03:06,1,True,12,11,1,41,10,4
4,00:01:40,1,False,11,13,-2,45,10,4
4,00:01:09,2,False,11,13,-2,50,15,4
4,00:01:01,1,False,11,13,-2,33,10,4
4,00:00:39,2,False,11,13,-2,25,2,4
1,00:13:41,1,True,0,0,0,14,10,4
1,00:12:32,0,False,0,0,0,30,0,4
1,00:11:09,3,True,0,0,0,39,1,4
1,00:09:24,1,True,0,0,0,8,8,4
1,00:08:31,2,True,0,0,0,3,3,4
1,00:06:41,1,False,7,0,7,55,10,4
1,00:06:19,1,True,0,7,-7,38,10,4
1,00:03:20,1,True,0,10,-10,54,10,4
1,00:00:30,1,False,10,0,10,37,10,4
2,00:15:00,1,True,0,10,-10,48,10,4
2,00:13:46,1,False,10,0,10,36,10,4
2,00:12:43,1,False,10,0,10,24,10,4
2,00:11:00,1,False,10,3,7,35,10,4
2,00:06:00,3,False,10,6,4,39,1,4
2,00:03:17,1,False,10,6,4,32,10,4
2,00:02:45,1,True,6,10,-4,52,10,4
2,00:02:05,1,True,6,13,-7,35,10,4
3,00:14:54,1,True,9,13,-4,53,10,4
3,00:13:42,1,False,13,9,4,16,10,4
3,00:12:58,2,False,13,9,4,21,5,4
3,00:11:41,1,False,13,9,4,55,10,4
3,00:10:04,1,True,9,13,-4,15,10,4
3,00:08:28,2,True,9,13,-4,37,1,4
3,00:07:18,1,False,13,9,4,26,10,4
3,00:07:02,2,False,13,9,4,33,3,4
3,00:05:30,1,True,9,13,-4,51,10,4
3,00:00:34,1,False,13,10,3,38,10,4
4,00:14:22,1,False,13,17,-4,42,10,4
4,00:12:09,1,True,17,16,1,35,10,4
4,00:11:53,2,True,17,16,1,42,3,4
4,00:10:40,1,True,17,16,1,22,10,4
4,00:08:07,1,False,19,17,2,43,10,4
4,00:07:40,1,False,19,17,2,53,10,4
4,00:04:44,1,False,26,17,9,16,10,4
4,00:04:21,1,False,26,17,9,35,10,4
4,00:03:10,1,False,26,17,9,47,10,4
4,00:01:50,1,True,17,33,-16,5,10,4
4,00:01:08,1,True,17,33,-16,22,10,4
4,00:01:03,2,True,17,33,-16,19,7,4
4,00:00:56,1,True,17,33,-16,9,9,4
4,00:00:32,2,True,17,33,-16,5,5,4
1,00:14:55,1,True,0,0,0,31,10,4
1,00:10:58,1,False,0,0,0,43,10,4
1,00:09:03,1,False,0,0,0,45,10,4
1,00:07:42,1,False,0,1,-1,35,10,4
1,00:06:25,3,False,0,1,-1,44,1,4
1,00:02:30,1,True,1,0,1,50,10,4
2,00:15:00,1,False,0,1,-1,44,10,4
2,00:14:09,1,False,0,1,-1,41,10,4
2,00:13:43,2,False,0,1,-1,43,8,4
2,00:13:05,3,False,0,1,-1,50,1,4
2,00:11:54,2,True,1,0,1,51,3,4
2,00:10:30,0,False,0,1,-1,12,0,4
2,00:09:25,1,True,1,0,1,48,10,4
2,00:07:52,2,True,1,0,1,23,4,4
2,00:05:47,1,True,1,3,-2,36,10,4
2,00:05:07,2,True,1,3,-2,39,7,4
2,00:04:29,1,True,1,3,-2,40,10,4
2,00:03:36,2,True,1,3,-2,20,18,4
2,00:02:45,2,True,1,3,-2,34,1,4
2,00:02:38,1,True,1,3,-2,36,10,4
2,00:00:09,2,True,1,3,-2,12,10,4
3,00:13:36,1,False,6,8,-2,35,10,4
3,00:13:00,2,False,6,8,-2,36,9,4
3,00:08:32,1,False,6,8,-2,54,10,4
3,00:07:52,2,True,8,6,2,49,3,4
3,00:07:04,3,True,8,6,2,47,1,4
3,00:06:32,1,True,8,6,2,47,10,4
3,00:05:57,2,True,8,6,2,55,2,4
3,00:03:44,2,True,8,6,2,22,3,4
3,00:02:30,1,True,8,6,2,5,5,4
3,00:01:32,1,True,8,6,2,1,1,4
3,00:00:28,2,True,8,13,-5,43,1,4
4,00:15:00,1,False,13,8,5,42,10,4
4,00:12:15,1,True,11,13,-2,46,10,4
4,00:10:52,1,False,13,11,2,16,10,4
4,00:08:37,1,True,14,13,1,51,10,4
4,00:06:35,2,True,14,13,1,22,2,4
4,00:05:57,1,True,14,13,1,19,10,4
4,00:05:15,2,True,14,13,1,14,5,4
4,00:02:37,1,False,16,14,2,38,10,4
4,00:02:08,1,False,16,14,2,26,10,4
4,00:01:44,1,False,16,21,-5,8,8,4
4,00:01:39,2,False,16,21,-5,14,14,4
1,00:10:54,1,False,0,0,0,55,10,4
1,00:08:59,1,True,0,0,0,26,10,4
1,00:07:53,1,True,0,0,0,40,10,4
1,00:06:34,1,True,0,0,0,41,10,4
1,00:05:23,1,True,0,0,0,31,10,4
1,00:04:11,1,True,0,0,0,19,10,4
1,00:01:30,1,True,0,7,-7,49,5,4
1,00:01:15,1,False,7,7,0,25,10,4
2,00:13:42,2,False,7,7,0,18,10,4
2,00:13:00,1,False,7,7,0,33,10,4
2,00:09:15,1,False,7,14,-7,52,10,4
2,00:09:05,2,False,7,14,-7,43,1,4
2,00:07:44,1,False,7,17,-10,35,10,4
2,00:05:18,2,False,7,24,-17,26,12,4
2,00:04:29,1,True,24,7,17,24,10,4
2,00:02:16,1,False,7,24,-17,54,10,4
2,00:01:59,2,False,7,24,-17,34,10,4
2,00:01:38,2,False,7,24,-17,28,4,4
2,00:01:03,1,False,7,24,-17,5,5,4
2,00:00:43,0,False,7,31,-24,52,0,4
2,00:00:18,1,True,31,7,24,31,10,4
3,00:14:54,1,True,31,10,21,26,10,4
3,00:14:12,1,True,31,10,21,37,10,4
3,00:09:34,1,False,13,31,-18,52,10,4
3,00:07:17,1,True,31,16,15,35,10,4
3,00:06:02,1,False,16,31,-15,53,10,4
3,00:05:24,2,True,31,16,15,49,2,4
3,00:04:12,1,True,31,16,15,15,10,4
3,00:03:04,1,True,31,23,8,26,10,4
3,00:01:02,2,True,31,23,8,50,3,4
4,00:14:20,2,False,23,31,-8,40,1,4
4,00:14:02,3,False,23,31,-8,41,0,4
4,00:13:33,1,False,23,31,-8,43,10,4
4,00:12:53,2,False,23,31,-8,48,5,4
4,00:10:41,1,False,24,31,-7,30,10,4
4,00:10:24,1,False,24,31,-7,20,10,4
4,00:05:42,1,True,34,24,10,38,10,4
4,00:03:02,1,False,24,34,-10,24,10,4
4,00:01:44,1,True,34,27,7,35,10,4
4,00:01:17,1,False,27,34,-7,50,10,4
1,00:14:50,1,False,0,0,0,26,10,4
1,00:13:03,1,False,0,7,-7,29,10,4
1,00:08:05,1,True,7,0,7,52,10,4
1,00:07:09,1,True,7,0,7,39,10,4
1,00:06:35,2,True,7,0,7,31,2,4
1,00:05:29,1,True,7,0,7,37,20,4
1,00:05:04,2,True,7,0,7,27,10,4
1,00:04:33,1,True,7,0,7,15,10,4
1,00:03:05,3,True,7,0,7,7,2,4
1,00:00:19,1,True,7,7,0,40,10,4
2,00:13:18,1,True,7,8,-1,35,10,4
2,00:12:03,1,False,8,7,1,9,10,4
2,00:10:32,1,False,8,7,1,31,10,4
2,00:08:51,1,True,7,8,-1,31,10,4
2,00:07:31,1,True,7,8,-1,55,10,4
2,00:06:52,2,False,8,7,1,50,5,4
2,00:06:11,1,False,8,7,1,40,10,4
2,00:03:25,1,False,8,7,1,19,10,4
2,00:02:11,0,False,8,7,1,53,0,4
2,00:01:20,2,False,8,7,1,34,1,4
2,00:00:38,1,True,7,8,-1,25,10,4
2,00:00:33,2,True,7,8,-1,28,7,4
3,00:14:54,1,True,7,8,-1,31,10,4
3,00:14:32,1,True,7,8,-1,46,10,4
3,00:13:22,1,False,8,7,1,52,10,4
3,00:11:48,1,False,8,7,1,20,10,4
3,00:11:27,2,False,8,7,1,28,2,4
3,00:10:08,1,True,7,8,-1,19,10,4
3,00:05:11,1,True,7,8,-1,45,10,4
3,00:04:57,1,True,7,8,-1,26,10,4
3,00:02:11,1,False,11,7,4,32,10,4
3,00:00:42,1,True,7,11,-4,37,10,4
4,00:15:00,1,True,7,11,-4,55,10,4
4,00:13:20,1,True,7,11,-4,45,10,4
4,00:12:44,2,True,7,11,-4,42,7,4
4,00:10:16,2,True,7,11,-4,13,1,4
4,00:08:42,1,True,7,11,-4,34,10,4
4,00:08:04,2,True,7,11,-4,25,1,4
4,00:06:25,1,True,7,11,-4,20,10,4
4,00:02:10,1,True,7,25,-18,15,10,4
4,00:01:51,3,True,7,32,-25,45,0,4
1,00:14:15,1,False,0,0,0,39,10,4
1,00:12:27,1,False,0,3,-3,34,10,4
1,00:09:48,2,False,0,10,-10,46,1,4
1,00:08:36,2,False,0,10,-10,55,5,4
1,00:05:20,1,True,10,0,10,52,10,4
1,00:04:14,1,False,0,10,-10,43,10,4
1,00:01:46,1,True,10,0,10,54,10,4
1,00:01:11,2,True,10,0,10,45,1,4
1,00:00:38,1,True,10,0,10,40,10,4
2,00:13:14,1,False,3,10,-7,44,10,4
2,00:12:21,1,True,10,3,7,51,10,4
2,00:11:05,1,True,10,3,7,12,10,4
2,00:10:30,1,True,10,3,7,24,10,4
2,00:08:42,1,True,10,3,7,48,10,4
2,00:05:35,1,False,3,13,-10,35,10,4
2,00:04:10,1,True,13,3,10,23,10,4
2,00:03:09,1,True,13,3,10,8,8,4
2,00:02:24,1,True,13,6,7,45,10,4
2,00:01:42,1,False,6,13,-7,13,10,4
2,00:01:36,2,False,6,13,-7,16,7,4
3,00:12:16,1,False,9,16,-7,35,10,4
3,00:11:45,2,False,9,16,-7,42,3,4
3,00:10:27,1,True,16,9,7,39,10,4
3,00:09:16,1,True,16,12,4,35,10,4
3,00:06:50,1,True,16,12,4,34,10,4
3,00:05:05,1,False,12,16,-4,20,10,4
3,00:03:55,1,False,12,16,-4,36,10,4
3,00:02:27,3,False,12,16,-4,45,1,4
3,00:01:48,1,True,16,12,4,53,10,4
3,00:01:10,2,True,16,12,4,45,2,4
4,00:12:26,2,False,19,16,3,53,4,4
4,00:11:20,1,True,16,19,-3,16,10,4
4,00:10:54,2,True,16,19,-3,22,4,4
4,00:08:43,1,True,16,19,-3,31,10,4
4,00:06:02,1,False,19,16,3,48,10,4
4,00:04:40,1,False,19,16,3,16,10,4
4,00:03:37,1,False,19,16,3,49,10,4
4,00:03:00,1,True,16,19,-3,51,10,4
4,00:01:36,1,False,20,16,4,27,10,4
4,00:01:31,2,False,20,16,4,31,6,4
4,00:01:06,1,False,20,16,4,42,10,4
4,00:00:44,2,False,20,16,4,50,2,4
1,00:14:53,1,False,0,0,0,39,10,4
1,00:14:14,2,False,0,0,0,49,0,4
1,00:11:37,1,True,0,3,-3,33,10,4
1,00:10:20,1,True,0,3,-3,50,10,4
1,00:08:49,2,False,3,0,3,25,10,4
1,00:07:55,1,True,0,3,-3,35,10,4
1,00:07:22,2,True,0,3,-3,41,4,4
1,00:05:24,2,False,3,0,3,28,2,4
1,00:04:46,1,False,3,0,3,6,6,4
1,00:02:44,1,False,3,0,3,1,1,4
1,00:01:29,1,False,3,7,-4,30,10,4
1,00:00:06,1,True,7,3,4,46,10,4
2,00:15:00,2,True,7,3,4,52,4,4
2,00:10:44,1,True,8,3,5,50,10,4
2,00:09:21,1,False,3,8,-5,41,10,4
2,00:08:36,2,False,3,8,-5,32,1,4
2,00:07:31,1,False,3,8,-5,8,10,4
2,00:06:00,1,False,3,8,-5,19,10,4
2,00:02:47,1,True,8,3,5,46,10,4
2,00:02:07,1,False,3,8,-5,25,10,4
2,00:01:56,1,False,3,8,-5,7,7,4
2,00:00:44,1,False,3,8,-5,37,10,4
3,00:14:45,1,True,8,3,5,20,10,4
3,00:13:10,2,True,8,3,5,50,10,4
3,00:12:03,1,False,3,9,-6,35,10,4
3,00:10:56,1,True,9,3,6,30,10,4
3,00:08:26,1,False,3,9,-6,32,10,4
3,00:06:53,1,True,9,3,6,32,10,4
3,00:06:19,2,True,9,3,6,38,4,4
3,00:05:45,1,True,9,3,6,43,10,4
3,00:02:00,1,False,3,12,-9,49,10,4
4,00:15:00,1,True,13,3,10,43,10,4
4,00:10:34,1,True,13,3,10,52,10,4
4,00:07:32,1,True,13,3,10,44,10,4
4,00:04:06,2,True,20,10,10,53,1,4
4,00:02:32,1,True,20,10,10,27,10,4
4,00:02:28,2,True,20,10,10,32,5,4
4,00:02:04,2,False,10,20,-10,45,1,4
4,00:01:35,1,True,20,10,10,38,10,4
4,00:01:30,2,True,20,10,10,30,2,4
4,00:01:24,3,True,20,10,10,29,1,4
4,00:01:19,1,True,20,10,10,14,25,4
4,00:01:14,2,True,20,10,10,15,24,4
1,00:12:39,1,True,0,0,0,46,10,4
1,00:11:48,1,True,0,0,0,27,10,4
1,00:09:25,1,True,0,0,0,31,10,4
1,00:07:53,1,True,0,0,0,6,10,4
1,00:07:00,1,True,0,7,-7,41,10,4
1,00:04:08,1,True,0,7,-7,18,10,4
1,00:02:15,2,True,0,7,-7,37,3,4
1,00:00:01,1,False,7,0,7,45,10,4
2,00:10:32,1,True,2,7,-5,45,10,4
2,00:09:06,1,False,7,2,5,3,10,4
2,00:06:31,1,False,7,4,3,5,5,4
2,00:06:12,1,False,7,11,-4,15,10,4
2,00:05:00,1,False,7,11,-4,25,10,4
2,00:02:32,3,False,7,11,-4,43,0,4
2,00:02:28,1,False,7,11,-4,41,10,4
2,00:00:33,2,False,7,14,-7,38,17,4
3,00:14:28,1,False,7,14,-7,50,10,4
3,00:12:52,2,False,7,14,-7,34,1,4
3,00:12:02,1,False,7,14,-7,15,10,4
3,00:10:37,3,False,7,14,-7,6,1,4
3,00:09:50,1,False,7,14,-7,5,5,4
3,00:08:35,2,False,7,14,-7,3,3,4
3,00:08:15,1,False,7,21,-14,51,10,4
3,00:04:38,2,True,21,7,14,11,8,4
3,00:02:32,1,True,21,21,0,35,10,4
3,00:00:53,1,False,21,21,0,41,10,4
3,00:00:01,2,False,21,21,0,49,2,4
4,00:15:00,3,False,21,21,0,50,1,4
4,00:14:30,1,False,21,21,0,52,10,4
4,00:13:09,1,True,21,21,0,22,10,4
4,00:11:26,1,True,21,24,-3,35,10,4
4,00:11:04,2,True,21,24,-3,42,3,4
4,00:08:56,1,True,21,24,-3,44,10,4
4,00:07:41,1,True,21,27,-6,40,10,4
4,00:07:15,2,True,21,27,-6,48,2,4
4,00:05:14,1,False,27,28,-1,27,10,4
4,00:04:19,1,True,28,27,1,43,10,4
4,00:03:50,2,True,28,27,1,38,5,4
4,00:02:44,2,True,28,30,-2,35,10,4
4,00:02:35,3,True,28,30,-2,45,0,4
4,00:02:09,1,False,30,28,2,51,10,4
4,00:01:47,2,False,30,28,2,42,1,4
4,00:01:43,1,False,30,28,2,39,10,4
4,00:01:13,1,False,30,28,2,23,10,4
4,00:00:28,2,False,30,28,2,15,2,4
1,00:14:50,1,False,0,0,0,26,10,4
1,00:13:28,1,False,0,3,-3,30,10,4
1,00:11:17,2,True,3,1,2,45,0,4
1,00:10:39,1,True,3,1,2,46,10,4
1,00:08:55,1,False,1,3,-2,11,10,4
1,00:06:21,1,True,10,1,9,2,10,4
1,00:05:45,2,True,10,1,9,8,4,4
1,00:00:24,1,True,10,3,7,1,10,4
1,00:00:10,2,True,10,3,7,3,8,4
2,00:15:00,1,True,10,3,7,11,10,4
2,00:14:03,1,True,10,3,7,29,10,4
2,00:12:28,1,False,3,10,-7,48,10,4
2,00:10:24,2,True,10,3,7,47,1,4
2,00:08:05,1,False,3,10,-7,15,10,4
2,00:04:30,2,False,3,10,-7,18,1,4
2,00:00:58,1,True,13,3,10,36,10,4
2,00:00:17,1,True,13,10,3,34,10,4
3,00:14:56,1,False,10,13,-3,33,10,4
3,00:13:31,1,True,13,10,3,4,10,4
3,00:11:41,3,False,12,13,-1,42,1,4
3,00:07:19,1,True,13,12,1,52,10,4
3,00:06:01,1,False,12,13,-1,35,10,4
3,00:03:52,2,False,12,13,-1,54,2,4
3,00:00:44,1,True,13,12,1,30,10,4
4,00:13:01,2,False,12,13,-1,47,1,4
4,00:10:34,1,False,12,13,-1,11,10,4
4,00:04:07,2,False,12,13,-1,47,3,4
4,00:02:20,0,True,13,12,1,20,0,4
4,00:01:24,1,False,12,13,-1,45,10,4
4,00:01:20,2,False,12,13,-1,39,4,4
4,00:01:16,1,False,12,13,-1,35,10,4
4,00:00:20,2,False,12,13,-1,35,3,4
1,00:13:27,1,False,0,0,0,40,10,4
1,00:12:35,2,False,0,0,0,35,5,4
1,00:12:11,1,False,0,0,0,27,10,4
1,00:10:17,1,False,0,0,0,1,1,4
1,00:08:45,1,True,8,0,8,53,10,4
1,00:08:11,2,False,0,8,-8,52,5,4
1,00:05:24,1,False,7,8,-1,8,10,4
1,00:01:54,1,False,7,8,-1,43,10,4
2,00:14:25,3,False,7,8,-1,18,0,4
2,00:13:48,1,False,7,8,-1,21,10,4
2,00:13:31,1,False,7,8,-1,48,10,4
2,00:12:22,1,True,8,7,1,19,10,4
2,00:11:48,1,True,8,7,1,33,10,4
2,00:11:07,1,True,8,7,1,47,10,4
2,00:07:23,1,True,15,7,8,28,10,4
2,00:04:53,1,True,15,7,8,31,10,4
2,00:02:14,2,False,10,15,-5,43,3,4
2,00:01:33,2,False,10,15,-5,46,11,4
2,00:01:01,1,True,15,10,5,5,10,4
2,00:00:50,1,True,15,10,5,26,10,4
2,00:00:28,2,True,15,10,5,32,15,4
2,00:00:12,3,True,15,10,5,41,6,4
3,00:12:38,2,False,10,15,-5,42,0,4
3,00:10:28,1,False,10,18,-8,35,10,4
3,00:10:00,2,False,10,18,-8,40,5,4
3,00:07:44,1,False,10,18,-8,38,10,4
3,00:07:10,2,False,10,18,-8,44,4,4
3,00:06:43,1,False,10,18,-8,50,10,4
3,00:05:17,1,True,18,10,8,17,10,4
3,00:04:52,2,True,18,10,8,23,4,4
3,00:04:15,1,True,18,10,8,32,10,4
3,00:02:50,1,True,18,10,8,52,10,4
3,00:01:02,1,False,10,18,-8,53,10,4
4,00:13:15,1,False,10,18,-8,48,10,4
4,00:11:47,1,False,10,18,-8,33,10,4
4,00:10:20,1,False,10,18,-8,16,10,4
4,00:09:10,1,False,10,18,-8,3,3,4
4,00:06:43,3,True,25,10,15,34,1,4
4,00:06:10,1,True,25,10,15,30,10,4
4,00:04:37,1,True,25,13,12,35,10,4
4,00:03:41,1,False,13,25,-12,31,10,4
4,00:02:01,2,False,13,28,-15,54,2,4
4,00:00:56,1,True,28,13,15,28,10,4
4,00:00:39,2,True,28,13,15,36,2,4
1,00:14:53,1,True,0,0,0,40,10,4
1,00:13:00,1,False,0,0,0,46,10,4
1,00:11:01,1,True,0,0,0,31,10,4
1,00:10:04,1,False,0,0,0,51,10,4
1,00:08:42,1,True,0,0,0,49,10,4
1,00:08:02,2,True,0,0,0,44,5,4
1,00:00:10,1,False,3,0,3,40,10,4
2,00:14:06,1,True,0,3,-3,32,10,4
2,00:12:35,1,False,3,0,3,34,10,4
2,00:07:11,2,True,7,3,4,52,2,4
2,00:06:59,3,True,7,3,4,50,0,4
2,00:05:15,1,True,7,10,-3,36,10,4
2,00:04:03,1,False,10,7,3,51,10,4
2,00:03:23,2,True,7,10,-3,52,3,4
2,00:02:30,1,True,7,10,-3,1,1,4
3,00:14:56,1,False,17,10,7,28,10,4
3,00:14:33,1,False,17,10,7,38,10,4
3,00:13:11,1,False,17,10,7,55,10,4
3,00:11:55,1,True,10,17,-7,17,10,4
3,00:09:28,1,False,24,10,14,20,10,4
3,00:08:05,1,False,24,10,14,32,10,4
3,00:07:37,1,False,24,10,14,47,10,4
3,00:04:55,1,True,10,24,-14,20,10,4
3,00:04:29,1,True,10,31,-21,30,10,4
3,00:03:51,1,True,10,31,-21,45,10,4
3,00:03:19,2,True,10,31,-21,49,6,4
3,00:01:56,1,False,31,10,21,14,10,4
4,00:15:00,1,False,31,10,21,18,10,4
4,00:14:19,2,False,31,10,21,10,2,4
4,00:13:27,1,False,31,13,18,35,10,4
4,00:12:55,2,False,31,13,18,43,2,4
4,00:09:22,1,True,13,31,-18,2,10,4
4,00:08:04,2,True,13,31,-18,33,10,4
4,00:02:34,1,False,34,20,14,2,2,4
4,00:02:19,1,True,27,34,-7,36,10,4
4,00:01:33,1,True,27,34,-7,10,10,4
4,00:01:10,2,True,27,41,-14,55,5,4
1,00:14:55,1,False,0,0,0,42,10,4
1,00:14:16,2,False,0,0,0,44,8,4
1,00:11:20,1,True,7,0,7,18,10,4
1,00:10:05,1,False,0,7,-7,49,10,4
1,00:09:00,1,True,7,0,7,48,10,4
1,00:05:44,2,True,7,10,-3,22,15,4
1,00:05:08,1,False,10,7,3,55,10,4
1,00:02:38,2,True,7,10,-3,16,0,4
1,00:00:30,1,True,7,10,-3,3,3,4
2,00:13:58,1,True,7,17,-10,47,10,4
2,00:12:43,1,False,17,7,10,52,10,4
2,00:10:58,1,False,17,7,10,7,10,4
2,00:09:45,1,False,17,7,10,47,10,4
2,00:08:31,1,True,7,17,-10,25,10,4
2,00:07:30,3,True,7,17,-10,34,1,4
2,00:03:03,1,True,7,17,-10,21,10,4
3,00:14:21,2,True,7,21,-14,42,5,4
3,00:11:58,1,False,21,10,11,49,10,4
3,00:11:38,2,True,10,21,-11,54,3,4
3,00:11:02,3,True,10,21,-11,51,0,4
3,00:10:14,1,True,10,21,-11,35,10,4
3,00:09:46,2,True,10,21,-11,28,3,4
3,00:05:22,1,False,24,10,14,1,1,4
3,00:04:25,2,False,24,10,14,1,1,4
3,00:02:14,1,True,17,24,-7,44,10,4
4,00:14:54,1,False,24,24,0,25,10,4
4,00:14:21,2,False,24,24,0,31,4,4
4,00:12:55,2,False,24,31,-7,35,10,4
4,00:10:10,1,True,31,24,7,17,10,4
4,00:09:41,2,True,31,24,7,24,3,4
4,00:08:16,2,True,31,24,7,42,4,4
4,00:07:07,1,False,24,31,-7,30,10,4
4,00:05:39,3,False,24,31,-7,39,1,4
4,00:05:16,1,False,24,31,-7,40,10,4
4,00:02:55,1,False,24,31,-7,1,1,4
4,00:01:13,1,True,38,24,14,33,10,4
1,00:10:03,3,True,0,0,0,49,0,4
1,00:09:30,1,True,0,0,0,50,10,4
1,00:08:25,1,False,0,0,0,7,10,4
1,00:07:08,1,True,2,0,2,49,10,4
1,00:06:30,2,True,2,0,2,43,16,4
1,00:05:26,1,False,0,2,-2,37,10,4
1,00:04:49,2,False,0,2,-2,37,10,4
1,00:03:43,1,True,2,0,2,43,10,4
1,00:03:00,2,True,2,0,2,52,1,4
1,00:02:21,1,True,2,0,2,54,10,4
1,00:01:30,1,False,0,2,-2,41,10,4
1,00:00:44,2,False,0,2,-2,39,8,4
2,00:14:13,1,False,0,5,-5,55,10,4
2,00:13:33,2,True,5,0,5,49,4,4
2,00:12:50,1,True,5,0,5,50,20,4
2,00:10:59,1,True,5,3,2,31,10,4
2,00:10:05,2,False,3,5,-2,54,2,4
2,00:09:05,1,False,3,5,-2,42,5,4
2,00:05:27,1,False,3,6,-3,35,10,4
2,00:05:08,2,False,3,6,-3,42,3,4
2,00:02:39,1,False,3,6,-3,53,10,4
2,00:01:00,2,True,6,3,3,11,4,4
3,00:12:02,1,False,6,9,-3,35,10,4
3,00:11:35,2,False,6,9,-3,42,3,4
3,00:10:47,1,True,9,6,3,22,10,4
3,00:10:13,2,True,9,6,3,28,4,4
3,00:07:05,2,True,9,6,3,41,3,4
3,00:06:28,1,True,9,6,3,35,10,4
3,00:04:30,2,True,9,9,0,42,3,4
3,00:03:33,1,True,9,9,0,50,10,4
3,00:02:20,1,False,9,9,0,42,10,4
4,00:12:23,3,False,16,12,4,1,1,4
4,00:10:37,1,False,16,19,-3,38,10,4
4,00:09:20,2,False,16,19,-3,17,1,4
4,00:07:12,2,False,16,19,-3,20,15,4
4,00:04:33,1,True,26,16,10,52,10,4
4,00:03:07,1,False,16,26,-10,40,10,4
4,00:02:12,1,False,16,26,-10,28,10,4
4,00:02:02,1,False,16,26,-10,11,10,4
4,00:01:37,2,False,16,26,-10,7,6,4
4,00:01:28,1,False,16,33,-17,41,10,4
1,00:14:22,2,False,0,0,0,20,1,4
1,00:13:29,2,False,0,3,-3,43,2,4
1,00:11:40,2,True,3,0,3,18,2,4
1,00:07:28,2,True,3,7,-4,25,0,4
1,00:05:38,1,True,3,15,-12,35,10,4
1,00:04:38,1,True,3,15,-12,54,10,4
1,00:02:28,3,False,15,3,12,35,1,4
1,00:01:32,1,False,15,3,12,18,10,4
2,00:12:36,1,True,3,15,-12,18,10,4
2,00:10:37,2,True,3,15,-12,11,2,4
2,00:08:49,1,True,3,22,-19,28,10,4
2,00:08:12,2,True,3,22,-19,38,0,4
2,00:06:00,2,True,3,22,-19,33,5,4
2,00:02:44,1,False,29,3,26,27,10,4
2,00:01:20,2,False,29,3,26,47,6,4
3,00:14:53,1,True,10,29,-19,7,10,4
3,00:11:21,2,True,10,29,-19,36,10,4
3,00:09:45,2,True,10,32,-22,20,10,4
3,00:08:50,1,True,10,32,-22,31,10,4
3,00:06:11,2,False,32,18,14,21,1,4
3,00:04:14,2,False,32,25,7,17,12,4
3,00:03:32,2,False,32,25,7,37,2,4
3,00:00:58,1,False,32,25,7,29,10,4
4,00:13:50,2,True,25,32,-7,50,1,4
4,00:10:45,1,False,33,25,8,31,10,4
4,00:09:20,1,False,33,25,8,45,10,4
4,00:07:20,1,False,33,25,8,37,10,4
4,00:06:25,1,False,33,25,8,25,10,4
4,00:02:39,1,False,33,33,0,26,10,4
4,00:00:48,3,True,40,33,7,47,1,4
1,00:12:08,1,True,0,0,0,11,10,4
1,00:11:28,2,True,0,0,0,20,1,4
1,00:10:06,2,True,0,0,0,32,1,4
1,00:07:11,1,True,0,0,0,47,10,4
1,00:05:58,3,True,0,0,0,38,1,4
1,00:05:17,1,True,0,0,0,37,10,4
1,00:03:51,2,True,0,0,0,21,6,4
1,00:01:25,1,False,3,0,3,37,10,4
2,00:13:51,1,False,3,3,0,47,10,4
2,00:11:05,1,False,3,6,-3,20,10,4
2,00:10:19,2,False,3,6,-3,19,11,4
2,00:07:25,1,True,6,3,3,32,10,4
2,00:06:11,1,True,6,3,3,52,10,4
2,00:04:10,1,False,3,6,-3,20,10,4
2,00:01:15,1,False,3,8,-5,5,5,4
3,00:11:27,1,True,15,3,12,38,10,4
3,00:09:58,1,True,15,3,12,35,10,4
3,00:08:17,1,True,15,6,9,46,10,4
3,00:06:39,1,False,6,15,-9,38,10,4
3,00:04:17,1,False,6,16,-10,52,10,4
4,00:14:34,1,True,16,6,10,7,10,4
4,00:13:23,1,True,16,6,10,45,10,4
4,00:12:07,1,True,16,9,7,35,10,4
4,00:11:00,1,True,16,9,7,47,10,4
4,00:10:25,1,False,9,16,-7,53,10,4
4,00:09:48,1,False,9,16,-7,38,10,4
4,00:09:07,2,False,9,16,-7,32,4,4
4,00:06:51,1,True,19,9,10,43,10,4
4,00:04:17,1,False,9,19,-10,37,10,4
4,00:02:17,1,True,26,9,17,30,10,4
4,00:02:10,1,True,26,9,17,42,10,4
4,00:01:47,2,True,26,9,17,48,4,4
4,00:01:22,1,True,26,9,17,54,10,4
4,00:01:15,2,False,9,26,-17,53,7,4
4,00:00:46,1,False,9,26,-17,35,10,4
4,00:00:42,2,False,9,26,-17,31,6,4
1,00:12:52,1,False,0,0,0,49,10,4
1,00:12:15,2,False,0,0,0,43,4,4
1,00:11:22,1,False,0,3,-3,35,10,4
1,00:09:18,1,False,0,3,-3,50,10,4
1,00:07:49,1,False,0,6,-6,35,10,4
1,00:06:35,2,True,6,0,6,52,0,4
1,00:06:02,3,True,6,0,6,52,0,4
1,00:05:10,1,True,6,0,6,39,10,4
1,00:01:43,1,False,0,6,-6,35,10,4
2,00:15:00,1,False,0,6,-6,33,10,4
2,00:14:50,1,False,0,6,-6,16,10,4
2,00:11:49,1,True,13,0,13,26,10,4
2,00:10:19,1,False,0,13,-13,46,10,4
2,00:09:47,2,False,0,13,-13,53,3,4
2,00:07:21,2,True,13,0,13,48,0,4
2,00:06:31,1,True,13,0,13,35,10,4
2,00:06:07,2,True,13,0,13,29,4,4
2,00:04:11,1,True,13,0,13,3,3,4
2,00:01:42,1,True,13,3,10,48,10,4
2,00:00:34,2,False,3,13,-10,23,4,4
3,00:14:53,1,False,3,13,-10,22,10,4
3,00:12:54,2,False,3,13,-10,45,2,4
3,00:12:36,3,False,3,13,-10,44,1,4
3,00:07:16,1,False,3,20,-17,26,10,4
3,00:05:11,1,True,20,3,17,27,10,4
3,00:04:10,1,False,3,20,-17,54,10,4
3,00:02:07,1,False,3,20,-17,12,10,4
3,00:01:14,1,False,3,20,-17,15,20,4
4,00:13:51,1,False,3,20,-17,45,10,4
4,00:09:43,1,False,3,20,-17,26,10,4
4,00:07:10,2,True,20,3,17,45,1,4
4,00:06:40,1,True,20,3,17,47,10,4
4,00:06:19,2,True,20,3,17,45,12,4
4,00:02:26,1,False,3,27,-24,43,10,4
4,00:02:22,2,False,3,27,-24,38,5,4
4,00:01:30,1,False,3,28,-25,20,10,4
4,00:01:24,2,False,3,28,-25,28,2,4
1,00:14:32,1,False,0,0,0,41,10,4
1,00:13:58,2,False,0,0,0,36,5,4
1,00:12:33,2,False,0,0,0,15,1,4
1,00:11:49,2,False,0,0,0,45,1,4
1,00:11:19,1,False,0,0,0,47,10,4
1,00:06:01,1,True,0,4,-4,35,10,4
1,00:02:56,1,True,0,4,-4,18,10,4
1,00:02:36,1,True,0,4,-4,32,10,4
1,00:00:11,1,True,0,4,-4,51,10,4
2,00:13:51,1,True,0,11,-11,42,10,4
2,00:08:24,1,False,18,1,17,43,10,4
2,00:05:02,1,False,18,8,10,38,10,4
2,00:02:52,1,True,8,18,-10,37,10,4
2,00:02:03,2,False,18,8,10,34,1,4
2,00:01:20,2,False,18,9,9,44,1,4
2,00:00:36,2,True,9,18,-9,42,10,4
3,00:13:02,1,True,9,21,-12,30,10,4
3,00:09:33,1,True,9,21,-12,29,10,4
3,00:06:08,1,True,9,28,-19,10,10,4
3,00:05:24,1,True,9,28,-19,38,10,4
3,00:02:04,1,False,28,9,19,45,10,4
4,00:11:45,1,False,30,9,21,27,10,4
4,00:07:34,1,False,30,16,14,34,10,4
4,00:06:12,1,True,16,30,-14,45,10,4
4,00:03:04,2,False,33,16,17,45,1,4
4,00:02:11,1,False,33,16,17,1,1,4
4,00:01:49,2,False,33,16,17,1,1,4
4,00:01:49,1,True,23,33,-10,44,10,4
4,00:01:44,1,True,23,33,-10,31,10,4
4,00:00:53,2,True,23,33,-10,26,5,4
1,00:14:33,2,True,0,0,0,16,9,4
1,00:13:41,1,True,0,0,0,27,10,4
1,00:12:42,1,False,0,0,0,43,10,4
1,00:10:49,3,True,0,0,0,43,0,4
1,00:10:14,1,True,0,0,0,41,10,4
1,00:04:19,2,False,0,0,0,54,2,4
2,00:10:38,2,False,1,3,-2,40,10,4
2,00:02:04,2,True,3,15,-12,41,9,4
3,00:14:02,1,False,15,3,12,25,5,4
3,00:13:30,2,False,15,3,12,22,2,4
3,00:12:59,3,False,15,3,12,20,0,4
3,00:08:19,2,True,6,15,-9,20,18,4
3,00:07:37,1,False,15,6,9,25,10,4
3,00:06:14,2,False,15,6,9,52,1,4
3,00:03:56,2,False,15,7,8,35,10,4
4,00:11:50,1,False,15,10,5,1,1,4
4,00:10:56,2,False,15,17,-2,44,1,4
4,00:10:09,3,False,15,17,-2,44,2,4
4,00:09:25,1,False,15,17,-2,47,10,4
4,00:07:26,0,False,15,17,-2,13,0,4
4,00:03:54,2,False,16,17,-1,50,3,4
4,00:02:14,1,False,16,24,-8,42,10,4
4,00:02:11,2,False,16,24,-8,38,6,4
1,00:13:06,1,True,0,0,0,14,10,4
1,00:11:56,1,True,0,0,0,50,10,4
1,00:11:23,2,True,0,0,0,41,1,4
1,00:07:30,1,True,0,0,0,19,10,4
1,00:06:37,1,True,0,0,0,30,10,4
1,00:05:26,1,False,0,0,0,43,10,4
1,00:04:50,2,False,0,0,0,52,1,4
1,00:02:56,2,True,0,0,0,40,2,4
1,00:02:20,1,True,0,0,0,44,10,4
1,00:01:05,1,False,0,0,0,53,10,4
2,00:14:40,1,False,0,0,0,3,3,4
2,00:13:54,2,False,0,0,0,1,1,4
2,00:13:37,1,False,0,7,-7,38,10,4
2,00:12:58,2,False,0,7,-7,46,2,4
2,00:12:04,1,True,7,0,7,37,10,4
2,00:10:43,1,True,7,0,7,50,20,4
2,00:07:38,2,True,8,1,7,43,2,4
2,00:07:03,3,True,8,1,7,44,1,4
2,00:05:25,1,False,1,8,-7,21,10,4
2,00:03:10,1,False,1,15,-14,55,10,4
2,00:03:00,2,True,15,1,14,50,5,4
2,00:02:46,1,True,15,1,14,35,10,4
2,00:02:21,1,True,15,1,14,24,10,4
2,00:02:01,2,True,15,1,14,15,1,4
2,00:01:20,2,True,15,1,14,3,0,4
2,00:01:00,1,True,15,1,14,3,3,4
2,00:00:22,2,True,15,1,14,1,1,4
3,00:13:01,1,True,15,8,7,49,10,4
3,00:11:43,1,True,15,8,7,6,6,4
3,00:11:22,1,True,15,15,0,28,10,4
3,00:10:44,1,True,15,15,0,45,10,4
3,00:09:44,1,False,15,15,0,54,10,4
3,00:09:10,2,False,15,15,0,48,4,4
3,00:08:12,1,False,15,15,0,15,10,4
3,00:06:00,1,False,15,15,0,54,10,4
3,00:05:30,2,False,15,15,0,47,3,4
3,00:05:11,3,False,15,15,0,45,1,4
3,00:03:10,2,False,15,15,0,27,7,4
3,00:02:25,1,False,15,15,0,19,10,4
3,00:00:24,1,False,15,18,-3,21,10,4
4,00:14:39,1,False,15,18,-3,45,10,4
4,00:12:32,2,False,15,18,-3,12,1,4
4,00:10:07,1,False,15,25,-10,44,10,4
4,00:06:49,1,True,28,15,13,44,10,4
4,00:06:21,2,True,28,15,13,50,4,4
4,00:04:05,1,False,15,28,-13,43,10,4
4,00:03:04,1,False,15,28,-13,25,10,4
4,00:02:15,1,False,15,31,-16,46,10,4
4,00:02:02,2,False,15,31,-16,44,8,4
4,00:01:30,2,False,15,31,-16,8,10,4
4,00:00:45,1,True,31,15,16,33,10,4
1,00:14:54,1,False,0,0,0,25,10,4
1,00:13:41,1,False,0,0,0,39,10,4
1,00:12:39,1,False,0,0,0,55,10,4
1,00:11:59,1,True,0,0,0,30,10,4
1,00:10:14,1,True,0,0,0,9,10,4
1,00:09:48,2,True,0,0,0,13,6,4
1,00:08:08,1,True,0,0,0,8,8,4
1,00:07:53,1,True,0,7,-7,24,10,4
1,00:07:11,1,True,0,7,-7,34,10,4
1,00:05:51,1,True,0,7,-7,50,10,4
1,00:05:23,2,False,7,0,7,53,3,4
1,00:04:45,1,False,7,0,7,50,10,4
1,00:04:10,1,False,7,0,7,35,10,4
1,00:01:42,1,True,3,7,-4,28,10,4
2,00:14:43,1,True,3,8,-5,35,10,4
2,00:14:13,2,True,3,8,-5,39,6,4
2,00:09:11,3,True,3,8,-5,20,1,4
2,00:07:57,2,True,3,8,-5,9,1,4
2,00:04:40,1,False,15,3,12,27,10,4
2,00:00:02,2,True,10,22,-12,41,10,4
3,00:10:23,1,True,17,22,-5,41,10,4
3,00:09:18,1,True,17,22,-5,30,10,4
3,00:08:57,2,True,17,22,-5,24,4,4
3,00:07:22,1,True,17,29,-12,39,10,4
3,00:01:18,1,False,29,17,12,26,10,4
4,00:15:00,1,True,17,29,-12,49,10,4
4,00:13:37,1,False,29,24,5,34,10,4
4,00:11:05,1,True,24,29,-5,30,10,4
4,00:09:24,3,True,24,29,-5,52,1,4
4,00:08:50,1,True,24,29,-5,53,10,4
4,00:08:11,2,True,24,29,-5,50,13,4
4,00:04:07,1,False,29,24,5,53,10,4
4,00:03:40,2,True,24,29,-5,50,3,4
4,00:03:06,1,True,24,29,-5,21,10,4
4,00:02:38,2,True,24,29,-5,20,9,4
4,00:00:49,1,False,32,24,8,1,10,4
4,00:00:39,2,False,32,32,0,38,10,4
5,00:00:00,1,False,32,32,0,35,10,4
5,00:00:00,2,False,32,32,0,35,10,4
5,00:00:00,1,False,32,32,0,19,10,4
1,00:13:42,1,False,0,0,0,28,10,4
1,00:12:35,3,False,0,0,0,37,1,4
1,00:11:56,1,False,0,0,0,36,10,4
1,00:09:16,2,True,7,0,7,22,11,4
1,00:06:47,2,False,0,7,-7,49,2,4
1,00:06:12,1,False,0,7,-7,47,10,4
1,00:04:30,2,False,0,7,-7,35,10,4
1,00:02:38,1,False,0,10,-10,29,10,4
1,00:00:45,2,True,10,0,10,53,3,4
1,00:00:28,3,True,10,0,10,55,1,4
2,00:14:13,1,False,0,10,-10,6,10,4
2,00:13:00,1,True,12,0,12,47,10,4
2,00:12:37,1,False,0,12,-12,44,10,4
2,00:11:40,2,False,0,12,-12,50,16,4
2,00:09:50,2,False,0,13,-13,48,1,4
2,00:09:16,1,True,13,0,13,14,10,4
2,00:07:11,1,False,0,13,-13,40,10,4
2,00:06:43,1,False,0,13,-13,50,10,4
2,00:04:57,1,True,13,0,13,4,10,4
2,00:04:20,1,False,0,13,-13,46,10,4
2,00:02:21,1,False,0,14,-14,43,10,4
2,00:01:54,2,False,0,14,-14,51,2,4
3,00:14:55,1,False,0,14,-14,34,10,4
3,00:13:34,1,True,14,0,14,43,10,4
3,00:12:55,2,True,14,0,14,52,1,4
3,00:11:00,2,False,0,14,-14,40,5,4
3,00:08:05,1,True,17,0,17,33,10,4
3,00:06:38,1,True,17,0,17,52,10,4
3,00:05:23,1,True,17,0,17,23,10,4
3,00:04:50,2,True,17,0,17,32,1,4
3,00:01:30,2,False,0,17,-17,49,3,4
3,00:00:35,1,True,17,0,17,15,10,4
4,00:13:04,1,True,17,0,17,16,10,4
4,00:11:27,1,True,17,0,17,38,10,4
4,00:10:05,1,False,0,17,-17,22,10,4
4,00:08:40,2,False,0,17,-17,49,0,4
4,00:04:14,1,True,17,0,17,5,10,4
4,00:03:40,2,True,17,0,17,10,5,4
4,00:03:01,1,True,17,0,17,17,10,4
4,00:02:37,2,True,17,0,17,19,8,4
4,00:02:16,1,True,17,0,17,39,10,4
4,00:00:42,2,False,0,24,-24,27,19,4
4,00:00:22,3,False,0,24,-24,45,1,4
1,00:12:30,1,True,0,0,0,37,10,4
1,00:11:00,1,True,0,3,-3,15,10,4
1,00:06:20,1,False,3,0,3,24,10,4
1,00:05:19,1,True,0,3,-3,37,10,4
1,00:04:02,1,True,0,3,-3,49,10,4
2,00:10:58,1,True,2,3,-1,31,10,4
2,00:10:07,2,True,2,3,-1,22,1,4
2,00:08:48,1,True,2,10,-8,50,10,4
2,00:08:09,2,False,10,2,8,52,2,4
2,00:07:27,1,False,10,2,8,47,10,4
2,00:06:09,1,False,10,2,8,18,10,4
2,00:05:30,2,False,10,2,8,16,8,4
2,00:01:49,2,False,10,5,5,48,0,4
3,00:12:41,1,True,5,13,-8,35,10,4
3,00:09:57,2,False,13,5,8,55,19,4
3,00:07:00,1,False,13,5,8,41,10,4
3,00:05:50,1,True,5,13,-8,21,10,4
3,00:04:05,2,True,5,13,-8,40,3,4
3,00:02:24,2,True,5,13,-8,22,2,4
4,00:12:34,1,True,5,13,-8,52,10,4
4,00:09:26,1,False,16,5,11,10,10,4
4,00:03:00,1,False,16,11,5,47,10,4
4,00:01:25,2,False,16,11,5,34,3,4
4,00:00:43,2,False,16,11,5,12,7,4
1,00:13:41,1,False,0,7,-7,31,10,4
1,00:08:59,1,True,7,7,0,27,10,4
1,00:07:42,1,False,7,7,0,18,10,4
1,00:06:15,1,False,7,7,0,30,10,4
1,00:05:04,1,True,7,7,0,27,10,4
1,00:04:02,1,True,7,7,0,46,10,4
1,00:02:54,1,True,7,7,0,25,10,4
1,00:01:37,1,True,7,7,0,7,7,4
1,00:00:01,1,True,7,10,-3,35,10,4
2,00:13:45,1,False,10,7,3,3,10,4
2,00:09:20,2,False,10,7,3,53,4,4
2,00:08:55,1,True,14,10,4,43,10,4
2,00:08:14,2,True,14,10,4,37,4,4
2,00:06:18,1,True,14,10,4,1,1,4
2,00:05:57,1,True,14,17,-3,31,10,4
2,00:04:30,1,True,14,17,-3,44,10,4
2,00:03:55,2,True,14,17,-3,54,0,4
2,00:03:25,1,False,17,14,3,52,10,4
2,00:02:39,1,False,17,14,3,36,10,4
2,00:02:33,2,False,17,14,3,31,5,4
2,00:01:20,2,True,21,17,4,47,0,4
2,00:00:30,2,False,17,21,-4,43,1,4
2,00:00:03,2,False,17,21,-4,1,1,4
3,00:14:03,1,True,28,17,11,42,10,4
3,00:11:38,2,False,17,28,-11,18,2,4
3,00:06:36,1,True,31,20,11,35,10,4
3,00:04:56,1,False,20,31,-11,46,10,4
3,00:02:23,1,False,20,39,-19,35,10,4
4,00:14:19,2,False,20,39,-19,24,2,4
4,00:12:09,3,False,20,42,-22,44,1,4
4,00:11:02,2,False,20,42,-22,53,2,4
4,00:09:59,1,True,42,20,22,20,10,4
4,00:06:22,2,False,20,42,-22,48,1,4
4,00:06:00,1,True,42,20,22,53,10,4
4,00:05:37,2,True,42,20,22,43,0,4
4,00:04:08,1,False,20,42,-22,40,10,4
4,00:03:33,2,False,20,42,-22,33,3,4
4,00:01:51,1,True,42,20,22,46,10,4
4,00:01:33,2,True,42,20,22,53,3,4
4,00:01:21,1,False,20,42,-22,53,10,4
4,00:01:00,2,False,20,42,-22,46,3,4
1,00:14:54,1,False,0,0,0,35,10,4
1,00:13:19,1,True,0,0,0,16,10,4
1,00:13:00,2,True,0,0,0,22,4,4
1,00:12:25,1,True,0,0,0,29,10,4
1,00:10:16,1,True,0,0,0,53,10,4
1,00:09:45,1,True,0,0,0,42,10,4
1,00:05:19,1,True,0,2,-2,54,10,4
1,00:03:42,1,True,0,2,-2,12,10,4
1,00:03:12,1,True,0,2,-2,22,10,4
1,00:00:47,1,True,0,2,-2,55,10,4
1,00:00:01,1,False,2,0,2,45,10,4
2,00:14:26,1,False,2,0,2,54,10,4
2,00:13:16,1,True,0,2,-2,15,10,4
2,00:11:06,1,True,0,2,-2,45,10,4
2,00:09:40,1,True,0,2,-2,46,10,4
2,00:08:24,1,True,0,2,-2,11,10,4
2,00:08:04,1,True,0,2,-2,32,10,4
2,00:05:15,2,True,0,9,-9,38,2,4
2,00:04:42,1,True,0,9,-9,45,10,4
2,00:03:27,1,False,9,0,9,50,10,4
2,00:02:19,1,False,9,0,9,28,10,4
2,00:02:10,1,False,9,0,9,40,10,4
2,00:01:51,2,False,9,0,9,45,5,4
3,00:14:50,1,True,0,9,-9,36,10,4
3,00:13:08,1,False,9,0,9,36,10,4
3,00:12:45,2,False,9,0,9,40,6,4
3,00:12:10,1,False,9,0,9,48,10,4
3,00:11:35,2,True,0,9,-9,54,2,4
3,00:10:03,1,True,0,10,-10,35,10,4
3,00:07:08,1,True,0,17,-17,15,10,4
3,00:05:46,1,True,0,17,-17,49,10,4
3,00:03:57,2,True,0,17,-17,14,10,4
3,00:02:02,1,False,24,8,16,31,10,4
3,00:01:29,2,False,24,8,16,36,5,4
4,00:14:54,1,False,24,16,8,44,10,4
4,00:13:43,1,True,16,24,-8,9,10,4
4,00:13:04,2,True,16,24,-8,11,8,4
4,00:11:45,1,True,16,24,-8,40,10,4
4,00:10:43,1,False,24,16,8,23,10,4
4,00:09:51,1,False,24,16,8,1,1,4
4,00:08:53,2,False,24,16,8,1,1,4
4,00:04:53,2,True,24,24,0,50,10,4
4,00:02:01,1,True,24,24,0,20,5,4
4,00:01:55,2,True,24,24,0,16,1,4
4,00:01:34,1,True,24,24,0,15,10,4
4,00:01:17,1,True,24,24,0,4,4,4
4,00:01:13,2,True,24,24,0,1,1,4
4,00:00:32,1,True,24,24,0,1,1,4
1,00:13:57,3,True,0,0,0,52,0,4
1,00:13:36,1,False,0,0,0,54,10,4
1,00:12:28,1,False,0,0,0,5,10,4
1,00:10:01,1,False,0,7,-7,27,10,4
1,00:05:57,1,True,14,7,7,35,10,4
1,00:05:20,1,True,14,7,7,45,10,4
1,00:02:26,1,False,7,17,-10,5,14,4
2,00:13:04,1,True,17,7,10,41,10,4
2,00:12:29,1,False,7,17,-10,44,10,4
2,00:11:52,2,False,7,17,-10,38,4,4
2,00:08:47,1,True,20,7,13,52,10,4
2,00:07:23,1,True,20,7,13,39,10,4
2,00:05:42,1,True,20,7,13,23,10,4
2,00:04:47,1,True,20,14,6,21,10,4
2,00:01:56,2,False,21,20,1,29,0,4
2,00:01:15,1,False,21,20,1,25,10,4
3,00:13:57,1,False,21,20,1,40,10,4
3,00:09:21,1,False,21,20,1,42,10,4
3,00:06:52,1,False,21,23,-2,35,10,4
3,00:05:33,1,True,23,21,2,34,10,4
3,00:04:41,3,True,23,21,2,43,1,4
3,00:03:38,1,True,23,21,2,50,5,4
3,00:02:27,2,False,21,23,-2,45,2,4
3,00:00:40,1,False,21,23,-2,30,5,4
4,00:13:13,1,True,26,21,5,45,10,4
4,00:10:43,1,True,29,21,8,43,10,4
4,00:08:47,1,True,29,24,5,35,10,4
4,00:06:01,1,False,24,29,-5,19,10,4
4,00:02:27,1,False,24,30,-6,42,10,4
4,00:02:22,1,False,24,30,-6,30,10,4
4,00:01:54,2,False,24,30,-6,32,12,4
1,00:14:55,1,False,0,0,0,30,10,4
1,00:12:57,1,False,0,0,0,45,10,4
1,00:10:28,1,True,0,0,0,42,10,4
1,00:08:50,2,True,0,0,0,54,1,4
1,00:06:57,1,True,0,0,0,12,10,4
1,00:06:24,1,True,0,0,0,24,10,4
1,00:04:37,1,False,0,0,0,43,10,4
1,00:03:22,1,False,0,0,0,33,10,4
2,00:14:07,1,False,10,0,10,29,10,4
2,00:12:44,1,False,10,3,7,35,10,4
2,00:11:22,3,False,10,3,7,44,1,4
2,00:10:29,1,False,10,3,7,45,10,4
2,00:08:53,1,False,10,3,7,50,10,4
2,00:06:56,1,False,10,3,7,12,10,4
2,00:00:41,2,True,9,10,-1,47,4,4
3,00:14:36,2,False,10,9,1,54,1,4
3,00:13:40,1,True,9,10,-1,54,10,4
3,00:10:02,2,False,10,9,1,44,3,4
3,00:08:23,1,False,10,12,-2,39,10,4
3,00:07:04,1,True,12,10,2,7,10,4
3,00:04:47,1,False,10,12,-2,50,10,4
4,00:15:00,1,False,17,12,5,26,10,4
4,00:11:40,2,False,17,12,5,40,0,4
4,00:08:37,3,False,17,12,5,14,1,4
4,00:08:27,1,False,17,12,5,13,10,4
4,00:05:35,1,False,17,14,3,7,10,4
4,00:02:26,1,False,17,16,1,5,5,4
4,00:02:21,2,False,17,16,1,1,1,4
4,00:01:00,1,True,19,17,2,51,10,4
4,00:00:56,2,True,19,17,2,52,9,4
1,00:10:03,1,True,0,0,0,5,5,4
1,00:08:53,1,True,0,7,-7,16,10,4
1,00:06:29,1,False,7,0,7,41,10,4
1,00:04:37,2,True,0,7,-7,43,3,4
1,00:03:54,3,True,0,7,-7,45,1,4
1,00:01:50,1,False,7,0,7,55,10,4
1,00:01:11,2,True,0,7,-7,34,2,4
1,00:00:15,1,True,0,10,-10,35,10,4
2,00:08:57,2,True,0,13,-13,43,2,4
2,00:07:44,2,False,13,0,13,52,2,4
2,00:01:49,2,True,7,13,-6,28,15,4
3,00:09:16,1,True,10,23,-13,45,10,4
3,00:07:03,1,False,23,10,13,37,10,4
3,00:06:24,2,False,23,10,13,31,4,4
3,00:01:38,1,False,30,13,17,29,10,4
3,00:00:41,1,False,30,13,17,35,10,4
4,00:10:28,2,True,20,30,-10,51,0,4
4,00:08:40,1,False,30,20,10,37,15,4
4,00:07:20,3,False,30,20,10,52,0,4
4,00:02:07,1,False,33,20,13,1,1,4
4,00:02:00,1,False,33,27,6,24,10,4
4,00:00:32,1,False,33,34,-1,9,9,4
4,00:00:28,2,False,33,34,-1,11,11,4
1,00:14:54,1,False,0,0,0,30,10,4
1,00:14:09,2,False,0,0,0,40,0,4
1,00:13:45,1,False,0,0,0,44,10,4
1,00:13:12,2,False,0,0,0,51,3,4
1,00:12:34,1,False,0,0,0,54,10,4
1,00:09:31,1,False,0,0,0,38,10,4
1,00:09:04,1,False,0,0,0,50,10,4
1,00:07:26,2,True,0,0,0,7,10,4
1,00:06:00,1,True,0,0,0,35,10,4
1,00:05:31,1,True,0,0,0,22,10,4
1,00:03:16,1,True,0,7,-7,35,10,4
1,00:02:08,1,False,7,0,7,24,10,4
1,00:01:51,2,False,7,0,7,32,2,4
1,00:01:18,3,False,7,0,7,34,0,4
1,00:00:03,1,False,7,0,7,25,20,4
2,00:13:52,1,True,0,7,-7,8,10,4
2,00:12:45,1,True,0,7,-7,25,10,4
2,00:09:50,1,False,7,0,7,1,1,4
2,00:09:36,1,False,7,7,0,32,10,4
2,00:09:05,2,False,7,7,0,38,4,4
2,00:08:12,1,True,7,7,0,31,10,4
2,00:06:35,1,False,7,7,0,8,10,4
2,00:06:24,2,False,7,7,0,10,8,4
2,00:05:15,1,True,7,7,0,49,10,4
2,00:04:04,1,False,7,14,-7,18,10,4
2,00:02:40,1,True,14,7,7,53,10,4
2,00:02:26,2,True,14,7,7,49,14,4
2,00:01:50,1,False,7,14,-7,13,10,4
2,00:00:37,2,False,7,14,-7,38,10,4
3,00:14:48,1,False,7,14,-7,43,10,4
3,00:14:13,2,False,7,14,-7,43,10,4
3,00:13:40,1,False,7,14,-7,29,10,4
3,00:11:11,2,True,21,7,14,52,3,4
3,00:10:36,1,True,21,7,14,46,10,4
3,00:10:05,2,True,21,7,14,41,6,4
3,00:09:05,1,True,21,7,14,25,10,4
3,00:08:06,1,True,21,7,14,41,10,4
3,00:07:33,2,True,21,7,14,49,2,4
3,00:01:55,1,False,7,31,-24,37,10,4
4,00:14:04,1,True,34,7,27,47,10,4
4,00:12:30,1,True,34,7,27,5,10,4
4,00:09:42,1,True,34,9,25,18,10,4
4,00:09:22,2,True,34,9,25,23,5,4
4,00:08:38,1,True,34,9,25,34,10,4
4,00:07:56,2,True,34,9,25,40,4,4
4,00:07:09,1,False,9,34,-25,50,10,4
4,00:06:34,1,False,9,34,-25,35,10,4
4,00:05:54,2,False,9,34,-25,32,7,4
4,00:05:17,1,False,9,34,-25,23,10,4
4,00:04:46,2,False,9,34,-25,18,5,4
4,00:03:40,1,False,9,37,-28,35,10,4
4,00:03:09,1,False,9,37,-28,45,10,4
4,00:02:04,1,False,9,37,-28,25,10,4
4,00:01:58,2,False,9,37,-28,24,9,4
4,00:01:15,1,False,9,40,-31,35,10,4
4,00:00:47,1,False,9,40,-31,48,10,4
4,00:00:05,1,True,40,9,31,44,10,4
1,00:14:30,1,False,0,0,0,44,5,4
1,00:09:40,1,False,0,0,0,45,10,4
1,00:09:05,2,False,0,0,0,36,1,4
1,00:08:14,1,False,0,0,0,37,15,4
1,00:06:47,2,False,0,0,0,11,10,4
1,00:05:57,1,False,0,0,0,1,1,4
1,00:05:13,1,False,0,7,-7,29,10,4
1,00:00:55,2,True,10,0,10,39,2,4
1,00:00:01,1,False,0,10,-10,52,10,4
2,00:15:00,2,False,0,10,-10,46,4,4
2,00:14:39,1,False,0,10,-10,40,10,4
2,00:11:47,0,False,0,11,-11,33,0,4
2,00:10:10,1,False,0,11,-11,30,10,4
2,00:08:48,1,False,0,14,-14,35,10,4
2,00:08:10,1,False,0,14,-14,49,10,4
2,00:05:29,1,False,0,21,-21,8,10,4
2,00:04:14,1,False,0,21,-21,52,10,4
2,00:03:25,1,False,0,21,-21,26,10,4
2,00:02:37,1,False,0,21,-21,1,1,4
2,00:00:34,2,True,30,0,30,52,0,4
2,00:00:04,1,False,0,30,-30,1,1,4
3,00:12:40,1,False,0,37,-37,27,10,4
3,00:12:04,1,False,0,37,-37,13,10,4
3,00:08:29,1,True,40,0,40,37,10,4
3,00:05:27,1,False,3,40,-37,42,10,4
3,00:04:41,2,False,3,40,-37,36,4,4
3,00:03:35,1,False,3,40,-37,34,10,4
3,00:01:17,1,True,40,6,34,35,10,4
4,00:13:21,1,False,6,41,-35,40,5,4
4,00:09:17,2,True,41,9,32,31,14,4
4,00:08:09,1,True,41,9,32,49,10,4
4,00:06:52,1,True,41,9,32,32,10,4
4,00:06:04,2,True,41,9,32,25,3,4
4,00:04:44,1,True,41,9,32,36,10,4
4,00:04:10,1,True,41,9,32,51,10,4
4,00:03:34,2,True,41,9,32,55,6,4
4,00:01:08,1,True,41,9,32,44,10,4
4,00:01:03,2,True,41,9,32,48,6,4
1,00:14:55,1,True,0,0,0,31,10,4
1,00:14:22,2,True,0,0,0,35,6,4
1,00:12:44,3,False,0,0,0,49,0,4
1,00:10:50,1,False,0,0,0,21,10,4
1,00:09:01,1,False,0,3,-3,35,10,4
1,00:03:55,1,True,4,0,4,49,10,4
1,00:03:06,2,True,4,0,4,42,3,4
1,00:01:49,1,True,4,0,4,14,10,4
1,00:00:36,1,True,4,0,4,28,10,4
2,00:14:20,1,False,0,4,-4,35,10,4
2,00:12:11,1,False,0,4,-4,45,10,4
2,00:10:11,1,True,4,1,3,55,10,4
2,00:07:52,1,False,1,4,-3,39,10,4
2,00:04:06,1,True,4,1,3,7,10,4
2,00:03:20,2,True,4,1,3,15,2,4
2,00:01:30,2,True,4,1,3,39,0,4
2,00:00:50,1,False,1,4,-3,45,10,4
3,00:13:07,3,True,7,1,6,49,0,4
3,00:09:45,1,False,3,7,-4,41,10,4
3,00:08:06,1,True,7,3,4,48,10,4
3,00:04:55,1,True,7,3,4,25,10,4
3,00:04:41,1,True,7,3,4,39,10,4
3,00:02:04,1,True,7,3,4,21,10,4
3,00:00:50,1,True,7,6,1,35,10,4
3,00:00:01,1,False,6,7,-1,52,10,4
4,00:15:00,1,False,6,7,-1,9,9,4
4,00:12:35,1,True,15,6,9,35,10,4
4,00:10:34,1,False,6,15,-9,21,10,4
4,00:06:22,2,True,16,6,10,54,4,4
4,00:02:48,1,True,16,6,10,55,10,4
4,00:02:23,2,False,6,16,-10,52,7,4
4,00:01:54,1,False,6,16,-10,42,10,4
4,00:01:32,2,False,6,16,-10,36,4,4
4,00:01:02,1,False,6,16,-10,30,10,4
4,00:00:43,2,False,6,16,-10,25,5,4
4,00:00:01,3,False,6,16,-10,21,1,4
1,00:14:00,1,True,0,0,0,42,10,4
1,00:13:07,1,False,0,0,0,40,10,4
1,00:11:38,2,True,0,0,0,44,1,4
1,00:09:48,2,False,0,0,0,46,2,4
1,00:07:50,1,False,0,3,-3,38,10,4
1,00:06:25,2,True,3,0,3,28,3,4
1,00:00:33,2,True,3,3,0,18,2,4
2,00:13:16,2,True,3,10,-7,55,2,4
2,00:12:08,2,False,10,3,7,46,6,4
2,00:11:11,1,False,10,6,4,35,10,4
2,00:10:35,2,False,10,6,4,45,0,4
2,00:08:20,1,True,6,10,-4,38,10,4
2,00:07:15,1,True,6,10,-4,50,10,4
2,00:04:11,1,False,10,6,4,28,10,4
2,00:03:40,2,False,10,6,4,34,4,4
2,00:01:17,0,True,6,10,-4,25,0,4
3,00:14:54,1,False,10,6,4,36,10,4
3,00:14:16,1,False,10,6,4,48,10,4
3,00:13:15,1,True,6,10,-4,46,10,4
3,00:10:59,1,True,6,10,-4,40,10,4
3,00:07:46,1,True,6,13,-7,53,10,4
3,00:05:00,1,True,6,13,-7,5,10,4
3,00:02:26,1,True,6,13,-7,47,10,4
3,00:00:31,1,True,6,13,-7,3,3,4
4,00:14:42,2,True,6,13,-7,1,1,4
4,00:14:11,1,True,6,20,-14,37,10,4
4,00:13:42,2,True,6,20,-14,46,1,4
4,00:12:59,1,True,6,20,-14,52,10,4
4,00:11:56,1,False,20,6,14,40,10,4
4,00:10:17,1,False,20,6,14,47,10,4
4,00:08:08,1,False,20,9,11,30,10,4
4,00:03:10,1,False,20,12,8,35,10,4
4,00:01:55,3,False,20,12,8,45,0,4
4,00:01:32,3,False,20,12,8,35,1,4
4,00:01:27,1,False,20,12,8,34,10,4
4,00:01:19,1,True,12,20,-8,53,10,4
4,00:00:57,2,True,12,20,-8,48,5,4
1,00:14:56,1,False,0,0,0,41,10,4
1,00:14:17,2,False,0,0,0,49,2,4
1,00:12:59,1,True,0,0,0,42,10,4
1,00:11:49,3,True,0,0,0,32,0,4
1,00:11:13,1,True,0,0,0,30,10,4
1,00:10:36,2,True,0,0,0,22,2,4
1,00:07:55,1,False,7,0,7,41,10,4
1,00:06:09,1,True,0,14,-14,34,10,4
1,00:03:59,1,False,14,0,14,41,10,4
1,00:01:55,1,False,14,3,11,41,10,4
2,00:13:52,1,False,15,3,12,46,10,4
2,00:11:16,1,False,15,6,9,50,10,4
2,00:10:40,2,True,6,15,-9,52,2,4
2,00:10:16,1,True,6,15,-9,50,10,4
2,00:08:43,1,True,6,16,-10,35,10,4
2,00:06:50,1,False,16,6,10,8,8,4
2,00:02:38,2,False,16,6,10,40,5,4
2,00:02:02,1,True,6,16,-10,48,10,4
2,00:00:14,2,True,6,16,-10,45,3,4
3,00:14:57,1,True,6,16,-10,37,10,4
3,00:14:16,1,True,6,16,-10,55,10,4
3,00:13:01,1,False,16,7,9,30,15,4
3,00:12:22,1,False,16,7,9,45,10,4
3,00:09:58,1,True,7,16,-9,1,1,4
3,00:08:50,2,True,7,23,-16,42,1,4
3,00:08:04,1,False,23,7,16,40,10,4
3,00:07:34,2,False,23,7,16,41,11,4
3,00:04:40,1,True,7,23,-16,50,10,4
3,00:03:37,1,False,23,7,16,4,10,4
3,00:03:11,2,False,23,7,16,10,4,4
3,00:02:02,1,True,9,23,-14,50,10,4
3,00:00:39,1,False,23,9,14,47,10,4
3,00:00:00,1,False,23,9,14,35,10,4
4,00:13:38,2,True,16,23,-7,52,1,4
4,00:13:06,1,True,16,23,-7,50,10,4
4,00:12:34,1,True,16,23,-7,33,10,4
4,00:10:14,1,True,16,26,-10,50,10,4
4,00:09:11,1,False,26,16,10,50,10,4
4,00:08:38,2,False,26,16,10,46,6,4
4,00:07:21,1,False,26,16,10,10,10,4
4,00:05:40,1,True,23,26,-3,35,10,4
4,00:04:24,1,False,26,23,3,50,10,4
4,00:03:20,1,True,23,26,-3,47,10,4
4,00:02:53,1,True,23,26,-3,25,10,4
4,00:02:12,2,True,23,26,-3,16,1,4
4,00:01:52,1,True,23,26,-3,14,10,4
4,00:01:25,2,True,23,26,-3,9,5,4
4,00:01:01,1,True,23,33,-10,39,10,4
4,00:00:56,1,True,23,33,-10,29,10,4
1,00:13:23,1,True,0,0,0,35,10,4
1,00:12:20,1,True,0,0,0,6,10,4
1,00:10:47,1,True,0,0,0,32,10,4
1,00:07:37,2,False,0,3,-3,41,4,4
1,00:04:41,1,True,3,0,3,25,10,4
1,00:04:17,2,True,3,0,3,34,1,4
1,00:03:40,3,True,3,0,3,34,1,4
1,00:02:41,1,True,3,0,3,35,10,4
2,00:11:38,1,True,3,3,0,35,10,4
2,00:11:08,2,True,3,3,0,35,10,4
2,00:09:58,1,False,3,3,0,37,10,4
2,00:06:45,1,True,3,4,-1,35,10,4
2,00:05:49,1,True,3,4,-1,55,10,4
2,00:03:08,1,False,4,3,1,30,10,4
3,00:14:32,1,True,13,11,2,44,10,4
3,00:13:49,2,True,13,11,2,52,2,4
3,00:13:13,1,False,11,13,-2,51,10,4
3,00:12:41,2,False,11,13,-2,49,8,4
3,00:10:39,1,True,13,11,2,53,10,4
3,00:06:53,1,True,13,11,2,43,10,4
3,00:06:12,2,True,13,11,2,38,5,4
3,00:05:04,1,True,13,14,-1,35,10,4
3,00:01:49,2,False,14,13,1,41,10,4
3,00:00:01,1,True,13,14,-1,22,10,4
4,00:14:50,1,True,13,14,-1,11,10,4
4,00:11:42,1,False,17,13,4,44,10,4
4,00:09:38,1,True,13,17,-4,26,10,4
4,00:07:49,1,True,13,17,-4,5,5,4
4,00:07:18,1,True,13,24,-11,39,10,4
4,00:06:48,2,True,13,24,-11,46,3,4
4,00:04:59,1,False,24,13,11,11,10,4
4,00:03:48,1,True,13,24,-11,45,10,4
4,00:03:07,2,True,13,24,-11,37,2,4
4,00:02:02,1,True,13,24,-11,33,10,4
4,00:00:37,1,True,19,24,-5,37,10,4
4,00:00:25,2,True,19,24,-5,34,7,4
1,00:14:20,1,False,0,0,0,51,10,4
1,00:13:30,2,False,0,0,0,45,4,4
1,00:13:01,1,False,0,0,0,35,10,4
1,00:12:01,1,False,0,0,0,17,10,4
1,00:10:16,1,False,0,7,-7,13,10,4
1,00:09:05,1,False,0,7,-7,33,10,4
1,00:08:02,1,True,7,0,7,40,10,4
1,00:07:15,2,True,7,0,7,33,3,4
1,00:06:56,1,True,7,0,7,9,9,4
1,00:05:23,1,True,7,0,7,1,1,4
1,00:05:14,1,True,7,7,0,36,10,4
1,00:04:54,2,True,7,7,0,41,5,4
1,00:04:03,1,True,7,7,0,50,10,4
1,00:02:13,1,False,7,7,0,45,10,4
1,00:01:09,1,False,7,7,0,34,10,4
1,00:00:05,1,False,7,7,0,25,10,4
2,00:14:42,1,False,7,7,0,40,10,4
2,00:13:19,1,True,7,7,0,40,10,4
2,00:12:21,1,True,7,7,0,51,10,4
2,00:11:21,1,True,7,7,0,45,10,4
2,00:09:55,1,False,7,7,0,5,10,4
2,00:08:43,1,True,7,7,0,51,10,4
2,00:05:56,1,True,7,7,0,48,10,4
2,00:03:34,1,True,7,10,-3,35,10,4
2,00:01:54,1,True,7,10,-3,26,10,4
2,00:01:24,1,True,7,10,-3,14,10,4
2,00:00:21,1,True,7,13,-6,35,10,4
2,00:00:15,1,True,7,13,-6,43,15,4
3,00:14:41,1,False,13,7,6,31,10,4
3,00:10:49,1,False,20,7,13,55,10,4
3,00:08:31,1,True,7,23,-16,35,10,4
3,00:07:25,1,True,7,23,-16,46,10,4
3,00:06:15,1,False,23,7,16,53,10,4
3,00:01:23,2,False,23,10,13,38,3,4
3,00:01:00,3,False,23,10,13,40,1,4
3,00:00:30,1,False,23,10,13,42,10,4
4,00:15:00,2,False,23,10,13,51,1,4
4,00:12:06,1,False,23,17,6,35,10,4
4,00:08:16,1,False,23,17,6,16,10,4
4,00:07:14,3,False,23,17,6,26,0,4
4,00:04:45,2,True,17,23,-6,53,3,4
4,00:04:22,3,True,17,23,-6,51,1,4
4,00:01:55,1,False,23,17,6,55,10,4
4,00:01:49,2,True,17,23,-6,50,5,4
4,00:00:50,1,True,17,23,-6,36,15,4
4,00:00:45,2,True,17,23,-6,31,10,4
1,00:14:54,1,True,0,0,0,39,10,4
1,00:13:41,1,False,0,0,0,25,10,4
1,00:12:14,1,False,0,0,0,34,10,4
1,00:11:06,1,False,0,3,-3,35,10,4
1,00:10:38,2,False,0,3,-3,39,6,4
1,00:06:56,1,True,4,0,4,27,10,4
1,00:05:58,1,True,4,0,4,10,10,4
1,00:04:29,1,False,7,4,3,47,10,4
1,00:03:50,2,False,7,4,3,50,7,4
1,00:02:25,1,True,4,7,-3,41,10,4
2,00:14:03,2,True,4,7,-3,54,10,4
2,00:13:10,1,False,7,4,3,44,10,4
2,00:10:54,1,False,7,4,3,37,10,4
2,00:09:33,1,True,4,7,-3,27,10,4
2,00:08:34,1,False,7,4,3,6,6,4
2,00:07:14,1,False,7,7,0,17,20,4
2,00:05:40,1,False,7,7,0,48,10,4
2,00:05:00,1,False,7,7,0,33,10,4
2,00:04:18,2,False,7,7,0,24,1,4
2,00:02:51,1,True,14,7,7,36,10,4
2,00:02:42,2,True,14,7,7,28,2,4
2,00:02:21,1,True,14,7,7,26,10,4
2,00:01:38,3,True,14,7,7,16,0,4
2,00:00:31,1,True,14,10,4,9,9,4
3,00:12:31,1,False,13,14,-1,40,10,4
3,00:11:40,1,False,13,14,-1,55,10,4
3,00:10:36,1,True,14,13,1,36,10,4
3,00:09:50,2,True,14,13,1,40,6,4
3,00:07:19,1,False,13,17,-4,25,10,4
3,00:06:45,2,False,13,17,-4,33,2,4
3,00:05:37,3,False,13,17,-4,34,1,4
3,00:03:05,1,True,17,13,4,45,10,4
3,00:01:40,3,True,17,13,4,36,1,4
3,00:00:10,1,True,17,13,4,47,10,4
4,00:12:05,1,False,13,17,-4,25,10,4
4,00:09:17,1,True,17,20,-3,46,10,4
4,00:07:50,1,True,17,20,-3,39,10,4
4,00:03:47,1,True,17,28,-11,48,10,4
4,00:02:45,1,False,28,17,11,7,7,4
4,00:02:27,2,False,28,17,11,2,2,4
4,00:02:20,1,False,28,23,5,45,10,4
4,00:02:15,2,False,28,23,5,54,1,4
4,00:01:50,1,False,28,23,5,55,10,4
4,00:01:29,2,True,23,28,-5,46,1,4
4,00:01:25,1,True,23,28,-5,45,10,4
1,00:08:55,1,False,0,0,0,27,10,4
1,00:06:11,1,False,0,1,-1,35,10,4
1,00:04:47,1,True,1,0,1,44,10,4
1,00:04:09,1,True,1,0,1,54,10,4
1,00:01:42,1,False,0,1,-1,9,9,4
1,00:00:55,1,True,8,0,8,51,10,4
2,00:13:49,1,True,8,0,8,13,10,4
2,00:12:26,1,True,8,0,8,29,10,4
2,00:09:27,1,False,7,8,-1,30,10,4
2,00:07:25,1,True,15,14,1,35,10,4
2,00:05:02,1,True,15,14,1,43,10,4
2,00:02:46,1,True,15,14,1,32,10,4
2,00:02:30,2,True,15,14,1,40,2,4
2,00:00:16,1,True,15,14,1,29,10,4
3,00:13:43,1,True,15,14,1,43,10,4
3,00:12:57,2,True,15,14,1,35,2,4
3,00:12:25,1,True,15,14,1,28,10,4
3,00:10:08,1,True,15,17,-2,35,10,4
3,00:09:51,2,True,15,17,-2,43,2,4
3,00:08:35,1,False,17,15,2,36,10,4
3,00:07:59,2,False,17,15,2,26,0,4
3,00:07:06,1,False,17,15,2,25,10,4
3,00:06:22,1,False,17,22,-5,45,10,4
3,00:05:43,2,False,17,22,-5,53,2,4
3,00:01:20,1,True,22,24,-2,33,10,4
4,00:15:00,1,True,22,24,-2,54,10,4
4,00:10:27,1,False,27,22,5,45,10,4
4,00:09:10,1,False,27,22,5,25,10,4
4,00:07:03,1,False,27,25,2,51,10,4
4,00:02:06,2,False,34,25,9,15,3,4
4,00:01:32,1,False,34,25,9,44,10,4
4,00:01:03,1,True,25,34,-9,52,10,4
4,00:00:40,2,True,25,34,-9,45,2,4
1,00:14:55,1,True,0,0,0,36,10,4
1,00:14:11,1,True,0,0,0,48,10,4
1,00:12:52,1,False,0,0,0,41,10,4
1,00:12:02,1,False,0,0,0,25,10,4
1,00:10:50,1,False,0,7,-7,20,10,4
1,00:10:17,1,False,0,7,-7,31,10,4
1,00:09:14,1,True,7,0,7,21,10,4
1,00:08:17,2,True,7,0,7,23,8,4
1,00:06:35,2,False,0,7,-7,30,0,4
1,00:06:15,1,False,0,7,-7,31,10,4
1,00:05:53,2,False,0,7,-7,34,7,4
1,00:05:08,3,False,0,7,-7,40,1,4
1,00:02:23,1,True,7,0,7,16,10,4
1,00:01:19,1,True,7,3,4,49,10,4
1,00:00:35,1,False,3,7,-4,47,10,4
2,00:15:00,2,False,3,7,-4,27,1,4
2,00:13:44,2,False,3,7,-4,20,6,4
2,00:12:41,1,False,3,10,-7,42,10,4
2,00:11:28,1,True,10,3,7,16,10,4
2,00:10:53,2,True,10,3,7,21,5,4
2,00:10:22,1,True,10,3,7,30,10,4
2,00:09:43,1,True,10,3,7,42,10,4
2,00:08:00,1,False,3,10,-7,28,5,4
2,00:06:42,2,False,3,10,-7,43,9,4
2,00:06:04,1,True,10,3,7,26,10,4
2,00:05:45,1,False,3,10,-7,46,10,4
2,00:04:20,2,False,3,10,-7,30,8,4
2,00:03:35,2,False,3,10,-7,31,11,4
2,00:02:54,1,False,3,10,-7,25,10,4
2,00:02:37,2,False,3,10,-7,32,3,4
2,00:02:01,2,False,3,10,-7,43,3,4
2,00:01:40,1,False,3,10,-7,50,10,4
2,00:00:47,1,True,10,3,7,23,10,4
3,00:14:53,1,False,3,10,-7,40,10,4
3,00:14:12,2,False,3,10,-7,39,11,4
3,00:11:38,1,True,10,3,7,4,4,4
3,00:09:15,1,True,10,9,1,51,10,4
3,00:05:49,1,True,11,9,2,39,20,4
3,00:04:24,1,False,9,11,-2,23,10,4
3,00:03:29,1,False,9,11,-2,50,10,4
3,00:02:50,1,True,11,9,2,48,10,4
3,00:02:20,2,True,11,9,2,46,8,4
3,00:01:54,1,True,11,9,2,37,10,4
4,00:12:05,2,False,9,11,-2,45,6,4
4,00:11:23,3,False,9,11,-2,51,0,4
4,00:09:40,1,True,11,9,2,17,10,4
4,00:08:15,1,True,11,9,2,6,6,4
4,00:06:42,1,True,11,12,-1,25,10,4
4,00:05:20,1,True,11,15,-4,35,10,4
4,00:04:35,1,True,11,15,-4,20,10,4
4,00:02:21,1,True,11,18,-7,39,10,4
4,00:02:10,1,True,11,18,-7,53,10,4
4,00:00:51,1,False,18,11,7,17,10,4
4,00:00:46,2,False,18,11,7,23,4,4
1,00:12:30,1,False,0,0,0,39,10,4
1,00:11:14,1,False,0,3,-3,35,10,4
1,00:09:55,1,True,3,0,3,25,10,4
1,00:09:02,2,True,3,0,3,31,3,4
1,00:07:15,1,False,0,3,-3,39,10,4
1,00:05:42,2,False,0,3,-3,2,2,4
1,00:04:13,1,True,10,0,10,36,10,4
1,00:03:30,2,True,10,0,10,31,5,4
1,00:00:09,1,False,3,10,-7,28,10,4
2,00:14:00,1,True,10,3,7,52,10,4
2,00:11:34,3,False,3,10,-7,19,2,4
2,00:10:18,1,False,3,10,-7,10,10,4
2,00:09:50,1,False,3,17,-14,41,10,4
2,00:08:33,1,True,17,3,14,20,10,4
2,00:07:35,1,True,17,3,14,29,15,4
2,00:05:03,1,False,3,17,-14,40,10,4
2,00:04:20,2,False,3,17,-14,33,3,4
2,00:03:12,1,False,3,20,-17,35,10,4
2,00:02:54,2,False,3,20,-17,38,7,4
2,00:02:13,1,False,3,20,-17,46,10,4
2,00:00:49,2,False,3,20,-17,53,10,4
2,00:00:22,1,False,3,20,-17,10,10,4
2,00:00:16,2,False,3,20,-17,19,1,4
3,00:14:56,1,True,20,3,17,23,10,4
3,00:13:23,1,False,3,20,-17,30,10,4
3,00:12:55,1,False,3,20,-17,40,10,4
3,00:10:42,1,False,3,20,-17,12,10,4
3,00:09:42,2,False,3,20,-17,5,3,4
3,00:09:08,1,False,3,20,-17,1,1,4
3,00:07:37,2,True,27,3,24,34,2,4
3,00:03:30,2,False,3,27,-24,20,2,4
3,00:01:35,1,False,3,30,-27,35,10,4
3,00:01:15,2,False,3,30,-27,42,3,4
3,00:00:34,3,False,3,30,-27,45,0,4
4,00:14:24,1,True,30,3,27,20,10,4
4,00:13:06,1,True,30,3,27,32,10,4
4,00:12:29,2,True,30,3,27,35,7,4
4,00:11:54,1,True,30,3,27,43,10,4
4,00:08:46,1,False,3,37,-34,36,10,4
4,00:06:28,2,True,37,3,34,16,1,4
4,00:05:57,1,True,37,3,34,17,10,4
4,00:05:24,1,True,37,3,34,31,10,4
4,00:04:47,2,True,37,3,34,38,3,4
4,00:04:20,1,True,37,3,34,47,10,4
4,00:02:06,1,True,37,3,34,48,10,4
4,00:01:12,1,False,3,37,-34,37,10,4
4,00:00:44,2,False,3,37,-34,33,6,4
4,00:00:14,3,False,3,37,-34,29,2,4
1,00:14:15,2,False,0,0,0,36,5,4
1,00:12:39,1,True,0,0,0,21,10,4
1,00:12:05,1,True,0,0,0,33,10,4
1,00:09:03,2,False,0,0,0,27,1,4
1,00:08:21,1,False,0,0,0,29,10,4
1,00:05:55,1,False,0,0,0,54,10,4
1,00:03:52,2,True,0,0,0,18,13,4
1,00:03:09,1,True,0,3,-3,35,10,4
1,00:00:34,2,False,3,0,3,18,1,4
2,00:14:13,1,True,0,3,-3,41,10,4
2,00:13:30,2,True,0,3,-3,48,3,4
2,00:12:54,1,False,3,0,3,47,10,4
2,00:12:19,2,False,3,0,3,40,3,4
2,00:10:58,1,False,3,0,3,17,10,4
2,00:10:36,1,False,3,7,-4,41,10,4
2,00:10:02,2,False,3,7,-4,48,3,4
2,00:09:10,1,True,7,3,4,27,10,4
2,00:08:10,1,True,7,3,4,46,10,4
2,00:03:51,1,False,4,7,-3,48,10,4
2,00:02:42,1,True,7,4,3,15,10,4
2,00:02:32,2,True,7,4,3,22,3,4
3,00:14:49,1,False,11,7,4,41,10,4
3,00:14:17,2,False,11,7,4,51,0,4
3,00:13:08,1,True,7,11,-4,45,10,4
3,00:11:56,1,True,7,11,-4,14,10,4
3,00:11:28,1,True,7,11,-4,27,10,4
3,00:06:55,1,True,7,11,-4,28,10,4
3,00:05:50,3,True,7,11,-4,35,3,4
3,00:04:58,2,True,7,11,-4,29,2,4
3,00:02:15,2,True,7,14,-7,44,1,4
3,00:01:36,1,True,7,14,-7,47,10,4
3,00:01:02,2,True,7,14,-7,52,5,4
4,00:12:27,1,False,14,10,4,41,10,4
4,00:10:43,1,True,10,14,-4,32,10,4
4,00:08:16,2,False,14,17,-3,35,6,4
4,00:07:30,1,True,17,14,3,47,10,4
4,00:06:18,1,False,14,17,-3,28,10,4
4,00:03:55,1,True,17,14,3,48,10,4
4,00:01:48,1,False,14,17,-3,51,10,4
4,00:01:43,1,False,14,17,-3,39,10,4
4,00:01:37,2,False,14,17,-3,30,1,4
4,00:01:15,1,False,14,17,-3,27,10,4
4,00:00:53,2,False,14,17,-3,21,4,4
1,00:14:50,1,False,0,0,0,46,10,4
1,00:11:52,1,False,0,0,0,48,10,4
1,00:05:52,2,False,0,14,-14,43,2,4
1,00:02:52,1,True,14,0,14,46,10,4
1,00:01:09,1,False,0,14,-14,35,10,4
2,00:14:37,1,False,0,17,-17,35,10,4
2,00:12:55,1,True,17,0,17,12,10,4
2,00:11:21,1,True,17,0,17,52,10,4
2,00:10:08,1,True,17,0,17,14,10,4
2,00:08:50,1,True,17,0,17,30,10,4
2,00:05:40,1,False,0,17,-17,23,10,4
2,00:03:13,1,False,0,20,-20,35,10,4
2,00:02:22,1,True,20,0,20,33,10,4
2,00:01:34,2,True,20,0,20,45,10,4
2,00:00:14,3,False,0,20,-20,38,1,4
3,00:13:48,2,True,20,1,19,54,1,4
3,00:12:55,1,False,1,20,-19,54,10,4
3,00:07:15,1,False,1,20,-19,14,10,4
3,00:04:42,2,False,1,20,-19,49,1,4
3,00:04:13,1,False,1,20,-19,51,10,4
3,00:03:48,1,True,20,1,19,48,10,4
3,00:01:11,1,False,2,20,-18,18,10,4
3,00:00:04,3,False,2,20,-18,28,0,4
4,00:15:00,1,False,2,20,-18,30,10,4
4,00:13:22,1,True,20,2,18,25,10,4
4,00:10:48,1,True,20,5,15,53,10,4
4,00:10:08,2,False,5,20,-15,49,2,4
4,00:09:38,3,False,5,20,-15,47,0,4
4,00:05:58,1,True,23,5,18,53,20,4
4,00:03:08,1,True,23,5,18,7,10,4
4,00:02:46,2,True,23,5,18,10,7,4
4,00:01:34,2,False,5,23,-18,52,10,4
4,00:00:20,3,False,5,23,-18,53,1,4
1,00:13:03,1,True,0,0,0,18,10,4
1,00:11:04,1,True,0,3,-3,33,10,4
1,00:10:30,1,True,0,3,-3,54,10,4
1,00:08:16,1,False,3,0,3,15,10,4
1,00:07:01,1,False,3,3,0,33,10,4
1,00:06:27,2,False,3,3,0,41,2,4
1,00:02:35,1,True,3,3,0,42,10,4
1,00:00:01,1,False,3,3,0,51,10,4
2,00:12:59,1,True,3,10,-7,43,10,4
2,00:12:21,1,False,10,3,7,50,10,4
2,00:08:45,1,False,10,6,4,48,10,4
2,00:07:24,2,False,10,6,4,46,2,4
2,00:05:44,1,False,10,6,4,43,10,4
2,00:03:01,1,True,6,10,-4,1,1,4
2,00:00:15,1,True,13,24,-11,16,10,4
3,00:14:54,1,True,13,24,-11,27,10,4
3,00:14:14,2,True,13,24,-11,34,3,4
3,00:12:43,1,False,24,13,11,45,10,4
3,00:08:52,1,False,24,13,11,19,10,4
3,00:07:37,1,False,24,13,11,26,10,4
3,00:05:12,1,True,16,24,-8,45,10,4
3,00:02:21,1,True,16,27,-11,35,10,4
3,00:02:01,2,True,16,27,-11,43,2,4
3,00:00:36,1,False,27,16,11,49,10,4
4,00:14:16,1,True,16,27,-11,50,10,4
4,00:11:00,2,True,16,30,-14,35,10,4
4,00:10:22,1,True,16,30,-14,49,10,4
4,00:05:45,1,False,30,16,14,55,10,4
4,00:03:00,2,True,16,30,-14,13,1,4
4,00:02:49,1,True,16,30,-14,11,10,4
4,00:02:14,2,True,16,33,-17,44,1,4
4,00:01:19,1,False,33,16,17,32,10,4
4,00:01:14,2,False,33,16,17,33,9,4
4,00:00:14,2,True,16,33,-17,23,12,4
1,00:14:54,1,True,0,0,0,37,10,4
1,00:11:57,1,False,0,3,-3,35,10,4
1,00:09:59,1,False,0,3,-3,54,10,4
1,00:09:26,2,False,0,3,-3,48,4,4
1,00:08:12,2,False,0,4,-4,41,4,4
1,00:07:44,3,False,0,4,-4,45,0,4
1,00:07:17,1,False,0,4,-4,46,10,4
1,00:05:44,1,True,4,0,4,30,10,4
1,00:03:57,2,False,0,4,-4,49,1,4
1,00:03:17,3,False,0,4,-4,49,1,4
1,00:01:52,2,False,0,4,-4,42,5,4
1,00:01:09,1,False,0,4,-4,37,10,4
1,00:00:01,1,False,0,4,-4,26,10,4
2,00:13:30,2,False,0,4,-4,30,15,4
2,00:12:29,1,True,4,0,4,54,10,4
2,00:11:53,2,False,0,4,-4,49,3,4
2,00:07:13,1,True,11,0,11,19,10,4
2,00:06:03,1,True,11,3,8,35,10,4
2,00:03:15,1,True,11,3,8,27,10,4
2,00:02:28,2,True,11,6,5,37,8,4
2,00:01:40,2,False,6,11,-5,39,1,4
2,00:01:01,2,False,6,11,-5,41,10,4
2,00:00:28,1,True,11,6,5,34,10,4
2,00:00:05,1,True,11,6,5,49,10,4
3,00:11:10,1,False,6,11,-5,24,10,4
3,00:10:33,2,False,6,11,-5,16,2,4
3,00:07:20,1,True,14,6,8,46,10,4
3,00:04:21,1,False,6,14,-8,23,10,4
3,00:03:06,1,True,14,6,8,53,10,4
3,00:02:15,1,False,6,14,-8,44,10,4
3,00:01:18,1,False,6,14,-8,29,10,4
3,00:00:01,1,False,6,14,-8,15,10,4
4,00:15:00,2,False,6,14,-8,8,3,4
4,00:11:42,1,False,6,21,-15,35,10,4
4,00:08:20,1,True,21,6,15,5,5,4
4,00:06:54,1,True,21,9,12,38,10,4
4,00:03:36,1,False,9,21,-12,6,6,4
4,00:01:42,1,False,9,28,-19,50,10,4
4,00:01:30,2,False,9,28,-19,50,10,4
1,00:14:40,2,False,0,0,0,45,1,4
1,00:13:43,1,True,0,0,0,46,10,4
1,00:10:37,2,True,0,1,-1,47,10,4
1,00:10:15,1,False,1,0,1,42,10,4
1,00:07:34,1,False,1,0,1,5,10,4
1,00:06:27,1,False,1,0,1,51,10,4
1,00:02:39,1,True,0,1,-1,14,10,4
1,00:01:49,2,True,0,1,-1,23,1,4
1,00:01:12,1,True,0,1,-1,42,10,4
1,00:00:44,2,True,0,1,-1,50,2,4
1,00:00:01,1,False,1,0,1,32,10,4
2,00:14:26,2,False,1,0,1,23,1,4
2,00:12:48,2,False,1,0,1,1,1,4
2,00:11:50,1,True,7,1,6,24,10,4
2,00:10:32,1,False,1,7,-6,42,10,4
2,00:09:41,1,True,7,1,6,28,10,4
2,00:09:04,2,True,7,1,6,23,5,4
2,00:08:31,3,True,7,1,6,19,1,4
2,00:05:08,1,True,7,4,3,38,25,4
2,00:03:11,1,False,4,10,-6,35,10,4
2,00:02:37,1,True,10,4,6,46,10,4
2,00:01:16,2,False,4,10,-6,40,10,4
2,00:00:45,1,False,4,10,-6,18,10,4
2,00:00:33,1,False,4,16,-12,19,10,4
2,00:00:12,2,False,4,16,-12,16,13,4
3,00:14:55,1,True,16,4,12,35,10,4
3,00:13:34,1,True,16,4,12,47,10,4
3,00:10:29,1,False,4,23,-19,55,10,4
3,00:09:49,2,True,23,4,19,46,1,4
3,00:08:45,2,True,23,4,19,38,4,4
3,00:08:16,1,True,23,4,19,33,10,4
3,00:07:09,2,True,23,4,19,24,1,4
3,00:06:35,1,True,23,4,19,22,10,4
3,00:06:04,2,True,23,4,19,15,3,4
3,00:05:10,1,True,23,7,16,35,10,4
3,00:04:44,2,True,23,7,16,36,9,4
3,00:03:43,1,False,7,23,-16,13,10,4
3,00:01:49,1,False,7,23,-16,39,10,4
3,00:01:06,2,False,7,23,-16,35,6,4
4,00:14:50,3,False,7,24,-17,45,0,4
4,00:12:06,1,True,24,7,17,32,10,4
4,00:11:17,1,True,24,7,17,47,10,4
4,00:09:36,2,False,7,24,-17,51,1,4
4,00:03:40,1,True,24,10,14,3,3,4
4,00:03:11,2,True,24,10,14,2,2,4
4,00:02:45,1,True,24,17,7,35,10,4
4,00:02:38,2,True,24,17,7,33,12,4
4,00:01:44,1,False,17,24,-7,43,10,4
4,00:01:38,2,False,17,24,-7,39,6,4
1,00:14:30,2,False,0,0,0,35,2,4
1,00:13:55,1,False,0,0,0,40,10,4
1,00:13:22,2,False,0,0,0,49,2,4
1,00:12:49,1,False,0,0,0,53,10,4
1,00:12:13,2,True,0,0,0,50,3,4
1,00:11:40,1,True,0,0,0,44,10,4
1,00:10:10,1,True,0,0,0,34,10,4
1,00:07:43,1,False,0,0,0,53,10,4
1,00:07:03,2,False,0,0,0,44,1,4
1,00:06:25,1,False,0,0,0,43,10,4
1,00:04:56,1,False,0,1,-1,35,10,4
1,00:02:08,2,True,1,0,1,29,12,4
2,00:14:42,1,False,0,1,-1,23,10,4
2,00:13:36,1,False,0,1,-1,30,10,4
2,00:11:55,1,True,1,0,1,43,10,4
2,00:11:20,2,True,1,0,1,50,3,4
2,00:10:27,1,False,0,1,-1,26,10,4
2,00:09:22,1,True,1,0,1,55,10,4
2,00:04:58,1,False,0,8,-8,42,10,4
2,00:03:22,2,True,8,0,8,34,10,4
2,00:02:30,1,True,8,3,5,40,10,4
2,00:02:10,1,True,8,3,5,53,10,4
2,00:00:20,1,False,3,15,-12,10,10,4
3,00:14:54,1,True,15,3,12,32,10,4
3,00:13:40,1,True,15,3,12,45,10,4
3,00:12:33,1,False,3,15,-12,35,10,4
3,00:11:57,2,False,3,15,-12,27,2,4
3,00:11:20,1,False,3,15,-12,19,10,4
3,00:10:45,2,False,3,15,-12,12,3,4
3,00:09:35,1,False,3,15,-12,2,2,4
3,00:08:38,2,False,3,22,-19,41,2,4
3,00:07:45,1,True,22,3,19,52,10,4
3,00:06:51,1,True,22,3,19,50,10,4
3,00:06:25,2,False,3,22,-19,53,3,4
3,00:05:43,1,False,3,22,-19,33,10,4
3,00:04:19,1,False,3,22,-19,3,3,4
3,00:02:40,1,False,3,29,-26,3,3,4
3,00:01:59,2,False,3,29,-26,1,1,4
3,00:00:48,1,False,3,36,-33,51,10,4
4,00:15:00,3,True,36,3,33,50,1,4
4,00:12:58,1,True,36,3,33,46,10,4
4,00:10:28,1,False,3,50,-47,31,10,4
4,00:08:39,1,False,3,50,-47,50,10,4
4,00:05:09,1,True,50,3,47,14,15,4
4,00:04:46,2,True,50,3,47,11,14,4
4,00:03:10,1,True,50,3,47,45,10,4
4,00:02:53,1,True,50,3,47,13,10,4
4,00:02:05,1,True,50,11,39,40,10,4
4,00:01:41,2,True,50,11,39,35,15,4
4,00:00:40,1,True,50,17,33,5,0,4
1,00:14:54,1,True,0,0,0,31,10,4
1,00:12:22,1,False,0,0,0,53,10,4
1,00:10:38,1,False,0,7,-7,32,20,4
1,00:08:05,1,True,7,0,7,46,10,4
1,00:07:04,1,True,7,1,6,35,10,4
1,00:04:57,2,False,1,7,-6,24,3,4
1,00:04:04,3,False,1,7,-6,26,1,4
1,00:03:39,1,False,1,7,-6,28,10,4
1,00:03:00,1,False,1,7,-6,44,10,4
1,00:01:52,2,True,7,1,6,47,1,4
2,00:13:50,1,False,1,7,-6,3,3,4
2,00:13:17,2,False,1,7,-6,2,2,4
2,00:13:01,1,False,1,14,-13,35,10,4
2,00:11:30,2,False,1,14,-13,31,10,4
2,00:08:37,1,False,1,22,-21,29,10,4
2,00:06:03,1,True,22,1,21,26,10,4
2,00:01:41,1,True,22,4,18,45,10,4
3,00:14:54,1,False,4,29,-25,27,10,4
3,00:13:27,1,True,29,4,25,43,10,4
3,00:11:19,1,False,4,29,-25,34,10,4
3,00:07:18,2,True,36,4,32,5,0,4
3,00:05:46,1,True,36,11,25,15,10,4
3,00:05:19,2,True,36,11,25,23,2,4
3,00:04:23,1,False,11,36,-25,45,10,4
3,00:02:53,1,True,36,18,18,30,10,4
3,00:00:50,2,False,18,36,-18,55,1,4
4,00:09:44,1,True,36,18,18,28,10,4
4,00:07:55,2,False,18,36,-18,27,10,4
4,00:07:09,1,True,36,18,18,46,10,4
4,00:06:24,1,False,18,36,-18,53,10,4
4,00:03:47,1,False,18,36,-18,16,10,4
4,00:02:59,2,False,18,36,-18,10,4,4
4,00:02:18,1,False,18,36,-18,2,2,4
4,00:01:47,1,False,18,43,-25,45,10,4
4,00:01:39,2,False,18,43,-25,40,5,4
1,00:14:12,2,False,0,0,0,35,3,4
1,00:13:24,1,False,0,0,0,38,10,4
1,00:12:37,1,False,0,0,0,51,10,4
1,00:11:22,1,True,0,0,0,22,10,4
1,00:08:51,0,False,0,0,0,52,0,4
1,00:05:12,1,False,0,0,0,1,1,4
1,00:04:56,1,False,0,7,-7,29,10,4
1,00:02:49,1,False,0,7,-7,54,10,4
1,00:00:08,2,False,0,7,-7,27,1,4
2,00:13:14,1,False,0,14,-14,47,10,4
2,00:11:21,1,True,14,0,14,29,10,4
2,00:09:12,2,False,0,14,-14,31,2,4
2,00:03:12,2,False,0,14,-14,12,3,4
2,00:03:00,3,False,0,14,-14,10,1,4
2,00:02:09,1,False,0,17,-17,46,10,4
2,00:01:10,2,True,17,7,10,47,2,4
2,00:00:29,1,False,7,17,-10,24,10,4
2,00:00:24,2,False,7,17,-10,30,4,4
3,00:14:09,1,True,17,7,10,50,10,4
3,00:11:28,2,False,7,17,-10,48,14,4
3,00:06:49,1,False,7,17,-10,35,10,4
3,00:06:02,2,False,7,17,-10,32,7,4
3,00:05:38,1,False,7,17,-10,17,10,4
3,00:02:48,1,True,20,7,13,25,10,4
3,00:01:43,1,True,20,7,13,26,10,4
4,00:13:09,1,True,20,7,13,23,10,4
4,00:10:26,2,True,20,10,10,40,0,4
4,00:07:42,2,True,20,10,10,18,2,4
4,00:06:59,1,True,20,10,10,3,3,4
4,00:06:17,2,True,20,10,10,2,2,4
4,00:05:35,1,True,20,13,7,35,10,4
4,00:01:55,1,True,20,16,4,47,10,4
1,00:14:56,1,True,0,0,0,37,10,4
1,00:14:25,2,True,0,0,0,46,1,4
1,00:11:43,1,False,0,3,-3,35,10,4
1,00:08:55,1,False,0,3,-3,22,10,4
1,00:08:12,2,False,0,3,-3,23,9,4
1,00:06:09,1,False,0,3,-3,29,10,4
1,00:05:02,1,False,0,3,-3,39,10,4
1,00:03:24,1,True,6,0,6,45,10,4
1,00:02:00,1,False,0,6,-6,50,10,4
1,00:01:32,2,False,0,6,-6,45,5,4
1,00:01:03,3,False,0,6,-6,42,2,4
2,00:14:44,1,False,0,7,-7,35,10,4
2,00:13:31,1,False,0,7,-7,44,10,4
2,00:09:55,2,False,0,7,-7,25,4,4
2,00:07:59,1,False,0,10,-10,36,10,4
2,00:06:14,1,False,0,17,-17,46,10,4
2,00:01:32,1,True,17,0,17,16,10,4
2,00:00:38,1,True,17,7,10,42,10,4
2,00:00:15,2,True,17,7,10,55,8,4
3,00:12:02,1,False,7,17,-10,55,10,4
3,00:08:39,1,False,7,17,-10,54,10,4
3,00:08:24,1,False,7,17,-10,37,10,4
3,00:06:13,2,False,7,18,-11,35,10,4
3,00:03:20,2,True,18,7,11,43,13,4
3,00:01:23,1,True,18,10,8,35,10,4
4,00:14:28,1,True,18,10,8,51,10,4
4,00:13:56,2,True,18,10,8,55,6,4
4,00:10:48,2,True,18,10,8,20,2,4
4,00:10:19,3,True,18,10,8,22,0,4
4,00:06:50,1,True,18,10,8,53,10,4
4,00:05:22,3,False,10,18,-8,47,0,4
4,00:04:47,1,False,10,18,-8,45,10,4
4,00:01:10,1,True,18,10,8,48,10,4
1,00:13:54,1,True,0,0,0,24,10,4
1,00:13:16,2,True,0,0,0,32,2,4
1,00:12:42,1,True,0,0,0,36,10,4
1,00:10:40,2,False,0,0,0,53,1,4
1,00:10:09,1,False,0,0,0,55,10,4
1,00:08:51,1,True,0,0,0,40,10,4
1,00:05:29,1,False,7,0,7,35,10,4
1,00:02:45,1,False,7,0,7,27,10,4
1,00:00:07,1,True,3,7,-4,29,10,4
2,00:15:00,1,True,3,7,-4,53,10,4
2,00:13:26,1,False,7,3,4,13,10,4
2,00:12:32,1,False,7,3,4,20,10,4
2,00:11:09,1,False,7,3,4,5,5,4
2,00:10:14,2,False,7,10,-3,32,3,4
2,00:08:04,1,True,10,7,3,48,10,4
2,00:06:29,1,True,10,7,3,31,10,4
2,00:00:21,1,False,14,20,-6,30,10,4
2,00:00:17,2,False,14,20,-6,32,8,4
3,00:14:55,1,False,14,20,-6,37,10,4
3,00:14:12,2,False,14,20,-6,45,2,4
3,00:11:25,1,True,20,14,6,21,10,4
3,00:08:37,1,False,14,20,-6,38,10,4
3,00:07:35,1,False,14,20,-6,17,10,4
3,00:07:14,1,False,14,20,-6,6,6,4
3,00:06:10,2,False,14,20,-6,3,3,4
3,00:04:58,2,False,14,27,-13,38,1,4
3,00:04:15,1,True,27,14,13,52,10,4
3,00:03:05,3,True,27,14,13,43,1,4
3,00:01:57,1,True,27,14,13,26,10,4
4,00:14:19,2,False,17,27,-10,49,10,4
4,00:13:19,1,True,27,17,10,33,10,4
4,00:11:15,2,False,17,27,-10,33,6,4
4,00:09:25,0,False,24,27,-3,54,0,4
4,00:08:38,2,False,24,27,-3,49,3,4
4,00:02:21,1,False,24,37,-13,25,10,4
4,00:02:14,2,False,24,37,-13,20,5,4
4,00:01:36,1,False,24,40,-16,45,10,4
4,00:01:11,2,False,24,40,-16,44,9,4
4,00:01:07,3,False,24,40,-16,36,1,4
1,00:12:47,1,True,0,0,0,18,10,4
1,00:10:50,2,True,0,0,0,49,1,4
1,00:09:24,1,True,0,0,0,10,15,4
1,00:08:28,1,True,0,0,0,30,10,4
1,00:07:57,2,True,0,0,0,34,6,4
1,00:07:23,1,True,0,0,0,40,10,4
1,00:04:40,1,True,7,0,7,47,10,4
1,00:04:08,2,True,7,0,7,42,5,4
1,00:01:57,3,True,7,0,7,49,1,4
2,00:14:03,1,False,0,7,-7,35,10,4
2,00:12:49,1,True,7,0,7,55,10,4
2,00:08:33,1,False,0,10,-10,36,10,4
2,00:06:04,1,False,0,10,-10,31,10,4
2,00:02:12,2,False,0,20,-20,48,10,4
2,00:01:28,1,False,0,20,-20,8,10,4
2,00:01:20,1,False,0,20,-20,20,10,4
2,00:00:15,2,False,0,20,-20,38,9,4
3,00:08:57,1,False,0,27,-27,1,1,4
3,00:06:51,1,True,34,0,34,45,10,4
3,00:06:27,2,True,34,0,34,54,1,4
3,00:05:26,1,False,0,34,-34,35,10,4
3,00:01:30,1,False,0,34,-34,53,10,4
4,00:12:22,2,False,7,34,-27,35,4,4
4,00:11:47,1,False,7,34,-27,31,10,4
4,00:09:53,1,False,7,37,-30,29,10,4
4,00:04:31,1,True,37,7,30,13,10,4
4,00:04:05,2,True,37,7,30,14,9,4
4,00:01:58,1,True,37,10,27,35,10,4
4,00:01:54,2,True,37,10,27,39,6,4
4,00:01:00,2,True,37,10,27,33,10,4
1,00:13:42,1,False,0,0,0,43,10,4
1,00:12:32,1,True,0,0,0,34,10,4
1,00:11:18,1,True,0,0,0,53,10,4
1,00:09:46,1,False,0,0,0,22,10,4
1,00:05:45,1,False,0,0,0,3,3,4
1,00:04:46,1,False,0,6,-6,44,10,4
1,00:03:37,1,True,6,0,6,19,10,4
1,00:02:08,1,True,6,0,6,32,10,4
1,00:01:04,2,True,6,0,6,14,3,4
2,00:15:00,1,True,6,3,3,35,10,4
2,00:14:11,1,False,3,6,-3,43,10,4
2,00:12:45,2,True,6,3,3,45,0,4
2,00:07:21,1,True,6,6,0,38,10,4
2,00:06:17,1,True,6,6,0,21,10,4
2,00:02:20,2,True,6,6,0,42,1,4
2,00:00:54,1,True,6,6,0,31,10,4
3,00:14:27,2,False,13,6,7,24,10,4
3,00:13:23,1,True,6,13,-7,43,10,4
3,00:11:35,1,False,13,7,6,35,10,4
3,00:08:40,2,True,7,13,-6,47,4,4
3,00:07:21,2,True,7,13,-6,21,10,4
3,00:06:58,1,False,20,7,13,51,10,4
3,00:05:13,1,False,20,7,13,1,1,4
3,00:02:51,2,True,14,20,-6,39,1,4
3,00:00:02,2,True,14,27,-13,37,1,4
4,00:13:00,1,False,27,14,13,42,10,4
4,00:11:26,1,True,14,27,-13,38,10,4
4,00:10:32,2,True,14,27,-13,29,1,4
4,00:10:07,1,True,14,27,-13,17,10,4
4,00:08:52,1,True,14,27,-13,1,1,4
4,00:06:09,1,False,34,14,20,1,1,4
4,00:05:32,2,False,34,14,20,1,1,4
4,00:05:06,1,False,34,20,14,26,10,4
4,00:04:12,1,False,34,20,14,32,10,4
4,00:02:11,1,False,34,27,7,15,10,4
4,00:01:03,1,True,27,34,-7,52,10,4
4,00:00:58,2,True,27,34,-7,52,10,4
1,00:14:06,2,True,0,0,0,30,10,4
1,00:11:37,1,False,0,0,0,35,10,4
1,00:09:44,1,True,0,0,0,53,10,4
1,00:07:19,1,False,0,0,0,13,10,4
1,00:10:50,1,False,0,0,0,47,10,4
1,00:10:15,1,False,0,0,0,37,10,4
1,00:07:00,1,False,0,0,0,5,10,4
1,00:04:07,1,False,0,0,0,30,10,4
1,00:00:22,2,False,1,0,1,46,3,4
2,00:13:47,1,True,0,1,-1,39,10,4
2,00:13:10,2,True,0,1,-1,47,2,4
2,00:11:35,2,True,0,1,-1,40,0,4
2,00:11:02,1,True,0,1,-1,37,10,4
2,00:10:37,1,True,0,1,-1,25,10,4
2,00:08:41,2,True,0,4,-4,40,5,4
2,00:07:30,1,True,0,4,-4,51,10,4
2,00:06:37,1,False,4,0,4,53,10,4
2,00:05:04,1,False,4,0,4,22,10,4
2,00:01:08,1,True,3,12,-9,1,10,4
2,00:00:46,1,True,3,12,-9,16,10,4
2,00:00:05,2,True,3,12,-9,23,17,4
3,00:14:48,1,False,12,3,9,37,10,4
3,00:13:40,1,True,3,12,-9,53,10,4
3,00:11:30,1,True,3,12,-9,31,10,4
3,00:09:16,1,False,12,3,9,54,10,4
3,00:05:56,1,True,3,12,-9,36,10,4
3,00:04:50,1,True,3,12,-9,20,10,4
3,00:04:20,2,True,3,12,-9,16,6,4
3,00:03:26,1,True,3,12,-9,10,10,4
3,00:02:54,1,True,3,19,-16,36,10,4
3,00:14:54,1,False,19,3,16,8,17,4
4,00:14:47,1,False,19,3,16,44,10,4
4,00:12:55,1,True,3,19,-16,38,10,4
1,00:14:17,1,False,0,0,0,34,10,4
1,00:12:53,1,False,0,0,0,3,3,4
1,00:12:20,2,False,0,0,0,2,2,4
1,00:11:04,3,False,0,0,0,1,1,4
1,00:10:43,1,False,0,7,-7,30,10,4
1,00:10:14,2,False,0,7,-7,36,4,4
1,00:09:53,1,False,0,7,-7,44,10,4
1,00:08:47,1,True,7,0,7,41,10,4
1,00:08:07,2,True,7,0,7,35,4,4
1,00:06:56,1,True,7,3,4,34,10,4
1,00:05:11,1,False,3,7,-4,24,10,4
1,00:04:47,2,False,3,7,-4,28,6,4
1,00:04:10,1,False,3,7,-4,35,10,4
2,00:11:54,1,True,7,3,4,17,10,4
2,00:04:10,1,True,7,20,-13,37,10,4
2,00:02:27,1,False,20,7,13,34,10,4
3,00:14:50,1,True,7,22,-15,34,10,4
3,00:13:40,3,True,7,22,-15,30,6,4
3,00:13:05,1,True,7,22,-15,23,10,4
3,00:12:12,1,True,7,22,-15,9,9,4
3,00:10:34,1,True,7,30,-23,33,10,4
3,00:10:14,2,True,7,30,-23,35,8,4
3,00:09:35,1,True,7,30,-23,44,10,4
3,00:08:59,2,True,7,30,-23,53,1,4
3,00:08:05,1,True,7,30,-23,55,15,4
3,00:06:11,1,False,30,7,23,47,10,4
3,00:05:45,2,False,30,7,23,54,3,4
3,00:02:27,1,False,30,7,23,5,10,4
3,00:00:46,1,False,30,7,23,24,10,4
4,00:14:24,1,False,30,10,20,30,15,4
4,00:12:46,1,False,30,10,20,54,10,4
4,00:11:25,1,False,30,10,20,11,10,4
4,00:09:31,1,False,30,10,20,8,15,4
4,00:07:57,1,True,10,30,-20,34,10,4
4,00:07:28,2,True,10,30,-20,35,9,4
4,00:04:35,1,True,10,30,-20,26,10,4
4,00:04:09,2,True,10,30,-20,22,6,4
4,00:03:04,1,True,10,30,-20,20,10,4
4,00:02:18,1,False,30,10,20,52,10,4
4,00:01:44,2,False,30,10,20,50,12,4
4,00:01:01,2,True,10,30,-20,44,1,4
4,00:00:08,1,False,30,10,20,34,10,4
4,00:00:01,2,False,30,10,20,30,6,4
1,00:11:35,1,False,7,0,7,7,10,4
1,00:10:53,2,False,7,0,7,2,2,4
1,00:09:47,1,False,7,0,7,1,1,4
1,00:08:47,2,False,7,0,7,1,1,4
1,00:08:27,1,False,7,7,0,18,10,4
1,00:04:07,2,True,7,10,-3,37,3,4
1,00:03:25,1,True,7,10,-3,41,10,4
1,00:00:30,1,False,10,7,3,50,10,4
2,00:14:29,2,True,7,10,-3,23,4,4
2,00:13:51,1,True,7,10,-3,19,10,4
2,00:12:07,1,True,7,13,-6,37,5,4
2,00:09:38,2,True,7,13,-6,47,2,4
2,00:07:37,2,True,7,13,-6,12,2,4
2,00:05:57,1,True,7,13,-6,8,8,4
2,00:02:45,1,True,7,20,-13,54,10,4
2,00:00:47,2,True,7,20,-13,52,2,4
3,00:14:54,1,True,7,20,-13,30,10,4
3,00:14:28,2,True,7,20,-13,36,4,4
3,00:10:53,1,True,7,20,-13,17,10,4
3,00:04:33,2,False,23,7,16,52,3,4
3,00:00:01,2,False,23,7,16,32,1,4
4,00:15:00,1,False,23,7,16,30,10,4
4,00:13:56,1,False,23,7,16,2,2,4
4,00:07:40,1,False,26,13,13,38,10,4
4,00:05:57,1,True,13,26,-13,43,10,4
4,00:04:59,2,False,26,13,13,50,10,4
4,00:01:07,1,False,26,15,11,52,10,4
1,00:11:30,1,False,0,6,-6,26,10,4
1,00:10:28,1,True,6,0,6,27,10,4
1,00:09:17,3,True,6,0,6,19,2,4
1,00:08:22,1,True,6,0,6,9,5,4
1,00:07:01,1,True,6,3,3,35,10,4
1,00:05:41,1,False,3,6,-3,25,10,4
1,00:01:19,2,True,6,3,3,50,1,4
2,00:14:04,1,False,3,6,-3,1,1,4
2,00:13:32,1,True,13,3,10,28,10,4
2,00:13:06,2,True,13,3,10,21,3,4
2,00:12:31,1,True,13,3,10,15,10,4
2,00:09:49,1,False,10,13,-3,41,10,4
2,00:09:31,2,False,10,13,-3,38,7,4
2,00:04:03,1,True,19,10,9,40,10,4
2,00:02:14,1,True,19,10,9,38,10,4
3,00:10:42,1,True,19,16,3,46,10,4
3,00:09:52,2,True,19,16,3,55,1,4
3,00:05:34,1,True,19,16,3,50,10,4
3,00:04:17,1,False,16,19,-3,43,10,4
4,00:14:02,1,True,27,16,11,1,1,4
4,00:00:36,1,True,30,30,0,1,1,4
1,00:13:35,1,False,0,0,0,43,10,4
1,00:13:03,2,False,0,0,0,37,4,4
1,00:11:24,1,False,0,0,0,5,5,4
1,00:09:15,1,True,6,0,6,36,10,4
1,00:06:17,2,False,0,6,-6,52,4,4
1,00:05:33,1,True,6,0,6,53,10,4
1,00:04:13,1,True,6,0,6,10,10,4
1,00:00:21,1,False,0,6,-6,37,10,4
2,00:07:55,1,False,5,6,-1,16,10,4
2,00:07:38,2,False,5,6,-1,7,1,4
2,00:07:02,1,False,5,6,-1,5,5,4
2,00:05:19,1,False,5,13,-8,27,10,4
2,00:03:12,1,True,13,5,8,26,10,4
2,00:02:37,1,False,5,13,-8,40,10,4
2,00:01:35,1,True,13,5,8,17,10,4
2,00:00:30,1,False,5,13,-8,17,10,4
2,00:00:25,2,False,5,13,-8,19,8,4
3,00:14:59,1,False,5,13,-8,25,10,4
3,00:13:50,3,False,5,13,-8,32,3,4
3,00:13:18,1,False,5,13,-8,41,10,4
3,00:11:00,1,True,13,5,8,26,10,4
3,00:10:20,2,True,13,5,8,18,2,4
3,00:10:04,3,True,13,5,8,17,1,4
3,00:07:45,1,True,13,13,0,28,10,4
3,00:06:35,1,False,13,13,0,22,10,4
3,00:04:36,1,False,13,13,0,49,10,4
3,00:03:00,1,False,13,13,0,39,10,4
4,00:15:00,2,True,16,13,3,51,4,4
4,00:13:22,1,True,16,13,3,45,10,4
4,00:11:53,1,True,16,13,3,16,10,4
4,00:10:20,1,True,16,13,3,6,6,4
4,00:07:53,2,False,20,16,4,44,10,4
4,00:03:47,1,False,20,16,4,5,10,4
4,00:02:40,1,False,20,16,4,34,10,4
4,00:01:52,1,False,20,16,4,50,10,4
4,00:01:30,2,False,20,16,4,51,9,4
4,00:01:03,1,True,16,20,-4,49,10,4
4,00:00:59,2,True,16,20,-4,47,8,4
4,00:00:54,1,True,16,20,-4,38,10,4
4,00:00:31,2,True,16,20,-4,37,9,4
1,00:14:38,1,True,0,0,0,7,10,4
1,00:13:46,1,True,0,0,0,29,10,4
1,00:12:27,1,True,0,0,0,44,10,4
1,00:11:03,1,False,0,0,0,45,10,4
1,00:09:56,1,True,0,7,-7,25,10,4
1,00:07:18,1,False,7,0,7,42,10,4
1,00:00:35,1,True,7,15,-8,35,10,4
1,00:00:01,2,True,7,15,-8,41,4,4
2,00:13:19,1,False,15,7,8,21,10,4
2,00:12:01,1,False,15,7,8,31,10,4
2,00:03:40,2,False,15,10,5,40,2,4
2,00:03:05,3,False,15,10,5,38,0,4
2,00:02:31,1,True,10,15,-5,45,10,4
2,00:00:30,1,False,18,10,8,20,10,4
2,00:00:23,1,False,18,10,8,31,10,4
3,00:10:22,2,False,18,10,8,25,1,4
3,00:04:54,1,True,18,18,0,21,10,4
3,00:02:44,1,True,18,18,0,54,10,4
4,00:14:21,2,True,18,21,-3,41,4,4
4,00:12:54,1,True,18,21,-3,52,10,4
4,00:11:46,1,True,18,21,-3,34,10,4
4,00:10:13,1,True,18,22,-4,35,10,4
4,00:08:05,1,False,22,18,4,17,10,4
4,00:06:17,2,False,22,18,4,2,2,4
4,00:05:29,3,False,22,18,4,1,1,4
4,00:04:02,2,False,22,18,4,6,15,4
4,00:02:11,1,False,22,21,1,47,10,4
4,00:01:41,1,True,21,22,-1,46,10,4
1,00:12:30,1,True,2,0,2,39,10,4
1,00:10:57,1,True,2,0,2,29,30,4
1,00:07:54,2,False,0,2,-2,50,3,4
1,00:04:00,1,False,1,2,-1,45,10,4
1,00:02:16,1,False,1,3,-2,39,10,4
2,00:14:31,2,False,7,10,-3,37,1,4
2,00:13:59,1,False,7,10,-3,39,10,4
2,00:13:28,2,False,7,10,-3,48,1,4
2,00:09:22,1,False,7,10,-3,7,10,4
2,00:08:34,1,False,7,10,-3,30,10,4
2,00:07:52,2,False,7,10,-3,27,7,4
2,00:07:11,3,False,7,10,-3,24,4,4
2,00:04:30,1,True,10,7,3,43,10,4
2,00:03:50,1,True,10,7,3,30,10,4
2,00:02:38,1,True,10,10,0,35,10,4
2,00:00:40,1,True,10,10,0,17,10,4
3,00:13:55,3,False,10,10,0,46,0,4
3,00:10:58,1,True,10,10,0,43,10,4
3,00:10:05,2,True,10,10,0,52,1,4
3,00:09:25,3,True,10,10,0,53,0,4
3,00:03:31,1,False,10,16,-6,50,10,4
3,00:00:33,2,True,16,11,5,45,0,4
4,00:12:12,1,False,11,24,-13,37,10,4
4,00:09:46,3,True,25,11,14,44,5,4
4,00:09:15,1,True,25,11,14,40,10,4
4,00:04:07,1,False,11,26,-15,35,10,4
4,00:02:36,1,True,26,11,15,33,10,4
4,00:02:30,2,True,26,11,15,34,9,4
4,00:01:33,1,False,11,26,-15,48,10,4
4,00:01:23,2,False,11,26,-15,48,10,4
4,00:01:15,1,False,11,26,-15,23,10,4
1,00:13:54,2,True,0,0,0,30,1,4
1,00:13:25,1,True,0,0,0,34,10,4
1,00:11:43,2,True,0,0,0,55,2,4
1,00:11:05,3,False,0,0,0,54,1,4
1,00:08:39,2,False,0,0,0,21,2,4
1,00:07:14,1,False,0,0,0,53,15,4
1,00:03:59,1,False,0,0,0,39,5,4
1,00:00:37,1,True,0,7,-7,36,10,4
2,00:14:41,1,False,7,0,7,41,10,4
2,00:13:14,1,False,7,7,0,33,10,4
2,00:11:43,1,True,7,7,0,40,10,4
2,00:10:28,2,True,7,7,0,44,14,4
2,00:09:34,1,True,7,7,0,5,10,4
2,00:09:09,2,True,7,7,0,15,0,4
2,00:05:01,1,False,7,7,0,45,10,4
2,00:04:05,1,True,7,7,0,38,10,4
2,00:02:09,1,True,7,7,0,2,2,4
3,00:14:06,1,False,15,14,1,53,10,4
3,00:13:42,1,False,15,22,-7,28,10,4
3,00:11:58,2,False,15,22,-7,49,3,4
3,00:10:48,1,True,22,15,7,9,10,4
3,00:08:55,1,False,15,22,-7,44,10,4
3,00:05:58,1,False,15,23,-8,55,10,4
3,00:05:20,2,True,23,15,8,46,1,4
3,00:04:40,1,True,23,15,8,45,10,4
3,00:02:30,1,True,23,23,0,35,20,4
3,00:01:26,1,False,23,23,0,1,10,4
3,00:01:13,1,False,23,23,0,19,10,4
3,00:00:01,2,False,23,23,0,23,6,4
4,00:14:46,1,True,23,23,0,50,10,4
4,00:12:37,1,False,23,23,0,35,10,4
4,00:09:36,1,True,26,23,3,34,10,4
4,00:06:16,2,True,26,30,-4,20,0,4
4,00:04:56,1,True,26,30,-4,36,10,4
4,00:03:16,2,True,26,30,-4,48,10,4
4,00:02:36,1,False,30,26,4,15,10,4
4,00:02:30,1,False,30,26,4,26,10,4
4,00:02:06,2,False,30,26,4,32,4,4
4,00:01:39,1,False,30,26,4,36,10,4
4,00:01:13,2,False,30,26,4,45,1,4
4,00:00:51,1,False,30,26,4,47,10,4
1,00:14:58,1,False,0,1,-1,35,10,4
1,00:12:28,2,True,1,0,1,14,5,4
1,00:10:45,2,True,1,3,-2,43,2,4
1,00:09:51,1,True,1,3,-2,50,5,4
1,00:09:13,2,True,1,3,-2,54,1,4
1,00:06:48,1,False,3,1,2,13,10,4
1,00:03:15,1,True,7,3,4,20,10,4
1,00:03:05,1,True,7,3,4,7,10,4
1,00:01:17,1,True,7,10,-3,31,10,4
2,00:10:52,1,True,7,17,-10,1,10,4
2,00:09:19,1,True,7,31,-24,38,10,4
2,00:02:21,1,True,7,38,-31,54,10,4
2,00:00:35,1,False,38,7,31,4,4,4
2,00:00:30,1,False,38,13,25,25,10,4
2,00:00:01,2,False,38,13,25,29,6,4
3,00:09:09,1,False,41,13,28,15,10,4
3,00:07:26,2,True,15,41,-26,47,1,4
3,00:02:30,1,True,18,41,-23,20,10,4
3,00:00:01,1,False,49,18,31,48,10,4
4,00:12:27,2,False,49,18,31,16,11,4
4,00:11:44,1,False,49,26,23,28,10,4
4,00:09:10,3,False,49,26,23,53,0,4
4,00:08:39,1,False,49,26,23,55,10,4
4,00:07:36,1,True,26,49,-23,32,10,4
4,00:05:56,1,True,26,52,-26,35,10,4
4,00:03:33,1,False,52,26,26,11,10,4
4,00:02:10,1,True,26,52,-26,54,10,4
4,00:01:51,2,True,26,52,-26,46,2,4
4,00:01:27,1,True,26,52,-26,44,10,4
4,00:01:04,1,True,26,52,-26,33,10,4
4,00:00:40,2,True,26,52,-26,29,6,4
1,00:13:40,1,False,0,0,0,30,10,4
1,00:12:15,1,False,0,0,0,36,15,4
1,00:10:59,1,True,0,0,0,54,10,4
1,00:09:34,1,True,0,0,0,15,10,4
1,00:07:45,1,True,0,0,0,50,10,4
1,00:06:47,1,False,0,0,0,36,10,4
1,00:05:32,1,False,0,0,0,9,9,4
1,00:04:15,1,False,0,7,-7,23,10,4
1,00:02:42,1,False,0,7,-7,35,10,4
1,00:00:22,1,False,0,7,-7,52,10,4
2,00:14:38,1,False,0,7,-7,17,10,4
2,00:12:21,1,False,0,7,-7,31,10,4
2,00:11:57,2,False,0,7,-7,23,2,4
2,00:06:43,1,False,0,10,-10,30,10,4
2,00:05:14,1,True,10,0,10,15,10,4
2,00:03:41,1,False,0,10,-10,40,10,4
2,00:03:00,2,False,0,10,-10,31,1,4
2,00:02:02,1,False,0,16,-16,3,0,4
2,00:01:30,1,True,16,0,16,41,10,4
2,00:00:56,1,True,16,0,16,5,10,4
2,00:00:48,1,True,16,0,16,21,10,4
2,00:00:27,2,True,16,0,16,23,8,4
3,00:14:12,2,True,16,0,16,53,2,4
3,00:13:14,3,True,16,0,16,55,0,4
3,00:12:34,1,False,0,16,-16,54,10,4
3,00:11:18,1,False,0,16,-16,40,10,4
3,00:10:32,2,False,0,16,-16,33,3,4
3,00:10:03,3,False,0,16,-16,31,1,4
3,00:09:11,1,False,0,16,-16,30,10,4
3,00:08:12,1,False,0,16,-16,20,10,4
3,00:06:55,1,False,0,22,-22,31,10,4
3,00:03:19,1,True,22,3,19,35,10,4
3,00:02:44,2,True,22,3,19,38,7,4
3,00:02:14,3,True,22,3,19,45,0,4
3,00:00:32,1,False,3,22,-19,50,10,4
3,00:00:02,2,False,3,22,-19,46,6,4
4,00:14:03,1,True,25,3,22,7,5,4
4,00:12:35,1,True,25,3,22,4,4,4
4,00:11:46,2,True,25,3,22,1,1,4
4,00:10:35,3,True,25,3,22,1,1,4
4,00:09:01,1,True,25,11,14,51,10,4
4,00:07:55,2,True,25,11,14,45,16,4
4,00:06:39,2,False,11,25,-14,18,1,4
4,00:04:33,1,False,11,25,-14,12,10,4
4,00:03:43,2,False,11,25,-14,6,4,4
4,00:02:24,1,False,11,28,-17,54,20,4
4,00:01:03,2,True,29,11,18,45,5,4
1,00:13:46,2,True,0,0,0,55,3,4
1,00:11:48,1,False,0,0,0,35,10,4
1,00:11:25,2,False,0,0,0,27,2,4
1,00:08:55,2,True,0,0,0,39,2,4
1,00:08:45,1,True,0,0,0,35,10,4
1,00:06:54,1,True,0,3,-3,35,10,4
1,00:05:14,1,False,3,0,3,46,10,4
1,00:03:42,1,False,3,0,3,2,10,4
1,00:00:54,1,False,3,0,3,17,10,4
2,00:15:00,1,False,3,0,3,45,10,4
2,00:13:39,1,True,0,3,-3,15,10,4
2,00:11:06,1,True,0,3,-3,42,10,4
2,00:10:42,2,True,0,3,-3,36,4,4
2,00:08:29,1,True,0,3,-3,6,6,4
2,00:07:21,1,True,0,6,-6,35,10,4
2,00:05:35,1,False,6,0,6,23,10,4
2,00:05:05,2,False,6,0,6,20,7,4
2,00:03:48,1,False,6,7,-1,33,10,4
2,00:02:29,2,True,7,6,1,54,1,4
2,00:01:59,2,True,7,6,1,51,10,4
2,00:01:36,1,True,7,7,0,35,10,4
2,00:01:29,1,True,7,7,0,53,10,4
3,00:14:53,1,False,7,10,-3,44,10,4
3,00:11:02,1,True,10,9,1,44,10,4
3,00:10:15,2,True,10,9,1,51,3,4
3,00:09:27,2,False,9,10,-1,43,2,4
3,00:08:17,2,False,9,10,-1,32,2,4
3,00:07:37,1,False,9,10,-1,29,10,4
3,00:07:01,2,False,9,10,-1,24,5,4
3,00:02:30,1,True,13,16,-3,55,10,4
3,00:01:24,2,False,16,13,3,46,1,4
3,00:00:56,3,False,16,13,3,45,0,4
4,00:13:52,2,False,16,20,-4,54,3,4
4,00:12:29,1,True,20,16,4,31,10,4
4,00:10:54,2,True,20,16,4,51,3,4
4,00:10:24,3,True,20,16,4,53,1,4
4,00:09:03,1,False,16,20,-4,16,10,4
4,00:05:16,1,True,27,16,11,42,10,4
4,00:03:02,3,False,16,27,-11,51,1,4
4,00:02:57,1,False,16,27,-11,50,10,4
4,00:02:06,1,False,16,27,-11,33,10,4
4,00:01:56,2,False,16,27,-11,32,9,4
4,00:01:13,1,False,16,27,-11,21,10,4
4,00:00:48,2,False,16,27,-11,18,7,4
4,00:00:29,3,False,16,27,-11,18,7,4
1,00:14:55,1,False,0,0,0,38,10,4
1,00:14:22,1,False,0,0,0,49,10,4
1,00:13:16,3,True,0,0,0,52,1,4
1,00:09:40,2,True,0,3,-3,42,3,4
1,00:08:20,2,False,3,0,3,54,1,4
1,00:07:30,2,False,3,0,3,35,0,4
1,00:05:54,1,True,0,3,-3,3,3,4
1,00:04:58,2,True,0,3,-3,1,1,4
1,00:02:42,1,True,3,3,0,52,5,4
1,00:02:10,2,True,3,3,0,49,2,4
2,00:13:44,1,True,3,10,-7,27,10,4
2,00:09:41,1,False,10,3,7,40,10,4
2,00:05:19,1,False,10,6,4,48,10,4
2,00:03:00,1,False,10,9,1,49,10,4
2,00:01:45,1,True,9,10,-1,16,10,4
3,00:13:05,1,False,10,17,-7,19,10,4
3,00:12:24,2,False,10,17,-7,11,2,4
3,00:11:46,3,False,10,17,-7,10,1,4
3,00:08:50,1,False,10,20,-10,35,10,4
3,00:07:03,2,False,10,20,-10,53,3,4
3,00:04:14,1,True,20,11,9,47,10,4
3,00:00:01,1,True,21,11,10,43,10,4
4,00:14:04,1,True,21,11,10,11,10,4
4,00:12:07,1,True,21,11,10,46,10,4
4,00:09:21,1,True,21,18,3,22,10,4
4,00:08:13,1,True,21,18,3,43,10,4
4,00:03:41,2,True,21,18,3,41,15,4
4,00:02:46,1,True,21,21,0,35,10,4
4,00:02:41,2,True,21,21,0,44,1,4
4,00:02:35,1,True,21,21,0,48,10,4
4,00:01:54,1,False,21,21,0,7,7,4
4,00:01:17,1,False,21,21,0,1,1,4
5,00:00:00,2,False,28,28,0,26,1,4
5,00:00:00,1,False,28,28,0,20,10,4
5,00:00:00,1,False,28,28,0,1,1,4
5,00:00:00,2,False,28,28,0,1,1,4
5,00:00:00,0,True,34,28,6,1,0,4
5,00:00:00,1,True,34,28,6,25,10,4
5,00:00:00,1,True,34,34,0,35,10,4
5,00:00:00,2,True,34,34,0,26,1,4
5,00:00:00,1,True,34,34,0,20,10,4
1,00:13:49,1,False,0,0,0,42,10,4
1,00:11:06,2,True,0,0,0,39,10,4
1,00:09:46,1,True,0,0,0,25,10,4
1,00:02:19,1,True,14,0,14,54,10,4
1,00:01:29,1,False,0,14,-14,50,10,4
1,00:01:21,2,False,0,14,-14,43,3,4
1,00:00:50,1,False,0,14,-14,23,10,4
2,00:14:54,3,False,0,14,-14,1,1,4
2,00:14:33,1,False,0,20,-20,20,10,4
2,00:05:08,1,True,29,0,29,23,10,4
2,00:02:38,1,True,29,8,21,48,10,4
3,00:14:56,1,True,36,11,25,28,10,4
3,00:11:06,1,True,36,11,25,26,10,4
3,00:06:48,1,False,14,36,-22,11,10,4
3,00:06:00,2,False,14,43,-29,44,4,4
3,00:02:46,1,True,43,14,29,30,10,4
3,00:01:04,2,True,43,14,29,14,1,4
4,00:14:45,1,True,43,14,29,8,10,4
4,00:10:57,2,False,17,43,-26,49,3,4
4,00:10:03,3,False,17,43,-26,47,1,4
4,00:09:44,1,False,17,43,-26,44,10,4
4,00:09:04,2,False,17,43,-26,37,3,4
4,00:03:35,1,True,46,17,29,25,10,4
4,00:02:12,1,False,17,46,-29,42,10,4
4,00:01:54,1,False,17,46,-29,55,10,4
4,00:01:20,1,True,46,17,29,10,10,4
4,00:00:40,1,True,46,17,29,21,10,4
4,00:00:20,2,True,46,17,29,21,10,4
1,00:14:54,1,True,0,0,0,26,10,4
1,00:12:00,3,True,0,0,0,40,1,4
1,00:11:18,1,True,0,0,0,34,10,4
1,00:09:49,1,True,0,0,0,8,10,4
1,00:07:25,1,False,0,0,0,51,10,4
1,00:06:50,2,False,0,0,0,46,5,4
1,00:05:51,1,False,0,3,-3,45,10,4
1,00:03:46,1,False,0,3,-3,16,10,4
1,00:02:10,1,False,0,6,-6,50,10,4
2,00:14:30,2,True,6,0,6,15,3,4
2,00:13:45,1,True,6,3,3,35,10,4
2,00:11:15,1,False,3,6,-3,30,10,4
2,00:08:26,2,False,3,12,-9,53,4,4
2,00:04:52,1,True,12,3,9,3,3,4
2,00:04:35,2,True,12,3,9,4,4,4
2,00:04:04,1,True,12,10,2,25,10,4
2,00:00:52,1,False,10,12,-2,18,10,4
2,00:00:47,2,False,10,12,-2,21,7,4
2,00:00:14,1,False,10,19,-9,43,10,4
2,00:00:01,2,False,10,19,-9,47,6,4
3,00:14:08,2,False,10,19,-9,45,2,4
3,00:11:53,1,True,19,13,6,35,10,4
3,00:08:15,1,False,13,19,-6,26,10,4
3,00:05:32,1,False,13,19,-6,45,10,4
3,00:04:05,3,False,13,19,-6,35,0,4
3,00:03:40,1,False,13,19,-6,34,10,4
4,00:15:00,1,True,22,13,9,18,10,4
4,00:14:05,1,True,22,13,9,8,8,4
4,00:13:07,1,True,22,20,2,46,10,4
4,00:12:40,1,False,20,22,-2,47,10,4
4,00:11:03,2,False,20,22,-2,27,2,4
4,00:08:46,2,True,25,20,5,29,10,4
4,00:07:47,3,True,25,20,5,39,0,4
4,00:05:03,2,False,20,25,-5,33,1,4
4,00:03:29,2,True,25,20,5,38,10,4
4,00:02:49,1,True,25,23,2,35,10,4
4,00:01:54,1,False,23,25,-2,24,10,4
4,00:01:20,1,False,23,25,-2,26,10,4
4,00:01:13,2,False,23,25,-2,22,6,4
1,00:13:41,1,False,0,0,0,42,10,4
1,00:13:06,1,True,0,0,0,52,10,4
1,00:12:48,2,True,0,0,0,51,9,4
1,00:11:18,1,True,0,0,0,14,10,4
1,00:10:24,1,True,0,0,0,26,10,4
1,00:09:45,1,True,0,0,0,37,10,4
1,00:07:29,1,False,0,0,0,53,10,4
1,00:06:49,2,False,0,0,0,54,9,4
1,00:05:03,2,True,0,7,-7,34,10,4
1,00:02:29,2,False,7,0,7,26,1,4
1,00:01:56,1,False,7,0,7,22,10,4
2,00:15:00,1,False,7,3,4,46,10,4
2,00:12:26,1,False,7,3,4,22,10,4
2,00:07:53,2,True,6,7,-1,36,8,4
2,00:07:02,2,False,7,6,1,22,1,4
2,00:06:28,1,False,7,6,1,27,10,4
2,00:04:09,1,False,7,6,1,43,10,4
2,00:03:29,2,False,7,6,1,53,0,4
3,00:11:53,2,False,7,6,1,10,2,4
3,00:11:16,1,False,7,6,1,4,4,4
3,00:09:00,1,True,9,7,2,28,10,4
3,00:07:35,1,False,7,9,-2,47,10,4
3,00:07:05,2,False,7,9,-2,54,3,4
3,00:06:23,1,True,9,7,2,51,10,4
3,00:00:04,1,True,12,15,-3,26,10,4
4,00:14:43,1,True,12,15,-3,10,10,4
4,00:13:16,1,True,12,15,-3,1,1,4
4,00:08:58,2,False,22,12,10,41,1,4
4,00:07:36,1,False,22,12,10,14,10,4
4,00:06:11,1,False,22,18,4,38,10,4
4,00:05:29,2,False,22,18,4,47,1,4
4,00:02:21,2,True,18,22,-4,10,10,4
4,00:01:34,1,False,29,26,3,27,10,4
4,00:01:28,1,False,29,26,3,38,10,4
4,00:01:24,2,False,29,26,3,40,8,4
4,00:01:00,3,False,29,26,3,48,0,4
5,00:00:00,2,True,29,29,0,30,5,4
5,00:00:00,1,False,32,29,3,6,6,4
1,00:14:37,1,False,0,0,0,29,10,4
1,00:13:03,1,True,0,0,0,4,15,4
1,00:10:07,1,True,0,0,0,31,10,4
1,00:09:07,1,False,0,0,0,53,10,4
1,00:07:37,1,False,0,0,0,37,10,4
1,00:03:51,1,False,0,0,0,54,10,4
1,00:00:01,1,True,0,7,-7,18,10,4
2,00:14:05,1,False,7,0,7,47,10,4
2,00:12:04,1,True,0,7,-7,51,10,4
2,00:11:29,2,False,7,0,7,51,2,4
2,00:09:45,2,False,7,0,7,46,13,4
2,00:07:53,1,False,7,6,1,35,10,4
2,00:06:15,1,False,7,6,1,4,4,4
2,00:05:45,1,False,7,14,-7,8,10,4
2,00:01:26,1,True,21,14,7,50,10,4
3,00:14:31,2,True,22,14,8,41,2,4
3,00:13:43,3,True,22,14,8,42,1,4
3,00:12:55,2,True,22,14,8,52,2,4
3,00:11:35,1,False,14,22,-8,22,10,4
3,00:09:50,2,False,14,22,-8,26,20,4
3,00:09:10,1,True,22,14,8,29,10,4
3,00:04:12,1,False,17,22,-5,47,10,4
3,00:02:35,1,True,22,17,5,15,10,4
4,00:09:04,1,True,22,20,2,41,10,4
4,00:07:34,1,False,20,22,-2,40,10,4
4,00:04:39,2,False,20,22,-2,50,1,4
4,00:04:10,1,False,20,22,-2,48,10,4
4,00:03:32,2,False,20,22,-2,40,2,4
1,00:14:28,1,False,0,0,0,42,10,4
1,00:10:10,1,True,1,0,1,45,10,4
1,00:08:16,2,False,0,1,-1,25,8,4
1,00:02:00,1,False,0,1,-1,19,10,4
2,00:12:31,2,True,4,0,4,23,4,4
2,00:12:19,1,True,4,0,4,14,10,4
2,00:10:03,2,True,4,7,-3,29,2,4
2,00:07:28,1,False,7,4,3,1,1,4
2,00:07:00,2,False,7,4,3,1,1,4
2,00:06:22,3,False,7,4,3,1,1,4
2,00:06:04,1,False,7,4,3,1,10,4
2,00:04:19,3,False,7,4,3,10,1,4
2,00:03:10,2,False,7,4,3,20,1,4
2,00:03:00,1,False,7,4,3,22,10,4
3,00:13:45,1,False,10,7,3,21,10,4
3,00:11:35,2,True,7,10,-3,32,1,4
3,00:11:00,1,True,7,10,-3,35,10,4
3,00:03:25,2,True,14,10,4,39,6,4
3,00:02:10,1,False,10,14,-4,16,10,4
3,00:01:32,2,False,10,14,-4,23,3,4
4,00:15:00,1,True,14,10,4,40,10,4
4,00:11:50,2,True,14,13,1,51,11,4
4,00:08:50,2,False,13,14,-1,45,1,4
4,00:07:34,3,False,13,14,-1,44,0,4
4,00:07:10,1,False,13,14,-1,43,10,4
4,00:05:06,1,False,13,17,-4,46,0,4
4,00:04:40,2,False,13,17,-4,55,1,4
4,00:04:24,3,False,13,17,-4,55,1,4
4,00:03:35,1,True,17,13,4,54,10,4
4,00:03:00,2,False,13,17,-4,46,0,4
4,00:01:46,2,False,13,17,-4,24,6,4
4,00:01:15,1,False,13,17,-4,42,10,4
4,00:01:13,2,False,13,17,-4,44,12,4
1,00:13:16,1,True,0,0,0,9,10,4
1,00:12:01,1,False,2,0,2,43,10,4
1,00:10:37,1,True,0,2,-2,39,10,4
1,00:10:10,2,True,0,2,-2,32,3,4
1,00:07:08,2,True,0,2,-2,52,0,4
1,00:04:15,1,True,0,5,-5,35,10,4
1,00:00:30,2,True,0,5,-5,51,1,4
2,00:14:35,1,True,0,5,-5,7,10,4
2,00:13:54,2,True,0,5,-5,9,8,4
2,00:12:17,1,True,0,5,-5,46,10,4
2,00:09:57,1,True,0,5,-5,49,10,4
2,00:08:20,1,False,5,0,5,19,10,4
2,00:07:39,1,False,5,0,5,35,10,4
2,00:06:03,1,True,0,5,-5,45,10,4
2,00:05:30,1,True,0,5,-5,16,10,4
2,00:05:04,2,True,0,5,-5,15,9,4
2,00:03:29,1,True,0,8,-8,47,10,4
3,00:14:18,1,False,8,3,5,43,10,4
3,00:13:30,2,False,8,3,5,40,7,4
3,00:12:42,1,False,8,3,5,31,10,4
3,00:11:15,1,False,8,6,2,35,10,4
3,00:09:18,0,False,8,6,2,27,0,4
3,00:08:01,1,True,6,11,-5,35,10,4
3,00:06:08,2,True,6,11,-5,41,0,4
3,00:05:39,1,True,6,11,-5,40,10,4
3,00:01:45,1,False,11,6,5,54,10,4
3,00:00:38,1,False,11,6,5,47,10,4
4,00:12:50,2,False,11,6,5,7,1,4
4,00:12:20,1,False,11,6,5,3,3,4
4,00:11:45,2,False,11,6,5,1,1,4
4,00:11:12,1,False,11,12,-1,34,10,4
4,00:10:54,2,False,11,12,-1,43,1,4
4,00:09:18,1,True,12,17,-5,37,10,4
4,00:08:21,1,True,12,17,-5,50,10,4
4,00:06:54,1,False,17,12,5,31,10,4
4,00:05:08,1,True,12,17,-5,38,10,4
4,00:03:34,1,True,12,20,-8,39,10,4
4,00:01:41,1,True,12,23,-11,25,10,4
4,00:01:35,2,True,12,23,-11,18,3,4
4,00:01:12,1,True,12,23,-11,14,10,4
4,00:00:32,3,True,12,23,-11,5,1,4
1,00:14:50,1,True,0,0,0,26,10,4
1,00:12:01,1,True,0,0,0,51,10,4
1,00:11:35,1,True,0,0,0,26,10,4
1,00:10:36,1,True,0,0,0,14,10,4
1,00:09:25,1,True,0,0,0,3,3,4
1,00:07:52,1,False,7,0,7,53,10,4
1,00:06:35,1,False,7,0,7,1,10,4
1,00:06:15,2,False,7,0,7,9,2,4
1,00:05:01,2,False,7,0,7,25,1,4
1,00:02:38,1,True,0,7,-7,40,10,4
1,00:02:12,2,True,0,7,-7,46,4,4
1,00:00:53,1,False,7,0,7,24,10,4
1,00:00:33,1,False,7,0,7,35,10,4
2,00:14:05,1,True,0,8,-8,35,10,4
2,00:10:53,2,False,8,0,8,38,10,4
2,00:09:32,1,True,0,8,-8,47,10,4
2,00:09:10,1,False,8,0,8,45,10,4
2,00:07:19,2,False,8,3,5,35,10,4
2,00:03:14,1,False,9,4,5,35,10,4
2,00:02:10,1,True,4,9,-5,41,10,4
2,00:01:13,1,False,9,4,5,47,10,4
2,00:00:40,1,True,4,9,-5,5,10,4
2,00:00:30,1,True,4,9,-5,15,10,4
3,00:14:29,1,True,4,9,-5,15,10,4
3,00:13:16,2,True,4,17,-13,29,16,4
3,00:11:29,1,False,17,4,13,40,10,4
3,00:10:42,1,False,17,4,13,19,10,4
3,00:08:17,1,True,11,17,-6,32,10,4
3,00:05:55,1,True,11,17,-6,4,10,4
3,00:03:46,1,False,20,11,9,48,10,4
3,00:02:09,1,False,20,11,9,10,10,4
3,00:01:42,2,False,20,11,9,19,1,4
3,00:00:44,1,True,11,20,-9,41,10,4
4,00:14:25,1,True,11,27,-16,15,10,4
4,00:11:44,3,False,27,11,16,36,1,4
4,00:09:41,1,False,27,11,16,18,10,4
4,00:07:55,1,False,27,14,13,35,10,4
4,00:03:05,1,False,27,17,10,35,10,4
4,00:02:37,2,False,27,17,10,40,5,4
4,00:00:36,2,False,27,17,10,1,1,4
1,00:14:57,1,True,0,1,-1,35,10,4
1,00:13:15,1,False,1,0,1,19,15,4
1,00:12:55,2,False,1,0,1,24,10,4
1,00:12:19,3,False,1,0,1,34,0,4
1,00:11:55,1,False,1,0,1,35,10,4
1,00:08:42,1,True,0,8,-8,48,5,4
1,00:07:59,2,True,0,8,-8,44,1,4
1,00:07:09,1,True,0,8,-8,53,20,4
1,00:05:17,1,True,0,8,-8,1,1,4
1,00:04:24,2,True,0,16,-16,35,10,4
1,00:02:50,1,False,16,0,16,30,10,4
1,00:02:22,2,False,16,0,16,20,0,4
2,00:13:20,1,False,16,8,8,24,10,4
2,00:12:05,1,False,16,9,7,35,10,4
2,00:10:10,1,False,16,16,0,46,10,4
2,00:08:50,1,True,16,16,0,8,10,4
2,00:08:10,2,True,16,16,0,14,4,4
2,00:05:41,1,True,16,16,0,39,10,4
2,00:02:40,1,False,16,16,0,6,10,4
2,00:00:54,2,False,16,16,0,54,5,4
3,00:14:21,1,False,16,16,0,45,10,4
3,00:13:00,1,True,16,16,0,25,10,4
3,00:08:42,1,True,16,16,0,3,10,4
3,00:08:12,2,True,16,16,0,12,1,4
3,00:07:34,1,True,16,16,0,22,10,4
3,00:06:52,1,True,16,16,0,48,10,4
3,00:05:50,1,False,16,16,0,44,10,4
3,00:04:48,2,False,16,16,0,35,1,4
3,00:02:25,1,False,16,16,0,1,1,4
3,00:02:09,1,False,16,23,-7,29,10,4
4,00:10:17,1,True,23,22,1,9,10,4
4,00:09:33,2,True,23,22,1,18,1,4
4,00:08:36,1,True,23,22,1,48,10,4
4,00:05:45,2,True,23,25,-2,41,4,4
4,00:05:05,1,True,23,25,-2,47,10,4
4,00:03:41,1,False,25,23,2,40,10,4
4,00:03:00,2,False,25,23,2,37,7,4
4,00:01:13,1,True,26,25,1,17,10,4
4,00:01:07,2,True,26,25,1,21,6,4
1,00:14:10,1,True,0,0,0,42,10,4
1,00:10:32,1,False,0,0,0,37,10,4
1,00:06:24,1,True,0,8,-8,40,10,4
1,00:05:48,2,True,0,8,-8,35,5,4
2,00:14:20,1,True,8,11,-3,47,10,4
2,00:13:15,1,True,8,11,-3,33,10,4
2,00:11:42,1,True,8,11,-3,3,3,4
2,00:09:51,1,False,19,8,11,25,10,4
2,00:08:50,1,False,19,8,11,23,10,4
2,00:03:00,2,False,19,11,8,7,1,4
2,00:02:23,0,True,17,19,-2,1,0,4
2,00:02:01,1,False,19,17,2,40,10,4
3,00:13:25,1,True,17,19,-2,54,10,4
3,00:09:53,1,True,17,19,-2,20,10,4
3,00:06:12,1,False,22,20,2,35,10,4
3,00:04:35,2,True,20,22,-2,54,3,4
3,00:02:35,1,True,20,23,-3,35,10,4
4,00:15:00,2,False,23,20,3,45,1,4
4,00:14:36,1,False,23,20,3,43,10,4
4,00:14:01,2,False,23,20,3,38,5,4
4,00:11:45,1,False,23,20,3,44,10,4
4,00:05:10,1,True,26,23,3,47,10,4
4,00:03:04,1,True,26,26,0,48,10,4
4,00:02:03,1,False,26,26,0,25,10,4
4,00:01:55,2,False,26,26,0,28,13,4
5,00:00:00,1,False,26,26,0,35,10,4
5,00:00:00,2,False,26,26,0,33,8,4
1,00:12:38,1,False,0,0,0,50,10,4
1,00:10:54,1,True,0,0,0,37,10,4
1,00:10:24,2,True,0,0,0,45,2,4
1,00:09:52,1,False,0,0,0,53,10,4
1,00:08:51,1,False,0,0,0,35,10,4
1,00:07:23,2,False,0,0,0,15,2,4
1,00:06:25,1,False,0,0,0,10,10,4
1,00:06:01,1,False,0,7,-7,45,10,4
1,00:00:49,1,False,0,14,-14,35,10,4
2,00:14:20,2,False,0,14,-14,7,5,4
2,00:13:57,1,False,0,21,-21,28,10,4
2,00:12:53,1,False,0,21,-21,45,10,4
2,00:12:17,2,False,0,21,-21,52,3,4
2,00:11:37,3,False,0,21,-21,55,0,4
2,00:08:13,1,True,21,7,14,48,10,4
2,00:06:41,1,True,21,7,14,17,10,4
2,00:06:00,2,True,21,7,14,26,1,4
2,00:01:54,1,False,7,21,-14,20,10,4
2,00:01:47,2,False,7,21,-14,30,0,4
3,00:12:30,1,True,21,7,14,25,10,4
3,00:11:14,1,True,21,10,11,35,10,4
3,00:08:40,1,True,21,10,11,44,10,4
3,00:03:54,2,True,21,10,11,2,1,4
3,00:01:41,2,False,18,21,-3,43,3,4
4,00:12:31,1,True,21,21,0,35,10,4
4,00:10:04,1,True,21,21,0,51,10,4
4,00:08:01,1,False,21,21,0,33,10,4
4,00:04:20,1,True,24,21,3,17,10,4
4,00:01:37,1,True,27,27,0,25,10,4
4,00:01:13,2,True,27,27,0,20,5,4
1,00:13:15,1,True,0,0,0,38,15,4
1,00:11:11,1,False,0,0,0,40,10,4
1,00:04:50,1,True,1,0,1,46,10,4
1,00:04:10,1,True,1,0,1,20,10,4
1,00:02:45,1,True,1,0,1,8,8,4
1,00:02:20,2,True,1,0,1,2,2,4
1,00:00:17,3,False,3,1,2,54,10,4
2,00:13:53,1,True,1,3,-2,23,10,4
2,00:12:02,1,False,3,1,2,37,10,4
2,00:11:20,1,False,3,1,2,27,10,4
2,00:09:30,1,False,3,4,-1,35,10,4
2,00:07:37,2,False,3,4,-1,34,30,4
2,00:05:01,1,True,4,3,1,32,10,4
2,00:03:35,1,False,3,4,-1,40,10,4
2,00:02:27,1,True,4,3,1,50,10,4
2,00:02:19,1,False,3,4,-1,50,10,4
2,00:01:26,1,False,3,4,-1,31,10,4
2,00:01:13,2,False,3,4,-1,39,2,4
3,00:14:54,1,False,3,4,-1,37,10,4
3,00:14:22,2,False,3,4,-1,40,7,4
3,00:09:22,1,False,3,4,-1,53,10,4
3,00:06:48,1,False,3,4,-1,3,3,4
3,00:06:27,1,False,3,11,-8,39,10,4
3,00:04:52,1,True,11,3,8,52,10,4
3,00:03:39,1,False,3,11,-8,45,10,4
3,00:01:55,1,False,3,18,-15,34,10,4
4,00:15:00,2,False,3,18,-15,47,10,4
4,00:14:13,1,True,18,3,15,23,10,4
4,00:12:58,1,False,3,18,-15,32,10,4
4,00:11:22,1,False,3,18,-15,46,10,4
4,00:09:43,1,False,3,18,-15,17,10,4
4,00:06:23,1,True,25,3,22,37,10,4
4,00:05:53,1,False,3,25,-22,4,4,4
4,00:03:32,1,False,3,32,-29,44,10,4
4,00:01:49,3,False,3,32,-29,41,1,4
1,00:14:52,1,False,0,0,0,43,10,4
1,00:14:20,2,False,0,0,0,50,3,4
1,00:11:27,1,False,0,0,0,50,10,4
1,00:09:26,2,False,0,0,0,28,2,4
1,00:07:09,2,True,3,0,3,50,2,4
1,00:05:52,1,True,3,7,-4,5,10,4
1,00:03:44,1,True,3,7,-4,43,10,4
1,00:01:31,1,False,7,3,4,27,10,4
2,00:14:16,1,True,3,10,-7,35,10,4
2,00:09:01,2,False,10,6,4,41,4,4
2,00:08:38,1,False,10,6,4,48,10,4
2,00:05:05,1,True,6,11,-5,40,5,4
2,00:02:25,1,False,11,6,5,32,10,4
2,00:02:20,2,False,11,6,5,41,1,4
2,00:01:59,1,True,6,11,-5,22,10,4
3,00:14:47,1,True,14,14,0,24,10,4
3,00:12:14,1,False,14,14,0,2,2,4
3,00:11:16,2,False,14,14,0,1,1,4
3,00:10:16,1,False,14,21,-7,43,10,4
3,00:09:45,2,False,14,21,-7,46,7,4
3,00:09:07,1,True,21,14,7,46,10,4
3,00:07:13,1,True,21,17,4,51,10,4
3,00:05:14,1,False,17,21,-4,28,10,4
3,00:03:45,1,False,17,21,-4,48,10,4
3,00:02:39,1,True,21,17,4,51,10,4
3,00:00:25,1,True,21,17,4,18,10,4
4,00:14:01,1,True,21,20,1,35,10,4
4,00:10:56,1,True,21,20,1,37,10,4
4,00:09:38,1,True,21,20,1,25,10,4
4,00:09:03,2,True,21,20,1,17,2,4
4,00:07:08,1,True,21,20,1,1,1,4
4,00:05:46,1,True,21,28,-7,33,10,4
4,00:05:27,2,True,21,28,-7,40,3,4
4,00:04:03,1,True,21,28,-7,40,10,4
4,00:02:49,1,True,21,28,-7,27,10,4
4,00:02:25,2,True,21,28,-7,29,12,4
4,00:01:31,1,True,21,31,-10,25,20,4
4,00:00:52,1,True,21,31,-10,44,10,4
4,00:00:47,2,True,21,31,-10,36,2,4
1,00:14:53,1,True,0,0,0,19,10,4
1,00:11:37,1,False,0,0,0,25,10,4
1,00:06:24,1,True,7,3,4,42,5,4
2,00:13:23,1,True,7,6,1,47,10,4
2,00:12:10,1,False,6,7,-1,49,10,4
2,00:11:35,2,False,6,7,-1,45,6,4
2,00:10:49,3,False,6,7,-1,40,1,4
2,00:10:15,1,False,6,7,-1,39,10,4
2,00:07:28,1,False,6,7,-1,22,10,4
2,00:06:54,2,False,6,7,-1,25,7,4
2,00:06:00,1,True,7,6,1,48,10,4
2,00:03:47,1,False,6,7,-1,44,10,4
2,00:01:48,1,True,7,13,-6,33,20,4
3,00:14:54,1,False,14,10,4,34,10,4
3,00:10:46,1,True,10,15,-5,47,10,4
3,00:09:17,1,False,15,10,5,4,10,4
3,00:07:58,1,False,15,10,5,17,10,4
3,00:06:03,1,True,10,15,-5,49,10,4
3,00:03:13,2,True,10,15,-5,20,1,4
4,00:13:54,0,False,18,10,8,40,0,4
4,00:13:10,3,True,10,18,-8,44,1,4
4,00:11:43,1,True,10,18,-8,17,10,4
4,00:09:37,1,False,18,10,8,45,10,4
4,00:04:52,1,True,13,18,-5,5,10,4
4,00:03:42,1,False,18,13,5,38,10,4
4,00:02:21,1,False,18,13,5,43,10,4
4,00:01:38,1,False,18,13,5,24,10,4
4,00:01:14,2,True,13,18,-5,36,16,4
4,00:00:42,1,True,13,18,-5,51,10,4
4,00:00:36,2,True,13,18,-5,48,7,4
4,00:00:14,3,True,13,18,-5,43,2,4
3,00:08:37,2,True,3,17,-14,54,10,3
3,00:07:08,2,True,3,17,-14,28,5,3
3,00:04:15,2,False,17,3,14,20,6,3
4,00:11:48,2,False,24,6,18,3,3,3
4,00:01:22,2,True,6,24,-18,32,10,3
2,00:09:52,2,True,7,13,-6,24,2,3
3,00:09:25,2,True,12,23,-11,40,10,3
3,00:00:29,2,True,12,26,-14,22,10,3
4,00:01:20,1,True,26,33,-7,38,10,3
1,00:01:17,1,True,7,0,7,40,10,3
2,00:06:25,2,False,7,14,-7,52,1,3
2,00:01:26,1,False,7,14,-7,53,10,3
3,00:13:25,1,True,14,9,5,33,10,3
4,00:01:54,1,True,29,19,10,41,10,3
1,00:11:20,2,False,0,0,0,53,14,3
1,00:08:30,1,True,0,3,-3,31,10,3
1,00:00:49,1,True,7,10,-3,35,10,3
2,00:00:20,1,False,11,14,-3,39,10,3
3,00:09:30,2,False,11,14,-3,51,8,3
3,00:08:35,1,True,14,11,3,32,10,3
3,00:07:49,2,True,14,11,3,22,20,3
4,00:10:31,2,True,21,14,7,25,11,3
1,00:11:18,1,False,0,0,0,33,10,3
2,00:14:03,2,True,7,2,5,40,10,3
2,00:12:36,2,True,7,3,4,35,10,3
3,00:05:26,2,True,17,17,0,18,15,3
4,00:10:39,2,False,26,17,9,14,4,3
4,00:09:48,2,False,26,20,6,35,10,3
4,00:06:59,2,False,26,20,6,39,7,3
4,00:05:23,2,False,26,20,6,19,15,3
1,00:07:10,2,False,0,10,-10,47,10,3
1,00:05:33,2,True,10,0,10,26,13,3
2,00:12:47,2,False,0,17,-17,40,10,3
2,00:04:17,2,True,17,7,10,21,10,3
2,00:02:46,1,False,7,17,-10,47,10,3
2,00:01:41,2,True,17,7,10,42,10,3
3,00:12:39,3,False,7,20,-13,44,1,3
3,00:04:43,1,False,7,30,-23,29,10,3
3,00:00:58,2,True,30,7,23,53,10,3
4,00:10:35,1,False,7,37,-30,29,10,3
4,00:01:05,1,False,34,37,-3,17,10,3
1,00:11:48,2,False,0,1,-1,38,7,3
1,00:09:42,2,False,0,1,-1,11,10,3
1,00:07:18,2,False,0,1,-1,27,10,3
2,00:02:07,2,False,10,8,2,44,10,3
4,00:11:56,2,False,20,8,12,46,10,3
1,00:06:20,2,False,0,0,0,15,10,3
2,00:06:18,0,False,7,9,-2,7,0,3
2,00:02:09,2,True,9,10,-1,48,10,3
4,00:12:08,0,False,17,17,0,34,0,3
4,00:11:41,0,False,17,17,0,36,0,3
4,00:09:32,2,False,17,17,0,51,7,3
1,00:14:30,1,True,0,0,0,43,10,3
1,00:12:55,2,True,0,0,0,54,4,3
1,00:00:01,2,False,7,0,7,40,20,3
2,00:14:38,1,True,0,7,-7,36,10,3
2,00:04:17,2,False,10,8,2,52,10,3
2,00:00:58,1,False,10,9,1,41,10,3
2,00:00:46,2,False,10,9,1,45,14,3
3,00:05:44,2,False,13,9,4,23,8,3
4,00:12:06,1,False,16,9,7,38,10,3
4,00:07:13,2,True,12,16,-4,34,6,3
4,00:05:59,1,True,12,19,-7,30,15,3
1,00:09:57,2,False,0,0,0,18,8,3
1,00:05:02,1,True,3,0,3,42,10,3
2,00:00:23,2,True,17,5,12,7,7,3
4,00:13:34,2,True,34,15,19,34,10,3
4,00:06:28,2,False,22,34,-12,14,10,3
1,00:09:06,2,False,1,7,-6,36,12,3
2,00:13:29,2,False,2,10,-8,26,9,3
2,00:08:57,1,False,2,13,-11,55,10,3
2,00:08:12,2,False,2,13,-11,46,19,3
2,00:00:51,1,False,5,13,-8,23,10,3
3,00:14:23,1,False,5,16,-11,44,10,3
4,00:13:05,1,True,30,28,2,33,10,3
4,00:10:15,2,True,30,28,2,39,5,3
4,00:06:00,2,True,30,30,0,35,10,3
4,00:00:48,2,False,37,30,7,11,8,3
1,00:12:25,2,True,0,0,0,40,10,3
1,00:06:00,1,False,0,7,-7,41,10,3
1,00:04:31,1,False,0,7,-7,51,10,3
2,00:14:54,1,False,0,14,-14,26,10,3
3,00:01:06,2,True,44,0,44,50,4,3
2,00:10:17,2,True,7,9,-2,36,9,3
2,00:05:46,2,False,9,7,2,43,10,3
2,00:03:15,1,False,9,7,2,25,10,3
2,00:00:47,2,True,10,9,1,35,10,3
3,00:13:32,1,True,10,12,-2,43,10,3
3,00:08:39,2,True,17,12,5,36,10,3
4,00:11:03,2,True,24,13,11,23,5,3
4,00:09:56,2,False,13,24,-11,45,10,3
4,00:07:56,2,False,13,24,-11,27,5,3
4,00:05:55,2,True,25,13,12,41,6,3
4,00:04:27,2,True,25,13,12,12,11,3
4,00:01:51,1,True,25,13,12,53,10,3
4,00:01:12,2,False,13,25,-12,52,9,3
2,00:13:29,1,True,7,10,-3,41,10,3
2,00:12:32,2,True,7,10,-3,40,11,3
2,00:04:47,2,True,7,11,-4,35,3,3
2,00:00:36,1,True,7,14,-7,41,10,3
2,00:00:29,2,True,7,14,-7,36,15,3
3,00:07:28,2,False,14,16,-2,36,10,3
4,00:09:24,2,False,21,23,-2,46,11,3
4,00:02:13,2,True,23,24,-1,35,10,3
2,00:13:25,0,True,6,8,-2,10,0,3
3,00:13:14,2,False,15,13,2,37,10,3
3,00:05:48,1,False,22,13,9,43,10,3
4,00:08:19,1,True,19,22,-3,16,10,3
4,00:04:08,2,True,19,22,-3,21,7,3
4,00:01:11,1,False,22,26,-4,28,10,3
4,00:00:33,1,True,26,22,4,53,10,3
1,00:05:00,2,False,0,8,-8,55,5,3
2,00:08:55,2,True,8,14,-6,38,4,3
2,00:03:54,1,True,8,14,-6,36,10,3
2,00:02:33,2,True,8,14,-6,51,10,3
1,00:08:20,2,False,0,7,-7,21,12,3
2,00:13:50,2,True,17,0,17,40,5,3
2,00:10:59,2,False,0,17,-17,51,10,3
2,00:05:47,2,False,0,17,-17,51,10,3
2,00:00:53,1,False,3,24,-21,26,10,3
4,00:14:32,1,False,4,24,-20,24,10,3
4,00:13:28,2,False,4,24,-20,40,26,3
1,00:05:37,2,False,14,3,11,55,11,3
2,00:10:45,2,True,11,14,-3,18,10,3
3,00:10:39,2,False,23,27,-4,35,10,3
3,00:08:28,2,False,23,27,-4,15,5,3
3,00:06:40,2,True,30,23,7,45,7,3
3,00:03:10,1,False,24,30,-6,36,10,3
3,00:02:32,2,False,24,30,-6,41,15,3
1,00:11:45,1,True,0,1,-1,14,10,3
1,00:07:45,1,True,0,8,-8,34,10,3
2,00:10:47,2,False,11,3,8,38,10,3
3,00:04:00,2,False,12,23,-11,44,7,3
4,00:00:14,0,True,29,31,-2,5,0,3
4,00:03:44,1,True,39,34,5,53,10,3
4,00:03:22,2,False,34,39,-5,48,19,3
1,00:04:19,2,True,5,0,5,31,8,3
1,00:03:11,1,False,0,5,-5,34,10,3
3,00:09:11,2,False,0,15,-15,39,10,3
4,00:12:45,1,False,7,22,-15,4,10,3
4,00:09:50,1,False,7,22,-15,3,3,3
4,00:02:02,1,True,36,14,22,38,10,3
2,00:03:03,1,False,6,24,-18,35,10,3
4,00:06:14,1,False,24,41,-17,35,10,3
4,00:05:32,2,False,24,41,-17,27,18,3
1,00:00:01,2,False,0,14,-14,6,5,3
2,00:07:35,2,True,20,0,20,3,3,3
2,00:01:39,2,False,4,20,-16,39,3,3
3,00:08:52,2,True,27,11,16,46,10,3
3,00:01:21,2,True,27,14,13,35,10,3
2,00:01:52,1,True,1,15,-14,37,10,3
3,00:05:20,1,False,36,4,32,39,10,3
4,00:13:28,1,True,6,39,-33,35,10,3
4,00:10:09,2,False,39,6,33,45,11,3
1,00:13:26,1,False,0,0,0,50,10,3
2,00:08:51,1,True,3,7,-4,42,10,3
2,00:04:33,2,False,8,3,5,34,13,3
2,00:01:14,1,False,8,3,5,22,10,3
2,00:00:20,2,True,3,8,-5,43,10,3
3,00:14:53,1,True,3,8,-5,31,10,3
3,00:12:18,2,True,3,8,-5,47,5,3
3,00:08:01,2,True,3,8,-5,46,10,3
3,00:05:24,2,True,3,8,-5,23,10,3
4,00:15:00,2,True,4,8,-4,39,10,3
4,00:11:00,2,True,4,9,-5,47,8,3
2,00:15:00,2,False,0,7,-7,11,10,3
3,00:14:26,2,True,14,3,11,27,10,3
4,00:10:20,1,True,17,9,8,36,10,3
4,00:07:53,2,False,9,17,-8,51,6,3
2,00:07:02,2,False,14,11,3,37,8,3
4,00:06:57,1,False,21,28,-7,29,10,3
4,00:04:46,2,False,21,35,-14,33,10,3
4,00:01:42,2,False,21,35,-14,42,7,3
1,00:11:18,1,True,0,7,-7,35,10,3
1,00:09:46,2,True,0,7,-7,15,30,3
1,00:01:34,2,False,16,7,9,51,10,3
2,00:12:39,1,False,7,10,-3,49,10,3
2,00:01:14,1,False,10,10,0,35,10,3
3,00:09:32,2,True,13,16,-3,42,10,3
3,00:01:56,2,False,19,13,6,43,3,3
3,00:00:46,1,False,19,13,6,15,10,3
4,00:02:03,2,False,19,25,-6,17,10,3
1,00:06:50,2,False,0,3,-3,39,9,3
2,00:01:20,2,True,11,14,-3,34,10,3
3,00:07:45,1,True,14,29,-15,31,10,3
4,00:13:23,2,True,14,29,-15,5,5,3
4,00:01:34,1,False,39,21,18,53,10,3
4,00:00:20,1,True,28,39,-11,52,10,3
1,00:14:20,2,True,0,0,0,27,10,3
1,00:11:53,1,True,0,0,0,3,3,3
1,00:08:38,2,False,7,0,7,40,2,3
1,00:07:39,0,True,3,7,-4,40,0,3
4,00:12:38,2,False,25,25,0,36,10,3
1,00:05:50,2,False,0,7,-7,27,14,3
3,00:05:44,1,False,16,7,9,50,10,3
4,00:07:12,2,True,7,19,-12,45,8,3
4,00:05:26,1,True,7,19,-12,43,10,3
4,00:05:04,2,True,7,19,-12,53,15,3
4,00:02:39,1,True,14,19,-5,35,10,3
4,00:00:35,3,True,14,22,-8,35,10,3
1,00:06:17,2,True,7,15,-8,52,3,3
1,00:02:23,1,False,15,7,8,23,10,3
3,00:03:39,2,True,14,40,-26,26,10,3
3,00:00:01,1,True,14,47,-33,13,10,3
4,00:12:52,2,True,14,47,-33,35,10,3
4,00:09:34,2,True,14,50,-36,37,8,3
1,00:09:57,1,True,7,0,7,44,10,3
1,00:09:25,2,True,7,0,7,37,17,3
1,00:06:52,1,False,0,7,-7,37,10,3
2,00:11:40,2,True,9,6,3,38,10,3
2,00:09:55,1,False,6,9,-3,49,10,3
2,00:05:46,2,True,9,6,3,47,7,3
2,00:00:18,2,False,13,12,1,53,9,3
3,00:11:50,2,False,13,14,-1,35,10,3
4,00:13:51,1,False,13,17,-4,26,10,3
4,00:12:07,2,False,13,18,-5,35,10,3
4,00:10:45,1,False,13,18,-5,42,10,3
4,00:07:18,1,False,13,18,-5,4,4,3
4,00:01:59,2,False,20,25,-5,37,9,3
1,00:14:52,1,True,0,0,0,51,10,3
2,00:09:38,2,True,3,0,3,44,6,3
2,00:01:10,2,True,3,0,3,18,10,3
4,00:00:59,1,True,3,17,-14,45,10,3
4,00:00:30,2,True,3,17,-14,42,25,3
1,00:10:32,2,False,0,0,0,53,10,3
2,00:13:43,1,True,1,7,-6,35,10,3
2,00:10:06,1,True,1,14,-13,51,10,3
2,00:05:39,2,False,14,1,13,52,10,3
2,00:01:18,1,True,6,21,-15,20,10,3
3,00:04:12,1,True,6,31,-25,35,10,3
4,00:13:13,2,True,9,31,-22,20,10,3
2,00:08:54,1,False,3,1,2,30,20,3
2,00:06:00,2,False,3,1,2,50,10,3
2,00:01:05,1,False,3,1,2,23,10,3
4,00:02:28,1,False,12,17,-5,35,10,3
1,00:02:37,1,True,0,17,-17,15,15,3
2,00:01:32,1,False,24,13,11,35,10,3
3,00:14:02,2,True,19,24,-5,51,5,3
4,00:11:52,2,True,35,24,11,32,15,3
4,00:00:42,1,True,38,27,11,46,10,3
1,00:04:55,2,True,0,3,-3,36,11,3
2,00:12:34,2,False,3,3,0,35,10,3
3,00:14:31,2,False,10,10,0,28,8,3
3,00:11:03,1,False,10,17,-7,31,10,3
1,00:00:38,1,False,3,0,3,40,10,3
1,00:00:01,2,False,3,0,3,40,10,3
1,00:00:01,2,False,3,0,3,40,10,3
2,00:14:13,2,False,3,1,2,35,10,3
2,00:03:57,2,True,2,3,-1,20,10,3
2,00:00:55,2,False,6,2,4,25,10,3
4,00:04:38,2,False,21,15,6,44,9,3
2,00:02:45,2,False,0,13,-13,47,10,3
3,00:14:50,1,False,0,16,-16,23,10,3
3,00:11:27,1,True,16,0,16,42,10,3
4,00:14:44,1,False,0,23,-23,28,10,3
4,00:13:56,2,False,0,23,-23,24,14,3
2,00:15:00,2,True,10,3,7,45,8,3
2,00:11:08,1,False,3,10,-7,22,10,3
2,00:00:18,2,False,6,20,-14,44,10,3
4,00:09:59,1,True,26,27,-1,54,10,3
2,00:14:32,1,False,8,7,1,29,20,3
2,00:01:22,1,True,14,14,0,35,10,3
3,00:06:19,3,False,24,14,10,36,2,3
4,00:00:17,2,True,24,37,-13,21,10,3
1,00:05:39,2,True,10,0,10,20,10,3
1,00:04:51,1,True,10,0,10,42,10,3
2,00:03:50,2,True,17,19,-2,36,10,3
2,00:01:37,1,False,26,17,9,33,10,3
2,00:00:38,1,True,17,26,-9,31,10,3
3,00:14:29,2,False,26,17,9,37,10,3
4,00:02:06,2,False,32,20,12,32,10,3
4,00:00:39,3,True,20,32,-12,17,10,3
1,00:14:01,1,True,0,0,0,54,10,3
1,00:13:08,2,False,0,0,0,49,17,3
1,00:02:52,1,True,0,3,-3,30,10,3
4,00:06:40,1,True,24,12,12,37,10,3
1,00:10:04,2,False,0,1,-1,38,7,3
1,00:07:18,2,True,1,0,1,14,8,3
2,00:14:14,1,True,8,1,7,17,10,3
2,00:03:04,2,False,1,15,-14,46,10,3
3,00:06:31,1,True,22,1,21,40,10,3
4,00:09:55,1,True,22,19,3,46,10,3
4,00:05:15,1,True,22,19,3,12,10,3
4,00:03:35,1,True,22,20,2,25,20,3
4,00:02:30,2,False,27,22,5,45,10,3
1,00:09:33,2,False,0,0,0,13,10,3
1,00:00:01,2,False,3,3,0,55,10,3
2,00:02:17,1,True,6,10,-4,12,10,3
3,00:10:55,2,False,17,6,11,15,10,3
3,00:06:13,2,True,8,17,-9,24,10,3
1,00:08:55,2,False,7,0,7,39,3,3
2,00:06:00,2,True,3,15,-12,47,3,3
3,00:09:16,2,False,22,9,13,19,12,3
3,00:01:35,2,False,22,16,6,52,9,3
4,00:05:52,2,True,19,30,-11,31,2,3
4,00:01:03,2,False,33,19,14,48,10,3
1,00:12:04,2,False,0,0,0,9,9,3
2,00:01:39,1,True,17,16,1,55,10,3
3,00:10:02,1,True,17,16,1,46,10,3
3,00:01:49,1,False,17,17,0,15,10,3
4,00:00:09,3,False,20,27,-7,55,15,3
2,00:01:31,2,True,3,15,-12,54,5,3
3,00:08:16,2,False,23,10,13,50,10,3
3,00:05:38,2,True,10,23,-13,42,10,3
3,00:02:47,2,True,10,23,-13,29,12,3
4,00:12:59,1,False,25,10,15,38,10,3
4,00:09:39,2,False,25,10,15,15,9,3
4,00:02:38,2,False,28,10,18,9,9,3
4,00:03:35,1,True,13,35,-22,35,10,3
4,00:00:02,1,False,38,13,25,47,15,3
3,00:04:00,2,True,26,17,9,18,11,3
4,00:13:37,2,False,20,26,-6,30,3,3
4,00:11:18,1,False,20,26,-6,5,10,3
3,00:04:27,1,True,3,32,-29,35,10,3
4,00:01:52,1,True,24,40,-16,2,2,3
1,00:00:01,2,False,10,0,10,49,6,3
2,00:01:05,1,False,17,7,10,43,10,3
2,00:00:41,1,True,7,17,-10,49,10,3
3,00:00:01,2,False,24,7,17,49,3,3
4,00:02:33,2,True,18,34,-16,50,8,3
3,00:00:01,2,False,11,35,-24,50,10,3
2,00:00:49,0,True,8,7,1,35,0,3
4,00:01:45,2,True,14,14,0,54,7,3
2,00:12:05,0,True,13,3,10,32,0,3
3,00:03:00,2,False,18,26,-8,55,11,3
4,00:02:27,2,True,33,26,7,41,10,3
2,00:14:23,2,True,14,7,7,52,8,3
3,00:12:08,2,True,21,16,5,32,9,3
1,00:07:41,2,True,0,0,0,38,10,3
1,00:06:25,2,True,0,3,-3,36,9,3
2,00:03:41,2,True,14,3,11,53,9,3
3,00:13:39,2,True,14,3,11,51,10,3
3,00:07:10,1,True,14,4,10,12,10,3
3,00:01:33,1,False,9,14,-5,42,10,3
1,00:10:04,1,True,7,0,7,7,7,3
3,00:14:23,2,False,16,17,-1,44,7,3
3,00:04:04,1,False,16,26,-10,6,6,3
1,00:14:42,1,False,0,0,0,35,10,3
1,00:11:38,1,False,0,0,0,51,10,3
1,00:03:35,2,True,0,12,-12,33,6,3
2,00:08:19,1,True,0,12,-12,33,10,3
2,00:05:22,1,False,15,0,15,5,5,3
4,00:13:02,1,False,28,27,1,17,10,3
4,00:09:02,1,True,27,31,-4,35,10,3
4,00:06:31,1,False,38,33,5,35,10,3
1,00:06:19,2,True,7,0,7,13,10,3
1,00:04:27,1,True,7,2,5,5,10,3
3,00:04:48,2,True,14,21,-7,44,17,3
4,00:14:32,1,True,14,21,-7,23,10,3
4,00:01:18,3,True,14,32,-18,38,7,3
1,00:00:07,1,False,1,9,-8,38,15,3
2,00:05:45,1,True,16,1,15,52,10,3
2,00:04:00,2,True,16,1,15,27,8,3
2,00:00:28,1,False,8,16,-8,54,10,3
4,00:05:08,1,False,18,24,-6,44,10,3
3,00:14:33,2,True,24,6,18,36,10,3
3,00:12:59,2,True,24,6,18,43,7,3
3,00:08:31,2,False,7,24,-17,36,10,3
4,00:06:31,2,False,14,27,-13,34,3,3
1,00:09:32,1,True,3,3,0,35,10,3
1,00:03:11,2,True,3,3,0,39,5,3
1,00:00:01,1,True,3,3,0,29,10,3
2,00:03:37,2,True,10,6,4,28,8,3
2,00:14:46,1,True,0,3,-3,27,10,3
2,00:08:45,2,True,3,10,-7,41,5,3
2,00:02:15,2,False,13,3,10,52,10,3
4,00:10:11,1,False,23,10,13,24,10,3
4,00:05:00,0,False,23,13,10,36,0,3
4,00:02:08,2,False,24,13,11,19,10,3
2,00:09:28,2,False,17,3,14,37,6,3
3,00:01:37,1,False,14,31,-17,52,10,3
4,00:04:25,1,False,14,32,-18,15,10,3
1,00:06:39,1,False,0,7,-7,34,10,3
1,00:06:16,0,True,7,0,7,28,0,3
4,00:15:00,0,False,3,34,-31,19,0,3
4,00:13:05,1,True,34,5,29,47,10,3
4,00:11:39,3,True,34,5,29,42,5,3
4,00:09:26,2,False,5,34,-29,18,4,3
2,00:02:01,1,True,21,10,11,40,10,3
4,00:01:57,3,False,21,36,-15,50,10,3
1,00:08:19,2,True,0,7,-7,6,6,3
1,00:07:05,2,True,0,10,-10,42,14,3
1,00:00:00,2,True,1,10,-9,18,7,3
3,00:09:56,2,False,15,22,-7,26,10,3
3,00:03:21,1,False,15,29,-14,36,10,3
3,00:01:04,2,True,29,15,14,51,9,3
4,00:14:20,1,False,15,29,-14,43,10,3
2,00:11:13,2,True,0,14,-14,25,10,3
3,00:04:18,2,False,23,10,13,45,1,3
1,00:13:15,1,True,0,0,0,19,10,3
1,00:09:13,1,False,3,0,3,18,10,3
2,00:08:20,2,True,10,3,7,5,5,3
2,00:05:24,2,True,10,6,4,46,10,3
3,00:06:11,1,True,19,15,4,50,10,3
3,00:02:51,2,True,19,15,4,23,10,3
4,00:14:15,1,False,18,19,-1,21,10,3
4,00:01:41,1,False,25,29,-4,29,10,3
1,00:14:30,2,True,0,0,0,44,10,3
1,00:08:34,1,False,0,7,-7,34,10,3
2,00:07:31,2,False,14,10,4,37,9,3
2,00:02:28,2,True,11,15,-4,40,5,3
2,00:00:37,2,True,11,15,-4,26,8,3
4,00:06:06,2,False,15,20,-5,36,9,3
1,00:10:02,2,True,0,0,0,33,9,3
2,00:15:00,1,True,7,4,3,35,10,3
2,00:00:46,1,False,4,17,-13,41,10,3
3,00:14:15,2,True,17,4,13,37,11,3
2,00:13:20,1,False,3,3,0,14,10,3
3,00:14:01,1,True,6,17,-11,15,10,3
4,00:04:16,2,False,30,7,23,46,3,3
2,00:03:45,1,True,10,10,0,35,10,3
4,00:09:49,1,False,23,23,0,43,10,3
4,00:09:08,0,True,23,23,0,42,0,3
4,00:00:13,1,False,30,26,4,36,10,3
4,00:00:01,1,False,30,26,4,25,10,3
1,00:12:50,1,False,0,0,0,54,10,3
1,00:03:48,2,False,0,0,0,23,13,3
2,00:00:43,1,True,13,17,-4,50,10,3
3,00:06:23,1,True,16,24,-8,50,20,3
3,00:05:00,0,False,24,16,8,29,0,3
1,00:08:47,2,False,0,0,0,40,7,3
1,00:13:00,1,True,0,0,0,8,8,3
1,00:07:11,2,False,3,7,-4,34,10,3
3,00:00:37,2,True,24,24,0,13,2,3
4,00:06:32,1,False,27,24,3,52,10,3
1,00:13:13,0,False,0,0,0,27,0,3
2,00:12:46,0,True,10,3,7,35,0,3
3,00:14:55,1,False,6,31,-25,31,10,3
4,00:04:51,1,False,16,38,-22,35,10,3
2,00:04:59,2,False,14,10,4,44,4,3
3,00:10:53,1,True,13,14,-1,38,10,3
3,00:03:51,2,True,13,14,-1,48,6,3
4,00:05:55,2,True,16,24,-8,37,10,3
2,00:05:21,2,True,7,3,4,29,10,3
3,00:05:02,2,False,4,11,-7,38,7,3
3,00:01:50,0,True,11,4,7,25,0,3
4,00:13:53,1,False,4,11,-7,28,10,3
4,00:12:24,2,True,11,4,7,52,14,3
4,00:02:34,2,True,11,11,0,38,10,3
4,00:02:10,1,False,11,11,0,55,10,3
1,00:05:03,1,True,0,7,-7,32,10,3
1,00:02:46,2,False,7,0,7,23,5,3
2,00:09:59,2,True,7,7,0,38,10,3
3,00:06:47,2,True,14,20,-6,48,10,3
4,00:07:50,2,False,23,21,2,19,10,3
4,00:02:47,2,True,28,23,5,28,8,3
3,00:13:57,2,False,14,10,4,42,10,3
4,00:10:30,2,False,21,17,4,43,8,3
4,00:06:59,2,True,17,21,-4,36,10,3
4,00:01:17,2,True,17,21,-4,28,10,3
1,00:04:28,2,False,0,7,-7,28,7,3
2,00:13:44,1,True,14,0,14,37,10,3
2,00:12:26,2,True,14,0,14,19,10,3
2,00:08:06,1,False,3,14,-11,26,10,3
4,00:01:23,2,False,20,20,0,46,10,3
1,00:00:01,2,True,14,3,11,2,2,3
2,00:03:45,1,False,6,21,-15,46,10,3
3,00:07:06,2,True,28,13,15,38,10,3
3,00:01:49,1,False,13,35,-22,29,10,3
4,00:14:21,1,True,35,13,22,33,10,3
4,00:13:30,2,True,35,13,22,30,13,3
4,00:12:52,1,False,13,35,-22,49,10,3
4,00:11:26,2,True,35,13,22,35,10,3
4,00:02:14,2,False,23,38,-15,35,10,3
4,00:00:49,2,False,23,41,-18,35,10,3
3,00:14:09,2,True,7,22,-15,40,10,3
3,00:02:03,2,False,23,10,13,40,13,3
4,00:12:11,1,False,26,10,16,53,10,3
4,00:09:55,2,False,26,10,16,50,7,3
4,00:01:57,2,False,26,10,16,47,8,3
1,00:12:10,1,False,0,0,0,21,20,3
2,00:11:49,1,False,0,7,-7,45,10,3
3,00:11:57,2,False,9,14,-5,52,10,3
4,00:07:26,2,False,16,14,2,55,5,3
1,00:09:25,2,False,0,7,-7,48,7,3
4,00:13:04,2,False,13,34,-21,48,10,3
4,00:05:32,1,False,13,37,-24,25,10,3
2,00:01:00,2,False,7,24,-17,45,5,3
2,00:00:11,1,False,7,24,-17,53,10,3
1,00:09:19,1,True,1,0,1,23,10,3
2,00:11:40,1,False,0,11,-11,40,10,3
2,00:06:34,2,True,11,0,11,46,10,3
2,00:02:15,2,True,11,0,11,42,9,3
3,00:01:12,2,True,15,0,15,33,4,3
1,00:10:27,2,True,7,0,7,50,13,3
1,00:03:14,1,False,7,7,0,37,10,3
2,00:12:54,2,True,14,7,7,4,4,3
2,00:11:25,2,True,14,10,4,33,4,3
2,00:08:57,1,True,14,10,4,28,10,3
4,00:09:15,1,True,17,27,-10,47,10,3
4,00:08:31,2,True,17,27,-10,42,15,3
1,00:10:50,2,False,0,3,-3,39,6,3
1,00:05:32,2,False,0,10,-10,14,7,3
1,00:01:59,0,True,12,0,12,40,0,3
2,00:02:38,1,False,1,21,-20,25,10,3
3,00:14:09,2,False,1,24,-23,43,10,3
3,00:07:48,1,True,31,1,30,48,15,3
3,00:07:14,2,True,31,1,30,49,16,3
3,00:02:51,1,False,3,31,-28,45,10,3
4,00:03:28,0,False,10,31,-21,25,0,3
4,00:02:20,1,False,10,31,-21,51,10,3
4,00:00:21,2,True,31,10,21,46,4,3
1,00:10:07,2,True,0,7,-7,21,8,3
2,00:02:06,2,True,14,21,-7,53,9,3
3,00:11:50,1,False,21,17,4,5,5,3
3,00:09:24,2,False,21,20,1,46,9,3
4,00:07:45,2,True,26,28,-2,27,10,3
1,00:12:39,2,False,0,0,0,39,6,3
1,00:07:01,1,False,0,7,-7,32,10,3
2,00:10:40,2,True,14,0,14,52,6,3
2,00:08:22,2,False,0,14,-14,51,10,3
2,00:01:22,2,False,0,17,-17,37,10,3
4,00:02:27,1,False,3,24,-21,46,10,3
1,00:14:21,2,False,0,0,0,30,8,3
2,00:07:18,2,False,7,10,-3,47,10,3
2,00:02:22,2,True,10,10,0,37,8,3
3,00:00:01,0,True,13,17,-4,45,0,3
4,00:05:11,1,False,24,22,2,46,10,3
4,00:04:34,2,False,24,22,2,36,20,3
2,00:10:05,1,False,0,17,-17,41,10,3
2,00:08:21,2,True,17,0,17,31,10,3
3,00:09:16,1,False,1,24,-23,30,10,3
3,00:06:19,2,False,1,24,-23,40,4,3
4,00:12:23,2,True,28,15,13,48,10,3
4,00:07:59,1,False,15,34,-19,26,10,3
4,00:01:20,1,True,48,15,33,52,10,3
1,00:03:49,2,False,10,7,3,39,10,3
2,00:13:20,1,True,10,10,0,55,10,3
2,00:11:58,1,False,10,10,0,51,15,3
2,00:04:19,1,False,10,10,0,40,20,3
3,00:10:13,2,False,19,20,-1,50,7,3
3,00:08:45,2,True,20,19,1,37,3,3
3,00:03:50,1,False,22,20,2,23,10,3
3,00:01:30,2,False,22,23,-1,22,10,3
1,00:14:18,2,False,0,0,0,21,7,3
2,00:10:22,2,False,0,1,-1,39,5,3
3,00:08:59,1,False,7,10,-3,32,10,3
3,00:08:32,2,False,7,10,-3,43,21,3
3,00:02:41,2,True,11,7,4,24,7,3
4,00:06:54,1,True,25,8,17,23,10,3
3,00:00:13,2,True,15,31,-16,32,10,3
4,00:02:41,2,False,34,15,19,46,10,3
1,00:06:32,2,True,0,1,-1,20,10,3
3,00:12:13,2,True,13,14,-1,45,16,3
3,00:08:51,2,False,14,13,1,55,7,3
3,00:03:31,2,True,13,14,-1,11,10,3
1,00:10:07,1,True,0,0,0,48,15,3
1,00:04:43,2,False,7,0,7,14,10,3
2,00:04:03,1,True,0,10,-10,10,10,3
2,00:01:52,1,False,13,0,13,10,10,3
3,00:13:28,2,False,13,3,10,36,10,3
3,00:12:07,2,True,3,13,-10,45,8,3
4,00:09:08,2,True,3,20,-17,15,2,3
4,00:06:31,2,True,3,23,-20,36,9,3
4,00:00:15,1,True,3,26,-23,31,10,3
2,00:08:01,1,True,6,4,2,30,10,3
2,00:06:05,1,True,6,7,-1,35,10,3
2,00:05:23,2,True,6,7,-1,34,11,3
2,00:00:39,2,False,7,6,1,12,7,3
3,00:14:32,1,True,9,7,2,35,20,3
3,00:08:12,2,True,9,7,2,35,10,3
3,00:02:31,1,False,7,12,-5,35,10,3
4,00:10:33,1,False,14,12,2,54,10,3
1,00:13:14,1,True,0,1,-1,50,10,3
3,00:05:54,1,True,7,4,3,17,10,3
3,00:02:26,1,False,7,7,0,53,10,3
4,00:02:53,2,True,10,7,3,13,10,3
4,00:00:19,1,False,7,10,-3,39,10,3
1,00:03:43,2,True,10,3,7,35,10,3
2,00:11:27,1,True,10,3,7,54,10,3
2,00:10:44,2,True,10,3,7,48,16,3
3,00:05:10,2,False,3,27,-24,42,5,3
4,00:13:30,1,False,3,34,-31,31,10,3
4,00:06:50,2,True,41,3,38,44,10,3
4,00:02:00,2,False,5,41,-36,43,10,3
3,00:11:14,2,True,13,20,-7,51,10,3
3,00:06:31,2,True,20,20,0,28,6,3
4,00:01:55,2,True,20,26,-6,53,0,3
4,00:01:22,1,False,26,20,6,20,10,3
1,00:02:09,1,True,0,6,-6,28,10,3
3,00:08:54,2,True,6,12,-6,39,6,3
3,00:00:01,2,True,6,23,-17,48,9,3
4,00:12:50,2,False,23,6,17,47,12,3
4,00:10:44,1,True,6,23,-17,34,10,3
4,00:09:05,2,True,6,23,-17,53,5,3
4,00:05:49,1,False,23,6,17,53,10,3
4,00:01:05,2,False,23,6,17,53,9,3
2,00:11:54,1,True,14,14,0,40,10,3
4,00:11:39,1,True,23,20,3,4,4,3
1,00:00:45,2,True,14,6,8,34,11,3
2,00:05:30,1,False,6,14,-8,29,5,3
2,00:02:31,2,False,6,21,-15,50,5,3
3,00:10:18,0,True,28,6,22,52,0,3
4,00:02:07,3,True,37,9,28,16,2,3
2,00:09:55,1,True,6,6,0,48,10,3
2,00:01:06,2,True,6,13,-7,29,10,3
4,00:14:30,1,False,20,20,0,29,10,3
4,00:09:15,2,False,20,29,-9,42,17,3
3,00:05:35,2,True,5,17,-12,25,10,3
3,00:03:12,2,True,5,17,-12,50,15,3
4,00:03:58,1,True,5,21,-16,23,10,3
2,00:07:54,2,True,7,10,-3,40,5,3
3,00:09:16,2,True,21,10,11,54,9,3
2,00:11:43,2,False,24,0,24,55,6,3
3,00:05:18,2,True,7,35,-28,48,11,3
4,00:10:41,2,False,35,7,28,30,6,3
4,00:08:30,2,True,7,35,-28,24,6,3
4,00:01:09,2,True,14,38,-24,30,10,3
1,00:12:08,1,False,0,0,0,48,10,3
1,00:09:16,1,True,0,0,0,42,20,3
1,00:02:01,2,False,3,0,3,26,10,3
3,00:02:33,2,True,10,3,7,28,9,3
4,00:13:28,2,False,13,10,3,40,5,3
4,00:00:21,1,True,17,23,-6,25,20,3
2,00:12:20,2,False,10,5,5,21,18,3
3,00:13:01,2,False,30,8,22,38,7,3
3,00:02:29,1,True,11,30,-19,30,10,3
4,00:02:01,3,True,17,30,-13,46,10,3
4,00:00:48,1,False,33,17,16,35,10,3
1,00:12:03,2,False,0,0,0,14,4,3
2,00:01:13,2,True,17,16,1,23,6,3
4,00:14:34,2,False,26,27,-1,49,5,3
4,00:13:41,1,True,27,26,1,20,10,3
4,00:03:09,2,False,29,30,-1,4,4,3
2,00:15:00,2,False,0,7,-7,34,10,3
2,00:07:55,1,True,14,0,14,50,10,3
2,00:00:40,1,False,7,28,-21,35,10,3
3,00:02:21,2,False,14,31,-17,34,6,3
4,00:09:35,1,False,17,35,-18,35,10,3
2,00:01:14,1,False,14,14,0,25,10,3
3,00:12:32,2,True,21,14,7,41,15,3
4,00:12:22,2,False,21,28,-7,19,25,3
4,00:02:42,2,False,21,38,-17,54,4,3
4,00:02:00,1,True,38,21,17,35,10,3
2,00:15:00,2,True,4,0,4,38,10,3
2,00:09:51,2,True,7,1,6,28,10,3
3,00:13:55,1,True,8,4,4,53,10,3
3,00:07:56,1,True,8,4,4,54,10,3
1,00:14:54,1,True,0,0,0,29,10,3
1,00:13:00,1,True,0,0,0,55,10,3
3,00:07:25,2,True,7,17,-10,24,10,3
3,00:04:24,2,False,20,7,13,44,4,3
3,00:02:25,1,True,10,20,-10,49,10,3
4,00:13:47,2,True,17,20,-3,45,5,3
4,00:11:29,1,True,17,20,-3,35,10,3
4,00:04:44,1,False,23,20,3,50,10,3
1,00:11:00,0,False,0,0,0,35,0,3
1,00:03:06,1,False,0,0,0,47,10,3
2,00:05:19,0,False,4,4,0,48,0,3
3,00:14:52,1,False,4,4,0,45,10,3
4,00:04:50,2,False,4,12,-8,23,10,3
4,00:01:46,3,False,11,13,-2,46,4,3
1,00:07:56,1,True,0,7,-7,26,10,3
1,00:02:50,2,True,0,10,-10,50,6,3
2,00:01:58,2,True,6,13,-7,41,4,3
2,00:01:05,1,False,13,6,7,42,10,3
2,00:00:59,2,False,13,6,7,35,17,3
1,00:04:11,1,True,1,0,1,6,10,3
2,00:07:19,1,True,1,0,1,19,10,3
2,00:04:01,1,True,1,3,-2,12,10,3
3,00:11:56,2,False,6,8,-2,13,10,3
4,00:10:14,2,False,13,11,2,11,5,3
1,00:13:49,1,False,0,0,0,37,10,3
2,00:10:53,2,False,7,14,-7,28,10,3
2,00:05:59,1,False,7,24,-17,28,10,3
2,00:02:47,2,False,7,24,-17,21,10,3
3,00:12:37,1,True,31,10,21,17,10,3
3,00:06:47,2,True,31,16,15,34,11,3
4,00:11:35,2,True,31,24,7,47,10,3
4,00:01:06,2,False,27,34,-7,46,6,3
1,00:12:03,1,False,0,7,-7,45,10,3
2,00:05:28,2,False,8,7,1,44,14,3
4,00:05:37,2,True,7,18,-11,35,10,3
4,00:01:06,1,False,32,7,25,29,10,3
1,00:11:49,2,False,0,3,-3,37,7,3
1,00:03:36,2,False,0,10,-10,40,7,3
2,00:07:12,1,False,3,10,-7,11,10,3
3,00:09:58,2,True,16,9,7,36,7,3
3,00:08:07,1,False,12,16,-4,36,10,3
4,00:08:17,2,True,16,19,-3,35,6,3
1,00:12:20,2,True,0,0,0,15,10,3
2,00:04:09,2,False,3,8,-5,21,20,3
2,00:12:51,2,False,7,0,7,17,18,3
2,00:00:50,1,False,7,14,-7,45,10,3
3,00:01:44,2,True,21,21,0,35,10,3
4,00:08:36,2,True,21,24,-3,38,4,3
2,00:13:26,0,False,3,10,-7,29,0,3
2,00:02:06,2,True,13,3,10,46,10,3
3,00:10:45,2,False,12,13,-1,40,10,3
3,00:09:31,1,False,12,13,-1,27,10,3
3,00:01:34,2,False,12,13,-1,42,8,3
4,00:14:23,2,False,12,13,-1,35,14,3
4,00:02:09,1,False,12,13,-1,25,10,3
1,00:09:35,2,False,0,8,-8,34,11,3
1,00:03:36,2,False,7,8,-1,34,4,3
2,00:05:53,1,True,15,7,8,47,10,3
2,00:00:46,1,True,15,10,5,37,10,3
1,00:10:32,2,False,0,3,-3,49,7,3
3,00:13:02,1,True,5,6,-1,31,10,3
3,00:03:14,2,False,7,5,2,47,10,3
3,00:02:02,1,True,5,7,-2,41,10,3
4,00:05:46,2,False,7,5,2,25,7,3
1,00:06:14,1,True,0,3,-3,27,10,3
2,00:11:51,2,False,3,0,3,35,9,3
3,00:11:25,1,True,10,17,-7,28,10,3
4,00:04:30,1,False,34,20,14,21,10,3
1,00:02:18,1,True,7,10,-3,15,10,3
2,00:07:04,1,True,7,17,-10,36,10,3
2,00:02:19,1,True,7,17,-10,4,4,3
2,00:01:06,1,True,7,20,-13,50,10,3
3,00:03:57,1,False,24,17,7,41,10,3
4,00:10:54,2,False,24,31,-7,44,10,3
1,00:07:28,2,True,0,0,0,27,6,3
2,00:09:00,2,True,8,8,0,30,5,3
2,00:01:25,1,True,8,20,-12,30,10,3
3,00:03:04,2,True,15,30,-15,53,15,3
4,00:12:44,2,False,30,16,14,36,6,3
4,00:03:40,1,True,17,30,-13,52,10,3
4,00:01:22,2,False,30,24,6,44,9,3
4,00:00:44,2,True,24,30,-6,43,2,3
3,00:01:34,1,False,9,9,0,23,10,3
4,00:08:15,1,False,16,19,-3,15,10,3
4,00:00:46,3,True,33,16,17,45,10,3
2,00:14:23,1,False,15,3,12,40,10,3
3,00:07:37,2,False,32,18,14,17,20,3
1,00:08:51,2,True,0,0,0,39,5,3
2,00:12:26,1,False,3,3,0,20,10,3
2,00:00:31,2,False,3,15,-12,44,6,3
4,00:08:09,1,False,9,19,-10,35,10,3
4,00:02:56,1,False,9,26,-17,36,10,3
1,00:03:04,1,True,6,0,6,27,10,3
1,00:01:05,2,False,0,6,-6,37,8,3
2,00:13:24,1,False,0,13,-13,38,10,3
2,00:02:08,2,False,3,13,-10,36,10,3
2,00:00:19,1,False,3,13,-10,14,10,3
3,00:11:56,1,False,3,13,-10,42,10,3
3,00:06:12,2,False,3,20,-17,46,10,3
4,00:02:58,2,False,3,27,-24,17,8,3
2,00:12:19,1,False,11,0,11,30,10,3
3,00:14:07,2,False,21,9,12,41,8,3
3,00:08:46,2,True,9,28,-19,18,10,3
3,00:07:21,2,True,9,28,-19,54,10,3
4,00:11:05,2,False,30,9,21,34,3,3
1,00:09:37,2,True,0,0,0,40,9,3
1,00:02:56,1,False,0,0,0,40,10,3
1,00:02:38,2,False,0,0,0,39,11,3
2,00:09:08,1,True,3,1,2,36,10,3
2,00:08:35,2,True,3,1,2,26,20,3
2,00:06:04,2,False,1,3,-2,41,10,3
2,00:01:18,0,False,8,3,5,25,0,3
2,00:00:40,1,False,15,3,12,55,10,3
3,00:10:23,1,False,15,6,9,51,10,3
3,00:08:36,1,True,6,15,-9,28,10,3
3,00:04:49,2,False,15,6,9,45,10,3
1,00:12:37,2,True,0,0,0,17,7,3
4,00:02:36,1,False,15,31,-16,40,10,3
1,00:10:57,2,True,0,0,0,34,14,3
2,00:13:10,1,False,8,3,5,20,10,3
2,00:07:24,1,True,3,8,-5,7,7,3
3,00:13:45,1,False,22,10,12,37,10,3
3,00:00:45,2,False,29,17,12,32,4,3
4,00:10:39,1,True,24,29,-5,43,10,3
5,00:00:00,1,False,32,35,-3,35,10,3
4,00:05:44,2,True,7,15,-8,44,1,3
4,00:00:02,0,True,7,15,-8,7,0,3
1,00:02:13,2,False,0,10,-10,30,9,3
2,00:15:00,2,False,0,10,-10,53,10,3
2,00:01:32,1,False,0,14,-14,54,10,3
3,00:14:14,2,False,0,14,-14,38,6,3
3,00:04:11,1,True,17,0,17,37,10,3
4,00:14:05,2,True,17,0,17,53,5,3
4,00:00:47,1,False,0,24,-24,36,10,3
1,00:09:45,2,True,0,3,-3,53,10,3
1,00:07:12,2,True,0,3,-3,48,2,3
1,00:01:42,1,True,0,3,-3,34,10,3
2,00:11:53,2,False,3,2,1,52,11,3
2,00:00:46,1,True,5,10,-5,31,10,3
3,00:08:50,1,True,5,13,-8,50,10,3
3,00:12:27,1,False,7,3,4,35,10,3
3,00:08:55,1,False,7,5,2,27,10,3
3,00:03:48,2,False,7,8,-1,29,6,3
4,00:09:27,2,False,7,14,-7,50,10,3
4,00:04:25,1,True,14,7,7,53,10,3
2,00:14:26,2,True,7,10,-3,54,2,3
2,00:11:53,2,False,10,7,3,32,3,3
3,00:09:50,2,True,31,17,14,54,8,3
4,00:13:18,1,False,20,42,-22,35,10,3
4,00:09:20,2,True,42,20,22,17,7,3
4,00:08:33,3,True,42,20,22,25,15,3
4,00:02:19,1,True,42,20,22,45,10,3
1,00:08:52,1,True,0,0,0,25,10,3
2,00:02:52,2,False,9,0,9,53,13,3
4,00:07:11,1,True,24,24,0,17,10,3
4,00:00:01,1,False,31,24,7,37,10,3
1,00:09:16,2,False,0,7,-7,30,7,3
4,00:14:02,2,False,21,26,-5,35,10,3
4,00:12:38,1,False,21,26,-5,14,10,3
4,00:01:13,1,False,24,33,-9,47,10,3
2,00:01:34,2,False,10,6,4,24,10,3
2,00:00:31,1,True,9,10,-1,51,10,3
4,00:07:56,2,False,17,12,5,13,10,3
4,00:01:18,1,True,19,17,2,49,10,3
1,00:14:30,1,True,0,0,0,23,10,3
2,00:07:19,1,False,13,0,13,49,10,3
2,00:00:25,2,False,20,7,13,19,9,3
3,00:02:59,1,True,13,30,-17,28,10,3
4,00:01:04,1,False,33,34,-1,51,10,3
4,00:00:45,0,True,34,33,1,46,0,3
2,00:11:29,2,True,3,0,3,48,10,3
1,00:10:43,1,True,0,0,0,22,10,3
1,00:08:31,2,False,0,0,0,54,6,3
2,00:11:12,1,False,7,0,7,45,10,3
3,00:13:07,1,False,7,14,-7,16,10,3
3,00:03:57,1,False,7,31,-24,28,10,3
4,00:02:37,2,True,37,9,28,49,10,3
4,00:02:29,3,True,37,9,28,50,11,3
1,00:13:58,2,False,0,0,0,46,3,3
2,00:13:07,1,False,0,11,-11,35,10,3
2,00:02:27,2,False,0,28,-28,2,12,3
3,00:11:37,2,False,0,37,-37,7,4,3
4,00:15:00,1,False,6,40,-34,36,10,3
2,00:13:37,2,False,0,4,-4,34,9,3
2,00:09:30,2,False,1,4,-3,52,7,3
2,00:02:27,1,False,1,4,-3,43,10,3
2,00:02:10,2,False,1,4,-3,38,15,3
3,00:12:10,2,True,7,1,6,47,8,3
3,00:10:34,2,True,7,1,6,10,15,3
3,00:06:40,1,True,7,3,4,38,10,3
3,00:04:00,2,True,7,3,4,40,9,3
2,00:02:18,2,False,10,6,4,37,10,3
3,00:06:45,1,True,6,13,-7,42,10,3
2,00:06:09,2,False,16,6,10,8,8,3
4,00:11:46,2,True,16,23,-7,27,4,3
4,00:05:06,2,True,23,26,-3,39,6,3
1,00:05:59,2,False,0,3,-3,38,17,3
2,00:08:13,1,True,3,3,0,23,10,3
2,00:07:46,2,True,3,3,0,24,11,3
2,00:07:45,1,False,7,7,0,43,10,3
2,00:04:48,2,True,7,7,0,31,7,3
2,00:02:53,2,False,10,7,3,34,11,3
3,00:05:07,1,False,23,7,16,43,5,3
3,00:03:07,2,False,23,7,16,10,10,3
1,00:08:13,1,False,0,1,-1,54,10,3
2,00:11:58,1,True,8,3,5,50,10,3
2,00:06:03,1,True,8,10,-2,54,10,3
3,00:14:52,1,False,20,15,5,36,10,3
3,00:05:00,2,False,27,15,12,47,10,3
3,00:02:56,2,True,15,27,-12,50,10,3
1,00:10:52,2,False,0,2,-2,17,14,3
1,00:09:43,1,False,0,5,-5,45,10,3
2,00:14:53,1,False,0,15,-15,36,10,3
2,00:14:26,2,False,0,15,-15,34,12,3
4,00:00:03,1,False,24,26,-2,48,10,3
1,00:11:50,2,False,0,0,0,31,7,3
1,00:05:22,2,True,4,7,-3,30,10,3
1,00:01:50,2,True,4,7,-3,45,6,3
2,00:07:57,2,False,7,4,3,8,8,3
3,00:08:06,2,False,13,14,-1,34,10,3
4,00:13:27,1,False,13,17,-4,50,10,3
4,00:12:51,2,False,13,17,-4,54,14,3
4,00:11:37,2,False,13,17,-4,29,6,3
4,00:08:47,2,True,17,20,-3,49,7,3
4,00:06:24,1,True,17,21,-4,35,10,3
4,00:01:06,2,True,23,28,-5,43,8,3
4,00:00:02,1,False,28,23,5,50,10,3
1,00:12:06,1,False,0,0,0,37,10,3
1,00:07:41,1,False,0,0,0,13,10,3
2,00:14:43,2,True,8,0,8,32,10,3
2,00:00:59,1,True,15,14,1,26,15,3
3,00:14:54,1,False,14,15,-1,38,10,3
4,00:08:29,2,False,27,22,5,23,8,3
4,00:05:34,1,True,25,27,-2,8,10,3
2,00:00:08,2,True,10,3,7,7,7,3
4,00:13:39,2,True,11,9,2,40,20,3
4,00:01:28,1,False,18,11,7,13,10,3
2,00:12:50,1,False,3,10,-7,27,10,3
2,00:05:48,2,False,3,17,-14,27,10,3
3,00:12:30,2,False,3,20,-17,42,8,3
4,00:03:15,2,False,3,37,-34,44,5,3
1,00:07:42,2,False,0,0,0,30,9,3
3,00:12:38,2,True,7,11,-4,43,8,3
4,00:02:35,1,False,14,17,-3,23,10,3
2,00:13:38,2,True,17,0,17,50,3,3
2,00:04:19,2,False,0,17,-17,7,7,3
3,00:10:50,2,False,1,20,-19,34,10,3
4,00:07:04,2,False,5,23,-18,40,5,3
3,00:09:40,2,False,24,13,11,45,10,3
4,00:07:58,2,False,30,16,14,30,4,3
4,00:01:41,2,True,16,33,-17,45,10,3
4,00:00:20,1,True,16,33,-17,25,10,3
1,00:06:05,2,False,1,0,1,47,6,3
4,00:06:06,2,True,24,10,14,35,10,3
1,00:11:10,2,True,0,0,0,44,10,3
1,00:03:01,1,True,1,0,1,31,10,3
4,00:14:06,2,True,36,3,33,42,4,3
4,00:09:48,2,False,3,50,-47,37,4,3
1,00:09:21,1,True,7,0,7,18,10,3
3,00:00:20,1,True,36,18,18,54,10,3
4,00:13:17,1,True,36,18,18,40,10,3
4,00:01:17,0,True,43,18,25,37,0,3
3,00:04:20,1,False,7,20,-13,35,10,3
4,00:02:21,2,True,20,13,7,24,10,3
4,00:00:35,1,False,16,20,-4,12,10,3
1,00:07:01,2,True,3,0,3,38,10,3
2,00:11:39,2,False,0,7,-7,21,4,3
3,00:09:46,1,True,17,7,10,49,10,3
3,00:03:58,1,True,18,7,11,40,10,3
3,00:00:55,2,True,18,10,8,37,8,3
3,00:00:03,1,False,10,18,-8,50,10,3
4,00:08:20,1,False,10,18,-8,40,10,3
4,00:04:05,2,False,10,18,-8,41,6,3
4,00:02:10,2,True,18,10,8,54,20,3
1,00:06:12,2,True,0,7,-7,41,9,3
1,00:01:45,1,False,7,3,4,31,10,3
1,00:01:26,1,True,7,0,7,50,10,3
3,00:11:57,2,False,0,27,-27,29,13,3
4,00:02:38,1,True,37,7,30,17,10,3
4,00:02:14,2,True,37,7,30,22,15,3
2,00:12:15,1,True,6,3,3,44,10,3
2,00:09:35,1,False,6,6,0,46,10,3
3,00:12:51,1,False,13,6,7,49,10,3
3,00:10:36,1,True,7,13,-6,34,10,3
4,00:01:09,3,False,34,27,7,52,10,3
1,00:06:30,1,True,3,0,3,5,10,3
1,00:02:52,2,True,3,3,0,42,10,3
1,00:01:07,0,False,3,3,0,54,0,3
2,00:02:17,2,True,6,3,3,22,10,3
3,00:11:20,2,False,6,9,-3,25,12,3
3,00:02:46,2,True,12,6,6,43,10,3
4,00:02:32,1,False,6,20,-14,26,10,3
4,00:01:08,2,False,6,20,-14,22,10,3
1,00:10:55,2,False,0,0,0,43,2,3
2,00:02:19,2,False,4,3,1,40,10,3
2,00:00:33,1,True,3,12,-9,30,10,3
3,00:08:33,2,True,3,12,-9,53,7,3
3,00:01:20,2,True,3,19,-16,53,5,3
3,00:01:59,2,False,30,7,23,10,5,3
2,00:00:15,2,False,20,7,13,22,10,3
3,00:13:30,2,True,7,20,-13,42,10,3
2,00:07:05,1,False,10,16,-6,26,10,3
4,00:00:15,2,True,30,37,-7,48,10,3
2,00:10:20,2,True,6,3,3,8,10,3
4,00:09:38,2,True,16,20,-4,35,10,3
4,00:06:30,2,False,20,16,4,45,20,3
1,00:03:28,2,False,7,7,0,54,7,3
2,00:14:29,2,True,7,15,-8,43,15,3
2,00:08:51,1,False,15,9,6,49,10,3
2,00:05:05,2,False,15,10,5,42,3,3
2,00:01:09,1,True,10,18,-8,35,10,3
3,00:06:10,1,False,18,18,0,29,10,3
4,00:00:33,2,True,21,23,-2,45,10,3
2,00:10:36,1,False,7,10,-3,51,10,3
3,00:13:26,1,False,10,10,0,47,10,3
3,00:05:18,2,False,10,16,-6,41,11,3
3,00:04:18,2,True,16,10,6,41,10,3
4,00:07:23,2,True,25,11,14,54,9,3
4,00:05:30,2,False,11,25,-14,9,4,3
1,00:06:41,2,False,0,0,0,53,15,3
1,00:00:55,2,True,7,10,-3,31,10,3
2,00:02:15,2,False,38,7,31,55,11,3
3,00:03:27,0,True,18,41,-23,55,0,3
4,00:05:28,2,True,26,52,-26,35,10,3
1,00:01:32,2,True,7,0,7,47,10,3
2,00:13:27,2,False,0,7,-7,27,10,3
2,00:12:56,2,True,0,3,-3,17,8,3
2,00:09:39,1,True,0,3,-3,17,10,3
2,00:01:25,2,False,7,7,0,53,6,3
3,00:12:46,1,False,9,10,-1,26,20,3
1,00:11:50,1,True,0,0,0,36,10,3
2,00:07:44,1,False,10,3,7,15,10,3
2,00:02:19,2,True,9,10,-1,54,3,3
3,00:05:59,2,True,20,10,10,30,10,3
5,00:00:00,0,False,34,34,0,3,0,3
1,00:07:16,1,False,0,7,-7,25,10,3
2,00:07:55,1,False,0,26,-26,29,10,3
3,00:05:03,1,True,43,14,29,43,10,3
3,00:02:24,0,False,14,43,-29,48,0,3
4,00:13:31,0,False,14,43,-29,21,0,3
4,00:05:41,1,True,46,17,29,22,10,3
1,00:14:18,2,True,0,0,0,28,8,3
1,00:13:35,1,True,0,0,0,49,10,3
1,00:05:21,2,False,0,3,-3,48,7,3
2,00:12:07,2,False,3,6,-3,50,20,3
3,00:10:02,2,False,13,19,-6,34,10,3
2,00:05:31,1,False,7,6,1,41,10,3
1,00:11:25,2,True,0,0,0,47,4,3
2,00:04:02,1,False,7,14,-7,50,10,3
4,00:12:55,1,True,22,20,2,30,15,3
2,00:00:55,2,True,7,7,0,39,5,3
4,00:11:04,1,False,13,14,-1,22,10,3
4,00:10:37,2,False,13,14,-1,14,18,3
1,00:00:12,1,True,0,5,-5,50,10,3
2,00:02:24,2,True,0,8,-8,52,5,3
4,00:02:13,2,True,12,23,-11,41,4,3
4,00:01:57,3,True,12,23,-11,30,15,3
1,00:14:20,2,True,0,0,0,32,4,3
4,00:03:46,2,False,27,14,13,29,10,3
1,00:00:19,2,False,16,8,8,43,4,3
2,00:07:06,2,True,16,16,0,18,10,3
4,00:12:07,1,False,22,23,-1,48,20,3
1,00:01:35,1,False,11,0,11,23,10,3
2,00:09:30,0,True,8,19,-11,27,0,3
3,00:01:13,1,True,20,23,-3,46,10,3
4,00:13:24,1,False,23,20,3,33,10,3
5,00:00:00,0,False,26,26,0,35,0,3
2,00:09:18,2,True,21,7,14,24,15,3
1,00:06:49,2,False,0,0,0,17,9,3
2,00:00:15,2,True,4,3,1,46,2,3
3,00:09:11,2,False,3,4,-1,51,8,3
3,00:08:20,1,False,3,4,-1,14,10,3
4,00:01:18,2,False,3,32,-29,50,15,3
1,00:02:43,2,True,3,7,-4,45,8,3
3,00:06:36,2,True,21,17,4,52,9,3
4,00:13:12,2,True,21,20,1,30,15,3
1,00:12:58,1,False,0,0,0,52,10,3
3,00:02:55,1,True,10,15,-5,18,10,3
3,00:01:05,2,True,10,15,-5,30,5,3
4,00:02:39,3,False,18,13,5,33,5,3
3,00:09:50,3,False,23,10,13,12,2,20
2,00:00:07,2,True,14,7,7,7,12,20
1,00:06:19,1,True,0,0,0,1,10,20
1,00:05:49,3,False,0,0,0,5,20,20
1,00:02:07,3,True,3,0,3,10,7,20
3,00:11:40,3,False,14,7,7,3,10,20
2,00:04:02,3,False,20,11,9,8,11,20
1,00:12:35,3,False,0,0,0,9,7,20
1,00:02:27,0,True,14,0,14,28,0,20
3,00:02:36,3,False,36,4,32,5,12,20
1,00:09:30,3,True,0,7,-7,1,44,20
4,00:14:35,3,False,19,13,6,5,20,20
4,00:04:44,3,True,3,15,-12,13,6,20
4,00:01:33,3,False,35,9,26,10,11,20
2,00:13:39,3,True,1,1,0,1,10,20
2,00:13:37,3,True,10,3,7,2,10,20
3,00:10:10,3,False,17,6,11,8,17,20
4,00:10:36,3,False,17,17,0,5,6,20
3,00:00:06,3,True,10,23,-13,3,9,20
4,00:10:15,2,False,20,26,-6,1,14,20
3,00:02:28,3,False,11,9,2,11,10,20
2,00:07:51,3,True,14,7,7,8,10,20
4,00:02:10,3,False,22,24,-2,1,10,20
3,00:04:54,3,False,16,24,-8,9,11,20
1,00:05:36,3,True,7,0,7,7,16,20
1,00:03:03,3,True,7,2,5,2,13,20
1,00:04:49,2,False,1,0,1,40,3,20
4,00:14:02,3,True,34,3,31,8,17,20
4,00:08:38,3,False,5,34,-29,6,16,20
4,00:03:56,3,False,21,27,-6,6,5,20
2,00:14:47,3,True,1,10,-9,10,15,20
4,00:14:52,3,False,15,17,-2,4,12,20
1,00:04:33,3,False,0,10,-10,13,8,20
2,00:09:54,0,True,19,0,19,23,0,20
3,00:04:31,3,True,31,1,30,9,3,20
4,00:02:07,1,False,11,25,-14,1,10,20
3,00:02:56,3,True,13,14,-1,4,17,20
4,00:04:22,3,True,41,3,38,5,6,20
4,00:00:44,3,False,26,20,6,22,8,20
4,00:12:40,3,True,5,17,-12,5,8,20
4,00:10:06,3,True,5,19,-14,13,6,20
2,00:12:05,0,True,0,7,-7,12,0,20
2,00:07:48,3,False,7,2,5,5,8,20
1,00:02:07,1,True,10,1,9,1,10,20
3,00:12:26,3,True,13,10,3,3,11,20
2,00:03:39,1,False,3,3,0,1,10,20
2,00:08:30,0,False,8,8,0,22,0,20
1,00:07:15,3,False,0,0,0,12,5,20
4,00:11:51,3,True,9,28,-19,13,12,20
2,00:13:06,3,False,0,10,-10,9,7,20
2,00:13:56,1,False,3,0,3,9,10,20
3,00:10:01,3,False,7,3,4,13,5,20
1,00:06:00,0,False,0,0,0,22,0,20
4,00:07:17,3,False,17,12,5,7,16,20
4,00:04:09,3,False,17,14,3,9,8,20
4,00:10:53,3,True,34,7,27,13,9,20
3,00:09:53,3,True,7,1,6,5,20,20
3,00:02:08,3,False,23,7,16,10,4,20
4,00:09:45,3,False,27,21,6,4,13,20
4,00:00:11,3,False,18,11,7,26,1,20
2,00:01:13,3,True,7,20,-13,3,10,20
4,00:01:37,3,False,26,13,13,20,1,20
2,00:09:25,3,True,6,3,3,4,14,20
1,00:12:44,1,False,0,0,0,1,10,20
3,00:08:07,3,False,41,13,28,10,15,20
3,00:13:57,0,False,7,10,-3,23,0,20
1,00:12:07,3,True,0,0,0,10,9,20
4,00:10:30,0,False,21,23,-2,5,0,52
4,00:00:01,0,False,30,44,-14,5,0,52
5,00:14:59,0,False,33,27,6,5,0,52
2,00:09:00,0,True,9,14,-5,5,0,52
4,00:12:57,0,True,26,21,5,5,0,52
4,00:00:29,0,True,17,35,-18,5,0,52
4,00:10:26,0,False,17,22,-5,5,0,52
2,00:03:29,0,False,13,3,10,5,0,52
4,00:07:58,0,False,24,26,-2,5,0,52
4,00:00:49,0,True,30,32,-2,5,0,52
3,00:02:12,0,True,6,24,-18,5,0,52
3,00:00:01,0,True,14,24,-10,5,0,52
4,00:08:27,0,True,22,24,-2,5,0,52
4,00:02:14,0,False,9,50,-41,5,0,52
4,00:11:03,0,True,18,6,12,3,0,52
3,00:10:57,0,False,28,7,21,3,0,52
4,00:13:45,0,True,22,11,11,3,0,52
3,00:01:08,0,False,47,18,29,3,0,52
4,00:09:55,0,False,9,25,-16,3,0,52
5,00:00:00,0,False,40,34,6,3,0,52
2,00:03:06,0,False,6,29,-23,3,0,52
3,00:04:58,0,False,13,9,4,3,0,52
4,00:01:38,0,True,24,29,-5,3,0,52
2,00:05:54,0,True,12,7,5,3,0,52
1,00:00:49,0,True,6,16,-10,13,0,52
1,00:08:13,0,False,6,0,6,3,0,52
1,00:00:06,0,True,6,11,-5,3,0,52
2,00:11:24,0,False,17,8,9,3,0,52
3,00:03:35,0,False,16,21,-5,3,0,52
2,00:00:13,0,True,12,14,-2,3,0,52
4,00:06:45,0,False,26,21,5,3,0,52
4,00:02:47,0,False,21,20,1,2,0,55
4,00:00:25,0,False,30,33,-3,1,0,55
2,00:01:16,0,False,10,3,7,3,0,55
3,00:08:04,0,False,11,13,-2,3,0,55
3,00:06:28,0,True,16,18,-2,3,0,55
3,00:02:37,0,False,21,23,-2,3,0,55
4,00:11:50,0,True,24,49,-25,2,0,55
