1,812,1,1,0,0,0,54,10,1
1,788,2,1,0,0,0,54,10,1
1,752,1,0,0,0,0,12,10,1
1,743,2,0,0,0,0,12,10,1
1,689,2,0,0,0,0,31,4,1
1,553,1,0,0,0,0,54,10,1
1,385,2,1,0,0,0,32,8,1
1,284,1,1,0,0,0,34,10,1
1,154,1,0,0,0,0,26,10,1
1,138,2,0,0,0,0,26,10,1
2,749,2,1,3,7,-4,34,6,1
2,496,1,0,7,3,4,50,10,1
2,282,2,0,7,3,4,55,12,1
2,234,1,1,3,7,-4,21,10,1
2,216,2,1,3,7,-4,21,10,1
2,166,1,0,7,3,4,55,10,1
2,16,1,0,14,3,11,54,10,1
3,740,1,1,3,14,-11,9,9,1
3,663,2,1,3,14,-11,5,5,1
3,534,1,1,3,17,-14,54,10,1
3,115,1,1,6,17,-11,30,10,1
4,679,3,0,24,6,18,6,6,1
4,100,1,1,6,24,-18,32,10,1
4,62,1,1,6,24,-18,44,10,1
4,51,1,1,6,24,-18,55,10,1
4,48,2,1,6,24,-18,55,10,1
4,25,3,1,6,24,-18,55,10,1
4,11,1,1,6,24,-18,49,10,1
4,7,2,1,6,24,-18,49,10,1
1,716,1,0,0,7,-7,51,15,1
1,628,1,1,7,0,7,50,20,1
1,608,2,1,7,0,7,40,20,1
1,430,2,1,7,0,7,26,8,1
1,244,2,1,7,3,4,44,4,1
1,71,1,1,7,3,4,24,10,1
1,49,2,1,7,3,4,24,10,1
1,10,1,1,7,6,1,27,10,1
2,900,2,1,7,6,1,27,10,1
2,823,1,1,7,6,1,47,10,1
2,803,2,1,7,6,1,47,10,1
2,738,1,1,7,13,-6,30,10,1
2,483,2,1,7,16,-9,34,9,1
2,399,2,0,16,7,9,46,7,1
2,268,1,0,16,7,9,43,10,1
2,256,2,0,16,7,9,43,10,1
2,153,1,0,16,7,9,43,10,1
2,131,2,0,16,7,9,43,10,1
2,99,1,0,16,7,9,30,10,1
2,62,2,0,16,10,6,44,1,1
2,44,1,1,10,16,-6,32,10,1
2,28,1,1,10,16,-6,25,10,1
3,573,1,1,12,23,-11,40,10,1
3,470,1,1,12,23,-11,45,10,1
3,441,2,1,12,23,-11,45,10,1
3,413,1,1,12,23,-11,9,10,1
3,402,2,1,12,23,-11,9,10,1
3,318,1,1,12,23,-11,7,7,1
3,303,2,1,12,23,-11,7,7,1
3,101,2,0,26,12,14,55,8,1
4,611,1,0,33,19,14,44,15,1
4,520,1,1,19,33,-14,33,10,1
4,465,1,1,19,33,-14,43,10,1
4,376,1,1,19,33,-14,53,10,1
4,249,1,0,33,26,7,35,10,1
4,230,2,0,33,26,7,35,10,1
4,172,1,1,26,33,-7,48,10,1
4,157,2,1,26,33,-7,48,10,1
4,139,1,0,33,26,7,29,10,1
4,61,2,1,26,33,-7,43,15,1
4,49,1,1,26,33,-7,17,10,1
1,866,2,1,0,0,0,50,8,1
1,714,1,1,0,0,0,50,10,1
1,446,2,1,7,0,7,49,4,1
1,252,2,1,7,0,7,28,13,1
1,139,1,1,7,0,7,13,10,1
1,115,2,1,7,0,7,13,10,1
1,34,2,1,7,0,7,46,16,1
2,176,1,1,14,7,7,47,10,1
2,157,2,1,14,7,7,47,10,1
2,64,2,0,7,14,-7,48,15,1
3,731,1,0,9,14,-5,27,10,1
4,850,1,0,16,21,-5,37,10,1
4,824,2,0,16,21,-5,37,10,1
4,712,1,1,22,16,6,49,10,1
4,641,1,1,22,16,6,18,10,1
4,43,1,1,29,19,10,2,2,1
1,115,2,0,3,7,-4,43,8,1
2,745,2,1,7,10,-3,45,6,1
2,533,2,1,7,11,-4,33,12,1
2,318,2,0,11,7,4,52,19,1
2,281,1,1,7,11,-4,19,10,1
2,100,2,1,14,11,3,30,1,1
2,64,2,0,11,14,-3,45,2,1
2,40,1,1,14,11,3,12,10,1
3,870,2,0,11,14,-3,40,7,1
3,160,1,1,14,14,0,46,10,1
3,147,2,1,14,14,0,46,10,1
3,57,1,0,14,21,-7,43,10,1
4,813,1,1,21,14,7,22,10,1
4,590,1,1,21,17,4,35,10,1
4,581,2,1,21,17,4,35,10,1
4,217,2,0,17,21,-4,30,7,1
4,127,2,1,24,17,7,27,4,1
4,116,1,1,24,17,7,15,10,1
4,12,1,0,31,24,7,53,10,1
1,773,2,1,0,0,0,55,5,1
2,776,1,1,7,3,4,35,10,1
2,454,2,0,10,7,3,47,8,1
2,293,2,1,7,10,-3,44,2,1
2,240,1,1,7,10,-3,18,10,1
2,137,1,1,7,10,-3,25,10,1
2,73,1,0,17,14,3,51,10,1
2,40,2,1,14,18,-4,39,1,1
3,508,2,0,18,21,-3,28,22,1
3,395,1,0,18,21,-3,40,10,1
3,383,2,0,18,21,-3,40,10,1
3,266,1,0,18,24,-6,46,10,1
3,245,2,0,18,24,-6,46,10,1
3,192,1,1,24,18,6,18,10,1
4,587,1,1,31,25,6,48,10,1
4,561,2,1,31,25,6,48,10,1
4,316,1,0,25,38,-13,42,10,1
4,305,2,0,25,38,-13,42,10,1
4,87,1,0,25,48,-23,39,10,1
1,860,2,1,0,0,0,37,7,1
1,812,1,0,0,0,0,42,10,1
1,792,2,0,0,0,0,42,10,1
1,752,1,1,0,0,0,48,10,1
1,736,2,1,0,0,0,48,10,1
1,387,2,0,0,0,0,31,4,1
1,224,2,1,3,0,3,50,10,1
1,187,1,1,3,0,3,14,10,1
2,792,1,0,7,3,4,30,10,1
2,637,2,0,7,10,-3,38,8,1
2,474,1,0,7,10,-3,28,10,1
2,406,1,0,7,10,-3,38,10,1
2,331,1,1,10,7,3,45,10,1
2,252,2,0,7,10,-3,38,0,1
3,852,2,0,17,17,0,43,8,1
3,811,1,1,17,17,0,21,10,1
3,707,2,0,17,17,0,40,8,1
3,557,2,1,17,17,0,46,8,1
3,345,1,1,17,17,0,18,15,1
3,216,2,1,17,20,-3,29,16,1
3,120,2,1,17,20,-3,12,5,1
4,599,1,0,26,20,6,35,10,1
4,366,1,0,26,20,6,24,10,1
4,289,1,0,26,20,6,39,10,1
4,102,2,1,27,26,1,39,4,1
4,61,2,1,27,29,-2,40,12,1
4,43,3,1,27,29,-2,40,12,1
1,620,2,0,0,7,-7,14,7,1
1,573,1,0,0,7,-7,34,10,1
1,129,2,0,0,17,-17,29,7,1
2,779,1,0,0,17,-17,40,10,1
2,707,1,1,17,0,17,55,10,1
2,666,2,1,17,0,17,45,20,1
2,622,1,0,0,17,-17,24,10,1
2,603,2,0,0,17,-17,24,10,1
2,396,1,1,17,0,17,13,10,1
2,276,1,1,17,7,10,21,10,1
2,104,1,1,17,7,10,42,10,1
2,71,1,0,7,17,-10,30,10,1
2,30,1,0,7,17,-10,53,10,1
2,18,2,0,7,17,-10,53,10,1
3,857,2,0,7,17,-10,7,2,1
3,823,1,0,7,20,-13,35,10,1
3,239,2,0,7,30,-23,20,19,1
3,72,1,1,30,7,23,53,10,1
4,863,1,0,7,30,-23,35,10,1
4,488,0,0,13,37,-24,5,0,1
4,228,1,1,37,20,17,33,10,1
4,176,1,1,37,27,10,53,10,1
4,131,1,1,37,34,3,27,10,1
4,100,2,1,37,34,3,40,8,1
4,59,2,0,34,37,-3,7,20,1
4,41,1,0,34,37,-3,50,10,1
4,27,3,1,37,34,3,53,3,1
1,594,1,0,0,1,-1,11,10,1
1,462,1,0,0,1,-1,27,10,1
1,345,1,0,0,1,-1,34,10,1
1,279,1,0,0,8,-8,25,10,1
2,719,2,1,8,0,8,5,5,1
2,566,2,1,8,3,5,45,10,1
2,184,1,0,10,8,2,32,10,1
2,150,1,0,10,8,2,44,10,1
2,76,2,1,8,17,-9,24,3,1
2,54,2,0,17,8,9,48,5,1
2,40,1,1,8,17,-9,26,10,1
3,310,2,0,17,8,9,46,6,1
4,771,1,1,8,20,-12,17,10,1
4,764,2,1,8,20,-12,17,10,1
4,728,1,0,20,8,12,46,10,1
4,640,2,1,8,20,-12,49,4,1
4,324,2,1,9,20,-11,40,8,1
4,30,1,1,9,20,-11,27,10,1
4,26,2,1,9,20,-11,27,10,1
1,873,2,0,0,0,0,38,7,1
1,847,1,1,0,0,0,37,10,1
1,830,2,1,0,0,0,37,10,1
1,760,2,0,0,0,0,38,2,1
1,697,2,1,0,0,0,36,6,1
1,651,1,0,0,0,0,13,10,1
1,560,2,0,0,0,0,31,8,1
1,436,2,0,0,0,0,43,8,1
1,398,1,0,0,0,0,15,10,1
1,74,1,1,2,0,2,32,10,1
1,3,1,1,2,7,-5,43,10,1
2,900,2,1,2,7,-5,43,10,1
2,801,2,0,7,2,5,25,18,1
2,710,1,0,7,2,5,15,10,1
2,611,2,0,7,9,-2,32,5,1
2,534,2,1,9,7,2,37,5,1
2,166,1,0,10,9,1,16,10,1
2,153,2,0,10,9,1,16,10,1
2,136,1,1,9,10,-1,48,10,1
2,96,1,0,10,9,1,47,10,1
2,92,2,0,10,9,1,47,10,1
2,68,2,1,9,10,-1,25,5,1
2,42,2,0,10,9,1,39,5,1
3,614,1,1,10,10,0,37,10,1
3,522,1,1,10,17,-7,18,10,1
3,503,2,1,10,17,-7,18,10,1
3,427,2,1,10,17,-7,52,6,1
3,147,2,0,17,17,0,46,5,1
3,45,2,1,17,17,0,39,11,1
4,440,1,0,17,17,0,53,10,1
4,183,1,0,20,17,3,29,10,1
4,135,2,0,20,24,-4,34,7,1
1,557,2,0,7,0,7,48,4,1
1,453,2,0,7,0,7,26,13,1
2,763,2,0,7,0,7,28,5,1
2,606,2,0,7,0,7,29,11,1
2,335,2,1,8,7,1,35,3,1
2,267,1,0,10,8,2,52,10,1
2,99,2,0,10,9,1,43,2,1
3,540,1,1,9,10,-1,39,20,1
3,279,1,1,9,13,-4,41,10,1
3,256,2,1,9,13,-4,41,10,1
3,185,1,0,13,9,4,46,10,1
4,800,1,1,9,16,-7,45,10,1
4,573,2,0,16,9,7,7,7,1
4,97,1,1,12,22,-10,48,10,1
4,90,2,1,12,22,-10,48,10,1
4,85,3,1,12,22,-10,48,10,1
1,860,2,0,0,0,0,45,6,1
1,494,2,0,0,3,-3,32,7,1
1,360,1,1,3,0,3,53,10,1
1,240,2,1,3,0,3,44,12,1
1,140,2,1,3,0,3,10,7,1
1,81,1,1,3,2,1,20,10,1
2,900,2,1,3,2,1,3,3,1
2,699,1,0,5,10,-5,32,10,1
2,688,2,0,5,10,-5,32,10,1
2,546,2,0,5,10,-5,25,3,1
2,455,1,0,5,10,-5,7,7,1
2,112,2,1,17,5,12,50,2,1
2,73,2,1,17,5,12,19,8,1
3,667,1,0,8,31,-23,33,10,1
3,650,2,0,8,31,-23,33,10,1
3,612,1,0,8,31,-23,47,10,1
3,533,2,0,8,31,-23,32,7,1
3,386,1,1,34,8,26,30,10,1
3,372,2,1,34,8,26,30,10,1
4,839,1,1,34,15,19,34,10,1
4,767,1,1,34,15,19,43,10,1
4,700,1,1,34,15,19,21,10,1
4,415,1,0,22,34,-12,14,10,1
4,179,1,0,22,37,-15,51,10,1
4,156,2,0,22,37,-15,51,10,1
1,893,1,0,0,0,0,38,10,1
1,491,1,1,7,1,6,50,10,1
1,228,2,0,1,7,-6,16,8,1
2,752,1,0,2,13,-11,35,10,1
2,653,1,1,13,2,11,36,10,1
2,570,2,1,13,2,11,24,11,1
2,416,2,1,13,2,11,49,4,1
2,143,2,1,13,2,11,12,4,1
2,112,1,1,13,5,8,42,10,1
2,109,2,1,13,5,8,42,10,1
2,94,1,0,5,13,-8,35,10,1
3,823,2,0,5,16,-11,39,15,1
3,795,1,1,16,5,11,21,10,1
3,782,2,1,16,5,11,21,10,1
3,703,1,1,16,5,11,29,10,1
3,680,2,1,16,5,11,29,10,1
3,507,1,0,8,16,-8,45,10,1
3,491,2,0,8,16,-8,45,10,1
3,236,1,1,23,21,2,5,10,1
3,198,1,1,23,21,2,35,10,1
3,184,2,1,23,21,2,35,10,1
3,73,1,1,23,28,-5,32,10,1
4,692,1,0,28,30,-2,52,10,1
4,377,1,1,30,30,0,35,10,1
1,839,2,0,0,0,0,45,4,1
1,768,1,1,0,0,0,40,10,1
1,50,2,0,0,7,-7,30,15,1
2,650,1,0,0,14,-14,45,10,1
2,520,2,0,0,14,-14,53,8,1
2,422,2,0,0,14,-14,10,6,1
2,262,1,0,0,14,-14,18,10,1
2,150,1,1,21,0,21,50,10,1
2,144,2,1,21,0,21,50,10,1
2,116,1,1,21,0,21,24,10,1
2,15,2,1,28,0,28,3,3,1
3,670,2,0,0,35,-35,29,8,1
3,610,1,0,0,38,-38,35,10,1
3,326,1,0,0,41,-41,35,10,1
3,252,1,0,0,41,-41,4,4,1
3,224,2,0,0,41,-41,4,4,1
3,147,2,0,0,44,-44,38,7,1
4,700,2,1,44,0,44,18,2,1
4,664,1,0,0,44,-44,54,10,1
4,653,2,0,0,44,-44,54,10,1
4,560,2,1,44,0,44,13,4,1
4,498,1,1,44,0,44,53,10,1
4,399,1,0,0,44,-44,49,10,1
4,96,2,0,0,52,-52,45,10,1
1,528,1,1,0,0,0,1,1,1
1,392,1,1,7,3,4,41,10,1
1,248,2,1,7,3,4,4,7,1
2,833,2,1,7,6,1,33,12,1
2,761,2,0,6,7,-1,53,10,1
2,710,1,1,7,6,1,22,10,1
2,690,2,1,7,6,1,22,10,1
2,524,2,0,9,7,2,46,5,1
2,477,1,1,7,9,-2,32,10,1
2,369,1,0,9,7,2,43,10,1
2,174,2,0,9,7,2,31,16,1
2,64,1,1,10,9,1,35,10,1
3,855,2,0,12,10,2,38,6,1
3,730,1,0,12,10,2,36,10,1
3,548,1,1,17,12,5,36,10,1
3,458,1,1,17,13,4,35,10,1
3,443,2,1,17,13,4,35,10,1
3,181,2,1,17,13,4,55,12,1
4,735,2,1,24,13,11,50,8,1
4,610,1,0,13,24,-11,45,10,1
4,217,1,1,25,13,12,40,10,1
4,199,2,1,25,13,12,40,10,1
4,180,3,1,25,13,12,40,10,1
4,122,1,0,13,25,-12,51,10,1
4,89,3,0,13,25,-12,53,14,1
4,41,1,1,25,13,12,26,10,1
1,663,2,0,0,7,-7,38,6,1
1,397,1,1,7,0,7,30,10,1
1,379,2,1,7,0,7,30,10,1
1,334,1,0,3,7,-4,53,10,1
1,290,1,1,7,3,4,47,10,1
1,38,1,1,7,10,-3,42,10,1
2,855,2,0,10,7,3,25,6,1
2,712,1,0,10,7,3,45,10,1
2,701,2,0,10,7,3,45,10,1
2,629,2,1,7,10,-3,23,6,1
2,592,1,0,10,7,3,42,10,1
2,476,2,1,7,11,-4,40,5,1
2,362,2,0,11,7,4,43,6,1
2,166,1,1,7,11,-4,36,10,1
2,129,1,1,7,14,-7,35,10,1
2,98,1,0,14,7,7,41,10,1
2,76,2,1,7,14,-7,54,5,1
3,845,1,1,7,14,-7,52,10,1
3,734,2,0,14,7,7,3,10,1
3,637,1,0,14,9,5,36,10,1
3,593,1,0,14,9,5,25,10,1
3,459,1,0,14,16,-2,36,10,1
3,70,1,1,23,14,9,20,10,1
4,689,2,0,21,23,-2,40,9,1
4,480,2,1,23,21,2,45,6,1
4,345,2,0,21,23,-2,29,3,1
4,140,1,1,23,24,-1,35,10,1
1,895,1,0,0,0,0,31,10,1
1,655,1,1,0,7,-7,40,10,1
1,646,2,1,0,7,-7,40,10,1
1,582,1,0,7,0,7,17,10,1
1,229,2,0,8,3,5,8,3,1
1,106,2,0,8,3,5,22,4,1
1,23,1,0,8,6,2,47,10,1
1,7,2,0,8,6,2,47,10,1
2,817,1,0,8,6,2,10,10,1
2,701,2,0,8,6,2,39,6,1
2,435,1,0,8,13,-5,50,10,1
2,410,2,0,8,13,-5,50,10,1
3,865,2,1,13,15,-2,31,4,1
3,810,1,0,15,13,2,37,10,1
3,635,1,1,13,15,-2,44,10,1
3,273,1,0,22,16,6,35,10,1
3,241,2,0,22,16,6,30,15,1
4,857,1,0,22,16,6,17,10,1
4,847,2,0,22,16,6,17,10,1
4,203,1,1,19,22,-3,25,10,1
4,139,2,1,19,22,-3,42,6,1
1,763,1,1,0,0,0,40,10,1
1,650,1,0,0,0,0,23,10,1
1,524,1,0,0,7,-7,51,10,1
1,499,2,0,0,7,-7,51,10,1
2,900,2,1,8,7,1,55,11,1
2,760,2,0,7,8,-1,40,1,1
2,303,1,1,8,14,-6,6,6,1
2,172,1,1,8,14,-6,51,10,1
2,73,1,1,8,14,-6,40,10,1
2,43,1,0,14,8,6,31,10,1
3,797,1,1,8,17,-9,55,20,1
3,733,1,0,17,8,9,34,10,1
3,336,2,1,15,17,-2,3,3,1
3,145,2,0,20,15,5,52,10,1
4,872,1,0,20,15,5,27,10,1
4,798,1,1,15,20,-5,37,15,1
4,776,2,1,15,20,-5,37,15,1
4,479,2,0,27,22,5,44,11,1
4,204,1,0,27,22,5,7,7,1
4,178,3,0,27,22,5,5,5,1
4,128,1,0,27,22,5,48,10,1
4,124,2,0,27,22,5,48,10,1
4,119,3,0,27,22,5,48,10,1
4,68,1,1,22,27,-5,46,10,1
4,34,2,0,27,22,5,38,4,1
4,24,1,0,27,22,5,31,10,1
4,12,1,0,27,22,5,10,10,1
1,421,1,0,0,7,-7,44,10,1
1,320,1,0,0,7,-7,6,6,1
1,261,1,0,0,10,-10,35,10,1
1,177,1,0,0,10,-10,27,10,1
2,663,1,0,0,17,-17,51,10,1
2,500,2,1,17,0,17,45,7,1
2,376,1,0,0,17,-17,51,10,1
2,280,1,1,17,0,17,17,10,1
2,255,2,1,17,0,17,17,10,1
2,142,2,1,17,0,17,10,5,1
3,770,2,0,3,24,-21,46,8,1
3,511,1,1,24,3,21,15,10,1
3,456,1,1,24,3,21,13,10,1
3,440,2,1,24,3,21,13,10,1
3,217,1,1,24,3,21,35,10,1
3,193,2,1,24,3,21,35,10,1
4,615,2,1,25,4,21,15,10,1
4,424,2,0,7,25,-18,44,13,1
4,368,2,1,25,7,18,18,4,1
4,1,2,0,7,25,-18,21,4,1
1,882,1,0,0,0,0,41,10,1
1,862,2,0,0,0,0,41,10,1
1,547,1,0,14,0,14,32,10,1
1,215,1,0,14,3,11,21,10,1
1,71,2,0,14,10,4,36,3,1
1,7,1,0,14,10,4,47,10,1
2,900,2,0,14,10,4,47,10,1
2,793,2,1,11,14,-3,54,5,1
2,672,1,1,11,14,-3,18,10,1
2,363,2,1,11,20,-9,36,8,1
2,278,2,0,20,11,9,8,11,1
2,236,1,1,13,20,-7,47,10,1
2,210,2,1,13,20,-7,47,10,1
3,757,2,0,23,20,3,31,8,1
3,14,2,0,24,33,-9,53,7,1
4,853,2,1,33,24,9,17,6,1
4,800,1,1,33,24,9,53,10,1
4,790,2,1,33,24,9,53,10,1
4,748,1,1,33,24,9,2,10,1
4,721,2,1,33,24,9,2,10,1
4,659,1,1,33,24,9,42,10,1
4,490,1,0,31,33,-2,29,15,1
4,109,2,1,33,34,-1,29,9,1
4,101,1,1,33,37,-4,35,10,1
4,91,3,1,33,37,-4,43,2,1
4,25,1,1,33,38,-5,35,10,1
1,585,2,1,0,8,-8,48,6,1
1,440,2,1,0,8,-8,41,17,1
1,270,2,0,11,0,11,50,8,1
1,163,2,0,11,0,11,7,13,1
1,114,1,0,11,0,11,42,10,1
1,74,1,0,11,0,11,26,10,1
1,40,2,0,11,0,11,26,10,1
2,900,1,0,11,3,8,35,10,1
2,812,2,0,11,3,8,14,11,1
2,762,2,0,11,3,8,31,4,1
2,726,1,1,3,11,-8,20,10,1
2,705,2,1,3,11,-8,20,10,1
2,659,1,0,11,3,8,38,10,1
2,596,1,1,3,11,-8,47,10,1
2,251,1,0,11,10,1,12,10,1
2,228,2,0,11,10,1,12,10,1
2,167,1,0,11,13,-2,47,10,1
2,130,1,0,11,20,-9,51,10,1
2,91,1,1,20,12,8,35,10,1
2,78,1,0,12,20,-8,49,10,1
3,873,2,1,20,12,8,44,6,1
3,808,2,0,12,20,-8,32,5,1
3,762,1,1,20,12,8,22,10,1
3,453,2,0,12,23,-11,20,25,1
3,1,2,1,23,12,11,27,9,1
4,856,1,1,23,15,8,30,15,1
4,834,2,1,23,15,8,30,15,1
4,770,1,1,23,15,8,49,10,1
4,625,1,1,23,23,0,34,10,1
4,406,1,1,23,30,-7,47,10,1
4,360,2,1,23,30,-7,37,20,1
1,860,1,1,0,0,0,50,10,1
1,787,1,0,0,0,0,8,8,1
1,558,2,0,7,7,0,40,8,1
1,236,1,1,8,14,-6,39,10,1
1,222,2,1,8,14,-6,39,10,1
2,752,1,1,15,21,-6,50,10,1
2,679,1,1,15,21,-6,35,10,1
2,597,1,1,15,21,-6,14,10,1
2,569,2,1,15,21,-6,14,10,1
2,465,1,0,24,22,2,29,10,1
3,889,1,0,31,25,6,48,10,1
3,786,2,1,25,31,-6,33,8,1
3,701,1,0,34,25,9,25,10,1
3,336,2,1,32,34,-2,27,7,1
3,115,2,1,32,34,-2,54,9,1
4,900,1,0,34,32,2,43,10,1
4,800,2,1,32,34,-2,46,3,1
4,723,1,1,32,34,-2,21,15,1
4,532,1,0,34,32,2,40,10,1
4,513,2,0,34,32,2,40,10,1
4,346,1,0,34,32,2,10,10,1
4,63,2,1,39,34,5,42,7,1
4,3,1,1,39,34,5,8,5,1
1,866,2,0,0,0,0,42,5,1
1,800,2,0,0,0,0,9,7,1
1,618,1,0,0,2,-2,16,10,1
1,431,1,0,0,5,-5,40,15,1
1,406,2,0,0,5,-5,40,15,1
1,150,2,0,0,5,-5,29,15,1
1,56,2,1,5,0,5,49,7,1
2,612,2,0,0,5,-5,36,7,1
2,113,2,1,15,0,15,49,4,1
2,39,2,0,0,15,-15,36,1,1
3,764,1,1,15,0,15,42,10,1
3,752,2,1,15,0,15,42,10,1
3,687,2,0,0,15,-15,22,4,1
3,569,1,0,0,15,-15,39,10,1
3,391,1,1,15,0,15,26,10,1
3,126,2,1,15,7,8,46,5,1
4,837,2,0,7,22,-15,31,12,1
4,662,1,0,7,22,-15,15,10,1
4,139,1,1,36,14,22,50,10,1
4,82,2,1,36,14,22,21,25,1
4,63,2,0,14,36,-22,53,7,1
4,51,3,0,14,36,-22,53,7,1
1,825,1,1,0,0,0,49,10,1
1,440,1,1,7,0,7,44,10,1
1,256,1,0,0,7,-7,12,10,1
1,192,1,0,0,14,-14,28,10,1
1,172,2,0,0,14,-14,28,10,1
1,45,2,0,0,16,-16,46,3,1
2,348,1,0,6,23,-17,17,10,1
2,132,2,0,6,24,-18,22,23,1
2,114,1,0,6,24,-18,14,10,1
2,83,1,0,6,31,-25,53,10,1
2,56,2,0,6,31,-25,53,10,1
3,790,1,1,31,6,25,53,10,1
3,694,1,1,31,6,25,17,10,1
3,30,2,0,21,38,-17,55,16,1
4,875,2,1,38,21,17,37,6,1
4,717,1,1,38,21,17,27,10,1
4,672,2,1,38,21,17,32,15,1
4,625,1,1,38,24,14,45,10,1
4,85,1,1,44,24,20,52,10,1
4,69,1,1,44,24,20,40,10,1
4,36,1,1,44,24,20,35,20,1
1,716,1,0,0,0,0,35,10,1
1,509,1,0,0,7,-7,43,15,1
1,365,1,1,7,0,7,30,15,1
1,290,1,0,0,7,-7,40,10,1
2,702,1,0,0,17,-17,33,10,1
2,607,1,0,0,20,-20,49,10,1
2,488,1,1,20,0,20,3,3,1
2,386,2,1,20,3,17,36,9,1
2,167,2,1,20,3,17,11,6,1
2,146,1,1,20,4,16,35,10,1
3,541,1,1,27,11,16,46,10,1
3,210,1,1,27,11,16,34,10,1
4,832,2,1,27,14,13,39,6,1
4,630,2,1,27,17,10,20,4,1
4,163,2,0,24,27,-3,27,9,1
4,133,1,0,24,27,-3,23,10,1
4,128,2,0,24,27,-3,23,10,1
4,75,1,0,24,27,-3,29,10,1
4,70,2,0,24,27,-3,29,10,1
4,44,1,1,27,24,3,10,10,1
4,31,2,1,27,24,3,10,10,1
5,0,1,0,35,27,8,35,10,1
5,0,3,0,35,27,8,54,29,1
1,894,1,0,0,0,0,36,10,1
2,881,1,0,14,0,14,53,10,1
2,856,2,0,14,0,14,53,10,1
2,776,1,1,0,14,-14,19,10,1
2,656,2,1,0,14,-14,44,3,1
2,580,1,0,15,0,15,29,10,1
2,515,1,0,15,0,15,17,10,1
2,496,2,0,15,0,15,17,10,1
2,430,2,0,15,1,14,38,7,1
2,227,2,0,15,1,14,48,12,1
2,87,2,1,1,15,-14,29,18,1
2,60,1,1,1,15,-14,53,10,1
3,860,2,1,1,22,-21,17,3,1
3,506,1,0,36,1,35,33,10,1
3,480,2,0,36,1,35,33,10,1
3,276,2,0,36,4,32,43,14,1
3,200,2,0,36,4,32,10,7,1
3,47,1,1,6,36,-30,37,10,1
4,846,2,1,6,36,-30,17,9,1
4,540,1,1,6,39,-33,44,10,1
4,441,1,0,39,6,33,19,10,1
4,303,1,0,39,12,27,17,10,1
4,282,2,0,39,12,27,17,10,1
4,260,3,0,39,12,27,17,10,1
4,118,1,0,39,12,27,45,10,1
4,113,2,0,39,12,27,45,10,1
4,103,1,0,39,12,27,30,10,1
4,98,2,0,39,12,27,30,10,1
4,39,2,0,39,15,24,48,7,1
1,739,2,1,0,0,0,46,9,1
1,539,2,0,0,0,0,8,8,1
1,331,2,1,3,0,3,21,6,1
1,262,2,1,3,0,3,19,7,1
1,201,1,0,0,3,-3,54,10,1
1,197,2,0,0,3,-3,54,10,1
2,655,1,0,7,3,4,44,10,1
2,464,2,1,3,7,-4,46,14,1
2,24,1,1,3,8,-5,43,10,1
3,572,1,0,8,3,5,23,10,1
3,556,2,0,8,3,5,23,10,1
3,340,1,1,3,8,-5,23,10,1
3,150,2,0,8,3,5,42,9,1
4,780,1,1,4,8,-4,47,10,1
4,599,1,0,9,4,5,20,10,1
4,587,2,0,9,4,5,20,10,1
4,446,1,1,4,9,-5,15,10,1
4,291,2,1,4,16,-12,33,17,1
4,235,2,0,16,4,12,45,6,1
4,108,2,0,16,11,5,53,11,1
4,77,1,1,11,16,-5,30,10,1
1,857,2,0,0,0,0,38,8,1
1,779,1,1,0,0,0,45,10,1
1,724,1,0,0,0,0,51,10,1
1,708,2,0,0,0,0,51,10,1
1,14,1,0,0,7,-7,11,10,1
2,593,2,0,0,10,-10,26,8,1
2,341,2,1,13,0,13,35,7,1
2,218,1,1,13,3,10,40,10,1
2,147,1,0,3,13,-10,33,10,1
2,78,1,0,3,14,-11,47,10,1
2,73,2,0,3,14,-11,47,10,1
2,49,1,1,14,3,11,21,10,1
2,44,2,1,14,3,11,21,10,1
2,17,2,1,14,3,11,50,4,1
3,891,1,1,14,3,11,27,10,1
3,754,2,0,3,14,-11,43,15,1
3,436,2,0,3,14,-11,19,1,1
3,360,2,0,3,14,-11,17,12,1
3,237,2,0,3,17,-14,50,9,1
3,25,2,1,17,3,14,5,5,1
4,220,2,0,9,24,-15,48,3,1
4,180,2,0,9,24,-15,48,9,1
4,146,1,0,9,24,-15,19,10,1
4,109,1,1,24,9,15,44,10,1
1,414,2,0,7,0,7,9,7,1
1,317,1,0,7,3,4,46,10,1
1,305,2,0,7,3,4,46,10,1
1,222,2,1,3,7,-4,9,10,1
2,258,2,1,11,14,-3,39,1,1
2,146,1,0,14,11,3,24,10,1
2,116,2,0,14,11,3,29,15,1
2,32,1,1,14,14,0,26,10,1
2,1,1,1,14,21,-7,50,10,1
3,668,2,0,21,17,4,36,1,1
3,404,1,0,21,17,4,21,10,1
3,369,2,0,21,17,4,21,10,1
3,209,2,0,21,20,1,48,7,1
4,728,2,0,21,28,-7,39,4,1
4,302,1,0,21,35,-14,33,10,1
4,18,1,1,36,21,15,34,10,1
1,218,1,0,16,7,9,25,10,1
1,166,2,0,16,7,9,20,15,1
1,124,1,0,16,7,9,51,10,1
2,739,1,1,7,16,-9,22,10,1
2,440,1,0,16,7,9,32,10,1
2,423,2,0,16,7,9,32,10,1
2,337,2,0,16,10,6,35,10,1
2,253,2,0,16,10,6,52,7,1
2,197,1,0,16,10,6,14,10,1
2,100,2,0,16,10,6,19,3,1
2,68,1,0,16,13,3,45,10,1
2,50,2,0,16,13,3,45,10,1
3,827,2,1,13,16,-3,47,11,1
3,759,2,0,16,13,3,10,11,1
3,693,1,1,13,16,-3,48,10,1
3,597,1,1,13,16,-3,5,10,1
3,423,1,1,13,23,-10,38,10,1
3,382,2,1,13,23,-10,38,10,1
3,10,2,1,13,23,-10,41,10,1
4,562,1,1,13,30,-17,30,10,1
4,244,1,1,20,30,-10,44,5,1
4,181,2,0,30,20,10,43,2,1
4,68,1,1,20,30,-10,48,10,1
1,846,1,0,0,0,0,28,20,1
1,402,2,0,0,0,0,18,10,1
1,18,2,0,7,3,4,10,4,1
2,834,2,0,7,10,-3,39,3,1
2,626,2,0,7,10,-3,43,8,1
2,534,1,0,7,10,-3,54,10,1
2,333,1,1,10,7,3,46,10,1
2,192,1,1,10,7,3,25,10,1
2,163,2,1,10,7,3,25,10,1
2,135,2,1,10,10,0,43,5,1
3,591,1,1,13,16,-3,42,10,1
3,23,2,0,19,13,6,5,20,1
4,815,1,1,15,19,-4,55,10,1
4,776,2,1,15,19,-4,55,10,1
4,582,2,0,19,22,-3,25,12,1
4,420,2,0,19,22,-3,27,5,1
4,353,1,0,19,25,-6,30,15,1
4,332,2,0,19,25,-6,30,15,1
4,297,1,1,25,19,6,47,10,1
4,213,1,0,19,25,-6,53,10,1
1,574,2,0,0,3,-3,51,8,1
2,837,2,0,7,11,-4,49,8,1
2,435,1,1,11,14,-3,22,10,1
2,170,1,1,11,14,-3,5,10,1
2,126,2,1,11,14,-3,26,9,1
2,109,1,0,14,11,3,39,10,1
2,101,2,0,14,11,3,39,10,1
2,86,1,1,11,14,-3,34,10,1
3,698,2,1,14,21,-7,44,6,1
3,547,2,1,14,22,-8,47,8,1
3,261,2,0,29,14,15,52,6,1
4,498,1,1,21,32,-11,29,10,1
4,486,2,1,21,32,-11,29,10,1
4,204,2,1,21,32,-11,42,5,1
4,191,3,1,21,32,-11,42,5,1
4,112,1,1,21,39,-18,22,10,1
4,71,1,0,39,21,18,38,10,1
4,66,2,0,39,21,18,38,10,1
1,893,1,1,0,0,0,27,10,1
1,811,1,1,0,0,0,53,10,1
1,805,2,1,0,0,0,53,10,1
1,428,1,0,7,3,4,27,10,1
1,199,2,0,7,10,-3,41,8,1
1,125,2,1,10,7,3,52,8,1
2,900,2,0,7,11,-4,50,5,1
2,791,1,0,8,11,-3,37,10,1
2,630,1,0,8,11,-3,6,6,1
2,526,1,0,8,18,-10,45,10,1
2,73,1,1,18,15,3,38,10,1
3,753,1,0,15,25,-10,28,10,1
3,271,2,1,25,22,3,33,3,1
3,30,1,1,25,25,0,44,30,1
4,787,1,0,25,25,0,36,10,1
4,688,2,1,25,25,0,31,10,1
4,452,1,1,25,32,-7,38,10,1
4,310,2,0,32,25,7,27,7,1
4,250,2,0,32,26,6,40,5,1
4,176,1,1,26,32,-6,37,10,1
1,893,1,0,0,0,0,39,10,1
1,873,2,0,0,0,0,39,10,1
1,533,1,0,0,0,0,30,10,1
1,278,2,1,7,0,7,40,10,1
2,735,1,1,7,3,4,36,10,1
2,670,1,1,7,3,4,22,10,1
2,580,2,1,7,6,1,39,6,1
2,85,2,0,13,7,6,52,16,1
3,871,2,1,7,13,-6,42,5,1
3,747,1,0,13,7,6,52,10,1
3,458,1,0,16,7,9,52,10,1
3,88,1,1,7,19,-12,35,10,1
4,900,2,1,7,19,-12,52,4,1
4,586,2,0,19,7,12,43,2,1
4,563,3,0,19,7,12,43,2,1
4,347,1,1,7,19,-12,46,10,1
4,180,2,0,19,14,5,33,9,1
4,47,1,1,14,22,-8,35,10,1
4,42,2,1,14,22,-8,35,10,1
1,224,2,0,15,7,8,32,10,1
1,46,1,1,7,15,-8,55,10,1
1,25,2,1,7,15,-8,55,10,1
2,760,2,1,7,15,-8,42,7,1
2,653,2,1,7,15,-8,29,7,1
2,610,1,0,15,7,8,47,10,1
2,525,1,1,7,15,-8,8,10,1
2,369,2,1,7,15,-8,27,9,1
2,217,1,1,7,25,-18,25,10,1
2,151,2,1,7,25,-18,45,4,1
2,81,1,0,33,7,26,35,10,1
2,58,1,0,33,14,19,37,10,1
2,15,1,1,14,33,-19,50,10,1
3,569,2,1,14,40,-26,34,10,1
3,492,2,0,40,14,26,40,11,1
3,420,2,1,14,40,-26,26,4,1
4,900,2,1,14,47,-33,8,15,1
4,790,1,1,14,47,-33,35,10,1
4,648,2,1,14,47,-33,5,3,1
4,502,2,0,50,14,36,39,10,1
4,412,1,0,50,14,36,23,10,1
4,390,2,0,50,14,36,23,10,1
4,274,2,0,50,17,33,55,5,1
4,203,2,1,17,50,-33,9,6,1
4,110,2,1,17,50,-33,30,10,1
4,80,2,1,17,53,-36,41,4,1
1,675,1,0,0,7,-7,44,10,1
1,666,2,0,0,7,-7,44,10,1
1,176,1,0,0,7,-7,37,10,1
1,152,2,0,0,7,-7,37,10,1
1,64,1,0,0,8,-8,47,10,1
1,49,2,0,0,8,-8,47,10,1
2,80,1,0,13,9,4,18,10,1
3,865,2,0,13,13,0,33,12,1
3,744,1,0,13,14,-1,35,10,1
3,610,2,1,14,13,1,55,10,1
3,534,2,0,13,14,-1,24,5,1
3,440,1,0,13,14,-1,24,10,1
3,310,2,0,13,17,-4,31,14,1
3,119,1,0,13,17,-4,47,10,1
3,104,2,0,13,17,-4,47,10,1
4,737,1,0,13,18,-5,35,10,1
4,144,2,1,25,20,5,45,10,1
1,862,2,1,0,0,0,50,11,1
1,630,1,0,0,0,0,39,15,1
1,105,2,0,0,3,-3,47,6,1
2,796,1,1,3,0,3,48,10,1
2,371,1,1,3,0,3,47,15,1
2,255,2,0,0,3,-3,38,2,1
2,79,1,1,3,0,3,18,10,1
3,571,2,1,3,8,-5,47,8,1
4,866,2,1,3,15,-12,41,12,1
4,737,1,1,3,15,-12,23,10,1
4,399,2,1,3,15,-12,52,7,1
4,367,1,1,3,15,-12,9,10,1
4,152,1,0,17,3,14,38,10,1
4,1,3,1,3,17,-14,41,26,1
1,836,1,0,0,0,0,41,10,1
1,801,2,0,0,0,0,41,10,1
1,675,1,0,0,0,0,53,10,1
1,314,2,0,0,0,0,17,9,1
1,228,2,0,0,1,-1,29,16,1
2,379,1,0,14,1,13,52,10,1
2,153,1,1,1,14,-13,44,10,1
2,135,1,1,1,14,-13,39,10,1
2,52,2,0,17,1,16,20,4,1
3,868,2,0,17,4,13,31,7,1
3,809,1,1,4,17,-13,47,10,1
3,544,1,1,4,20,-16,38,10,1
3,526,2,1,4,20,-16,38,10,1
3,125,1,0,27,4,23,54,10,1
4,730,2,1,11,34,-23,35,5,1
4,696,1,0,34,11,23,21,10,1
4,572,1,0,34,11,23,51,20,1
4,452,1,0,35,11,24,44,10,1
4,375,1,0,35,11,24,16,10,1
4,308,3,0,35,11,24,15,9,1
4,26,1,0,35,11,24,37,10,1
1,848,1,1,0,0,0,38,10,1
1,238,2,0,7,3,4,50,4,1
2,423,1,1,6,14,-8,28,10,1
2,409,2,1,6,14,-8,28,10,1
3,124,2,0,31,6,25,24,9,1
3,11,2,0,31,6,25,15,10,1
4,888,1,0,31,9,22,35,10,1
4,145,3,0,35,9,26,11,10,1
1,822,1,1,0,0,0,42,10,1
1,811,2,1,0,0,0,42,10,1
1,735,2,0,0,0,0,51,6,1
1,656,1,0,0,0,0,42,10,1
1,508,1,0,0,0,0,25,10,1
1,387,1,0,0,0,0,53,10,1
2,876,1,1,1,1,0,1,10,1
2,864,2,1,1,1,0,1,10,1
2,596,2,1,1,3,-2,40,8,1
2,427,2,1,1,3,-2,11,7,1
2,377,1,0,3,1,2,50,10,1
2,195,2,1,1,3,-2,55,8,1
2,133,2,0,3,1,2,32,7,1
2,92,2,1,1,3,-2,45,16,1
2,55,2,0,3,1,2,18,15,1
2,13,2,0,3,1,2,25,2,1
3,800,2,1,4,3,1,54,7,1
3,642,1,0,4,4,0,6,10,1
3,526,2,0,4,4,0,19,7,1
3,303,2,0,4,4,0,49,1,1
3,254,1,0,4,4,0,50,10,1
3,228,2,0,4,4,0,50,10,1
3,1,1,1,11,4,7,35,10,1
4,900,2,1,11,4,7,35,10,1
4,760,1,1,11,4,7,24,10,1
4,495,1,0,11,14,-3,52,10,1
4,413,1,1,14,12,2,35,10,1
4,399,2,1,14,12,2,35,10,1
4,360,1,0,12,14,-2,43,10,1
4,337,2,0,12,14,-2,43,10,1
4,156,2,0,12,14,-2,12,7,1
4,36,1,1,17,12,5,43,10,1
4,29,2,1,17,12,5,43,10,1
1,850,2,0,0,0,0,37,9,1
1,793,2,1,0,0,0,38,7,1
1,413,2,1,0,7,-7,35,11,1
1,249,1,0,10,0,10,52,10,1
2,817,1,1,0,24,-24,50,10,1
2,700,1,0,24,0,24,34,10,1
2,658,1,0,24,0,24,20,10,1
2,623,2,0,24,0,24,20,10,1
2,532,2,0,24,3,21,50,8,1
2,103,2,0,24,10,14,33,3,1
2,21,1,0,24,13,11,10,10,1
2,2,0,1,19,24,-5,5,0,1
3,655,2,0,24,19,5,21,11,1
3,505,2,0,24,22,2,51,10,1
3,396,1,0,24,22,2,44,10,1
3,297,0,1,28,24,4,5,0,1
3,1,1,0,24,35,-11,33,10,1
4,900,2,0,24,35,-11,33,10,1
4,864,1,1,35,24,11,40,10,1
4,625,2,1,35,24,11,19,5,1
4,590,1,1,35,27,8,35,10,1
4,241,1,0,27,38,-11,30,10,1
4,217,2,0,27,38,-11,30,10,1
4,157,2,1,38,27,11,46,6,1
4,142,1,0,27,38,-11,28,10,1
4,131,3,0,27,38,-11,36,2,1
1,193,2,0,3,0,3,43,6,1
1,63,1,1,0,3,-3,35,10,1
2,838,1,0,3,0,3,29,10,1
2,817,2,0,3,0,3,29,10,1
2,776,1,0,3,3,0,35,10,1
2,595,1,0,3,3,0,25,10,1
2,92,2,0,10,10,0,45,2,1
3,92,1,1,24,10,14,28,10,1
4,681,1,0,13,24,-11,34,10,1
4,616,1,0,13,24,-11,55,10,1
4,530,2,0,13,24,-11,36,6,1
4,86,1,1,31,14,17,12,10,1
1,667,2,1,0,0,0,5,5,1
1,570,2,1,0,3,-3,53,8,1
1,503,2,0,3,0,3,26,9,1
1,453,1,1,0,3,-3,43,10,1
1,413,1,1,0,3,-3,55,10,1
1,260,1,0,3,0,3,9,10,1
1,249,2,0,3,0,3,9,10,1
1,207,1,0,3,0,3,51,10,1
1,103,2,0,3,0,3,32,9,1
2,875,1,0,3,1,2,35,10,1
2,747,1,0,3,1,2,52,10,1
2,555,1,0,3,1,2,50,10,1
2,271,1,1,2,3,-1,20,10,1
2,85,1,0,6,2,4,33,10,1
2,73,2,0,6,2,4,28,5,1
2,23,1,0,6,2,4,37,10,1
3,894,1,0,6,9,-3,28,10,1
3,870,2,0,6,9,-3,28,10,1
3,120,1,1,12,21,-9,47,10,1
3,100,2,1,12,21,-9,47,10,1
3,40,2,0,21,12,9,20,3,1
4,789,2,0,21,12,9,26,9,1
4,667,1,0,21,12,9,35,10,1
4,653,2,0,21,12,9,35,10,1
4,522,2,1,15,21,-6,54,8,1
4,351,2,1,15,21,-6,30,6,1
4,207,2,1,15,21,-6,41,6,1
4,134,1,0,21,15,6,47,10,1
4,113,2,0,21,15,6,47,10,1
4,86,1,1,15,21,-6,47,10,1
4,72,2,1,15,21,-6,47,10,1
4,26,1,1,22,21,1,50,10,1
4,21,2,1,22,21,1,50,10,1
1,851,1,0,0,0,0,21,10,1
1,826,2,0,0,0,0,21,10,1
1,678,2,0,0,0,0,40,11,1
1,589,1,1,0,0,0,50,10,1
1,587,2,1,0,0,0,50,10,1
1,547,1,0,0,0,0,26,10,1
1,388,2,1,0,0,0,41,5,1
1,1,1,0,0,0,0,6,6,1
2,900,2,0,0,0,0,6,6,1
2,610,1,0,0,3,-3,37,10,1
2,180,1,0,0,13,-13,47,10,1
2,131,1,1,13,0,13,46,10,1
2,125,2,1,13,0,13,46,10,1
2,79,1,0,0,13,-13,29,10,1
2,45,1,0,0,13,-13,15,10,1
3,738,2,0,0,16,-16,22,11,1
3,641,2,1,16,0,16,54,22,1
3,576,2,1,16,0,16,24,5,1
3,351,1,1,16,0,16,45,10,1
3,322,2,1,16,0,16,45,10,1
4,657,1,0,0,30,-30,36,10,1
4,620,2,0,0,30,-30,36,10,1
4,316,1,0,0,37,-37,25,10,1
1,892,1,1,0,0,0,43,10,1
1,766,2,0,0,0,0,16,12,1
1,531,1,1,3,0,3,19,10,1
1,508,2,1,3,0,3,19,10,1
1,374,2,1,3,3,0,39,17,1
1,56,1,0,3,10,-7,32,10,1
2,736,2,1,10,3,7,40,7,1
2,704,1,0,3,10,-7,23,10,1
2,494,1,0,3,13,-10,47,10,1
2,393,2,1,13,3,10,11,2,1
2,332,2,1,13,6,7,39,6,1
2,41,1,0,6,20,-14,32,10,1
2,28,1,0,6,20,-14,44,10,1
3,886,1,0,6,20,-14,41,10,1
3,791,1,1,20,6,14,46,10,1
3,566,2,1,20,13,7,26,8,1
3,492,2,0,13,20,-7,51,9,1
3,270,2,0,13,20,-7,16,6,1
3,181,2,0,13,23,-10,41,4,1
4,889,1,0,13,23,-10,16,10,1
4,868,2,0,13,23,-10,16,10,1
4,490,2,0,27,26,1,45,10,1
4,298,2,0,27,26,1,7,6,1
4,217,2,0,27,29,-2,39,6,1
1,860,2,1,0,0,0,41,4,1
1,448,1,1,0,1,-1,49,10,1
1,71,1,1,0,8,-8,48,10,1
2,834,2,0,8,7,1,21,28,1
2,630,2,0,8,14,-6,42,6,1
2,583,1,1,14,8,6,30,10,1
2,564,2,1,14,8,6,30,10,1
2,480,2,1,14,8,6,30,10,1
2,440,1,1,14,11,3,35,10,1
2,45,1,0,14,14,0,44,10,1
3,479,1,1,14,24,-10,50,10,1
3,422,1,0,24,14,10,44,10,1
3,82,1,0,27,14,13,50,10,1
3,26,1,0,27,14,13,34,10,1
3,1,2,0,27,14,13,34,10,1
4,169,1,1,17,37,-20,49,10,1
4,148,1,0,37,17,20,41,10,1
4,119,1,0,37,17,20,9,5,1
4,22,1,1,24,37,-13,21,10,1
1,854,1,1,0,0,0,44,10,1
1,659,2,0,0,3,-3,17,6,1
1,404,2,0,0,10,-10,50,9,1
1,359,1,1,10,0,10,20,10,1
1,140,2,1,10,0,10,10,8,1
1,89,2,1,10,3,7,45,7,1
2,885,1,1,10,3,7,2,10,1
2,865,2,1,10,3,7,2,10,1
2,253,1,1,17,19,-2,36,10,1
2,145,1,1,17,19,-2,24,10,1
2,121,1,1,17,26,-9,29,10,1
3,891,1,0,26,17,9,37,10,1
3,815,1,1,17,26,-9,38,10,1
3,719,2,1,17,26,-9,10,8,1
3,620,1,1,17,29,-12,50,10,1
3,592,2,1,17,29,-12,50,10,1
3,420,1,0,29,17,12,53,10,1
3,405,2,0,29,17,12,53,10,1
3,309,1,1,17,29,-12,32,10,1
3,191,2,1,17,29,-12,5,5,1
4,870,2,0,32,20,12,35,10,1
4,682,1,0,32,20,12,10,10,1
4,258,2,1,20,32,-12,47,15,1
4,135,1,0,32,20,12,32,10,1
4,52,1,1,20,32,-12,17,10,1
4,44,2,1,20,32,-12,17,10,1
1,894,1,0,0,0,0,39,10,1
1,508,2,1,0,0,0,3,3,1
1,429,1,0,3,0,3,41,10,1
2,592,1,1,7,3,4,17,10,1
2,491,1,1,7,6,1,55,10,1
3,860,2,1,14,6,8,37,9,1
3,710,1,1,14,6,8,51,10,1
3,602,2,1,14,6,8,16,1,1
3,538,2,1,14,6,8,9,8,1
3,64,1,1,21,9,12,9,10,1
4,677,2,0,12,21,-9,13,5,1
4,128,2,0,12,31,-19,24,7,1
4,123,3,0,12,31,-19,24,7,1
4,27,1,0,12,38,-26,53,10,1
4,23,2,0,12,38,-26,53,10,1
1,894,1,0,0,0,0,36,10,1
1,874,2,0,0,0,0,36,10,1
1,665,2,0,0,0,0,41,6,1
1,484,2,1,1,0,1,45,3,1
1,312,1,1,1,0,1,36,10,1
1,296,2,1,1,0,1,36,10,1
1,163,1,0,1,1,0,43,10,1
1,76,1,0,1,1,0,38,20,1
2,840,2,1,8,1,7,21,14,1
2,382,1,1,15,1,14,51,10,1
2,233,2,1,15,1,14,28,7,1
2,194,1,0,1,15,-14,46,10,1
2,141,1,1,15,1,14,48,10,1
2,29,1,1,15,1,14,52,10,1
2,21,2,1,15,1,14,52,10,1
3,891,1,1,15,1,14,39,10,1
3,868,2,1,15,1,14,39,10,1
3,770,1,0,1,15,-14,39,10,1
3,726,2,0,1,15,-14,39,10,1
3,350,2,1,22,1,21,43,13,1
3,285,1,0,4,22,-18,53,10,1
3,261,2,0,4,22,-18,53,10,1
3,1,2,1,22,11,11,46,10,1
4,551,2,1,22,19,3,39,17,1
4,271,2,1,22,19,3,18,16,1
4,175,1,1,22,27,-5,22,10,1
4,171,2,1,22,27,-5,22,10,1
4,91,1,1,22,27,-5,26,10,1
1,765,1,0,0,0,0,38,15,1
1,635,1,0,0,0,0,43,10,1
1,267,2,1,3,0,3,9,5,1
1,23,1,0,3,3,0,55,10,1
2,888,1,1,3,3,0,23,10,1
2,811,1,0,3,3,0,49,10,1
2,702,2,0,3,3,0,31,5,1
2,299,1,0,10,6,4,27,10,1
2,86,1,1,6,17,-11,12,10,1
2,27,1,0,17,6,11,52,10,1
3,837,1,1,6,17,-11,45,10,1
3,760,2,0,17,6,11,46,6,1
3,590,1,1,8,17,-9,34,10,1
3,581,2,1,8,17,-9,34,10,1
3,394,1,1,8,17,-9,24,10,1
4,691,2,1,15,27,-12,44,8,1
4,136,2,1,22,27,-5,20,9,1
4,46,2,0,30,28,2,23,13,1
4,10,1,0,30,28,2,53,10,1
1,275,2,1,0,7,-7,47,5,1
1,195,2,1,0,8,-8,38,7,1
1,149,1,0,8,0,8,23,10,1
1,132,2,0,8,0,8,23,10,1
1,51,1,0,8,0,8,36,10,1
2,766,1,1,3,8,-5,43,10,1
2,750,2,1,3,8,-5,43,10,1
2,456,1,1,3,15,-12,26,10,1
2,224,1,0,15,3,12,54,20,1
2,210,2,0,15,3,12,54,20,1
2,112,1,1,3,22,-19,37,10,1
2,58,2,0,22,3,19,32,7,1
3,375,1,0,22,16,6,34,10,1
3,305,1,0,22,16,6,44,10,1
3,29,1,0,22,16,6,42,10,1
4,900,1,1,16,22,-6,35,10,1
4,878,2,1,16,22,-6,35,10,1
4,827,1,1,16,23,-7,20,10,1
4,288,1,0,30,19,11,45,5,1
4,66,1,0,33,19,14,48,10,1
4,46,3,1,19,33,-14,47,25,1
1,748,1,0,0,0,0,9,9,1
1,325,1,1,3,0,3,39,10,1
1,131,1,1,3,1,2,24,10,1
2,302,1,0,9,10,-1,14,10,1
2,169,2,0,9,17,-8,43,8,1
2,145,1,1,17,9,8,21,10,1
2,134,1,1,17,9,8,10,10,1
3,853,2,1,17,16,1,45,6,1
3,729,1,0,16,17,-1,40,10,1
3,722,2,0,16,17,-1,40,10,1
3,541,2,1,17,16,1,39,17,1
3,368,2,1,17,16,1,49,7,1
3,157,2,0,17,17,0,39,11,1
3,80,2,0,17,17,0,12,13,1
3,40,1,0,17,17,0,45,10,1
3,21,2,0,17,17,0,45,10,1
4,793,1,0,17,17,0,53,10,1
4,673,2,0,17,17,0,5,6,1
4,568,1,0,17,19,-2,39,10,1
4,427,1,0,17,19,-2,11,10,1
4,133,2,0,20,26,-6,37,8,1
4,99,1,0,20,27,-7,37,10,1
4,21,1,0,20,27,-7,55,15,1
4,14,2,0,20,27,-7,55,15,1
1,570,2,0,0,0,0,20,12,1
1,391,1,0,0,0,0,27,10,1
1,371,2,0,0,0,0,27,10,1
1,295,1,0,0,3,-3,53,10,1
1,278,2,0,0,3,-3,53,10,1
1,71,2,1,3,0,3,50,12,1
1,36,1,0,0,3,-3,30,10,1
1,16,2,0,0,3,-3,30,10,1
2,801,2,1,3,0,3,40,14,1
2,377,2,1,3,7,-4,25,6,1
2,34,1,0,15,3,12,45,10,1
2,24,1,1,3,15,-12,40,10,1
3,836,1,0,16,3,13,24,10,1
3,520,1,0,23,10,13,50,10,1
3,362,1,1,10,23,-13,42,10,1
4,900,1,0,25,10,15,49,10,1
4,887,2,0,25,10,15,49,10,1
4,843,1,1,10,25,-15,34,10,1
4,821,2,1,10,25,-15,34,10,1
4,320,1,1,10,28,-18,55,10,1
4,230,1,0,28,10,18,23,10,1
4,162,1,0,28,10,18,9,9,1
4,129,1,1,17,28,-11,46,10,1
4,125,2,1,17,28,-11,46,10,1
4,120,3,1,17,28,-11,41,15,1
4,30,1,1,17,31,-14,35,10,1
1,786,2,1,0,7,-7,35,9,1
1,385,1,1,0,14,-14,39,10,1
1,316,2,0,14,0,14,41,6,1
1,120,1,1,0,21,-21,43,10,1
2,696,1,0,21,0,21,28,10,1
2,536,2,0,21,0,21,54,6,1
2,318,1,1,0,21,-21,26,10,1
2,198,1,1,0,28,-28,37,10,1
2,171,2,1,0,28,-28,32,15,1
2,150,1,0,28,0,28,50,10,1
2,27,1,0,31,0,31,52,10,1
3,606,1,0,31,3,28,26,10,1
3,542,3,0,31,3,28,20,4,1
3,307,2,1,3,31,-28,37,17,1
3,217,1,1,3,32,-29,48,10,1
3,185,2,1,3,32,-29,48,10,1
4,900,1,0,32,3,29,48,10,1
4,641,1,0,32,10,22,31,10,1
4,555,2,0,32,10,22,8,8,1
4,367,2,0,32,13,19,46,10,1
1,892,1,1,0,0,0,32,10,1
1,865,2,1,0,0,0,32,10,1
1,678,2,0,0,7,-7,25,9,1
1,587,2,0,0,7,-7,51,1,1
1,206,2,0,0,13,-13,40,14,1
2,831,1,0,0,16,-16,35,10,1
2,418,1,0,7,16,-9,33,10,1
2,386,2,0,7,16,-9,38,5,1
2,119,1,0,7,23,-16,46,10,1
2,114,2,0,7,23,-16,46,10,1
2,28,1,0,7,23,-16,47,10,1
3,759,2,1,26,7,19,21,6,1
3,684,2,1,26,10,16,35,10,1
3,415,2,1,26,17,9,45,6,1
3,330,1,0,17,26,-9,49,10,1
3,314,2,0,17,26,-9,49,10,1
3,160,1,1,26,17,9,25,10,1
3,77,2,1,26,17,9,6,5,1
4,900,2,1,26,20,6,51,8,1
4,730,2,1,26,20,6,55,6,1
1,813,1,0,0,0,0,53,20,1
1,670,1,1,0,0,0,18,10,1
1,27,2,0,14,0,14,17,10,1
2,837,1,1,3,14,-11,44,10,1
2,535,1,1,3,21,-18,46,10,1
2,515,2,1,3,21,-18,46,10,1
2,450,2,0,21,3,18,31,9,1
2,264,2,1,3,21,-18,29,6,1
2,76,1,1,3,31,-28,41,10,1
2,71,2,1,3,31,-28,41,10,1
3,855,1,0,31,3,28,38,10,1
3,834,2,0,31,3,28,38,10,1
3,791,1,1,3,31,-28,37,10,1
3,502,1,0,31,3,28,30,10,1
3,493,2,0,31,3,28,30,10,1
3,475,3,0,31,3,28,30,10,1
3,303,2,1,3,31,-28,43,8,1
3,50,2,1,3,32,-29,49,5,1
4,900,1,1,3,32,-29,21,10,1
4,832,1,1,3,39,-36,25,10,1
4,820,2,1,3,39,-36,25,10,1
4,715,1,1,3,39,-36,39,10,1
4,684,2,1,3,39,-36,39,10,1
4,615,1,1,3,40,-37,51,10,1
4,400,2,1,10,40,-30,52,10,1
4,354,1,1,10,40,-30,54,10,1
4,233,1,0,40,17,23,7,7,1
4,214,2,0,40,17,23,7,7,1
1,716,2,1,0,0,0,34,13,1
1,174,1,0,10,0,10,48,10,1
1,157,2,0,10,0,10,48,10,1
2,390,1,1,7,10,-3,53,10,1
2,374,2,1,7,10,-3,53,10,1
2,50,1,0,17,7,10,49,10,1
3,872,2,1,7,17,-10,16,3,1
3,837,1,1,7,17,-10,21,10,1
3,638,2,0,17,7,10,55,14,1
3,543,2,1,7,17,-10,17,11,1
3,400,1,1,7,17,-10,30,10,1
3,379,2,1,7,17,-10,30,10,1
3,213,1,1,7,17,-10,30,10,1
3,177,1,1,7,17,-10,13,10,1
4,883,1,0,24,8,16,35,10,1
4,867,2,0,24,8,16,35,10,1
4,768,1,0,24,8,16,11,10,1
4,738,2,0,24,8,16,11,10,1
4,700,1,0,24,11,13,31,10,1
4,528,1,1,11,24,-13,39,10,1
4,509,2,1,11,24,-13,39,10,1
4,469,1,1,11,27,-16,35,10,1
4,435,1,1,11,27,-16,40,10,1
4,317,1,1,11,34,-23,35,10,1
4,102,2,1,18,34,-16,15,11,1
1,643,1,0,0,0,0,28,10,1
1,622,2,0,0,0,0,28,10,1
1,540,2,0,0,3,-3,38,7,1
1,335,1,1,10,0,10,8,8,1
1,323,2,1,10,0,10,8,8,1
1,76,1,0,3,17,-14,20,10,1
2,833,2,0,3,17,-14,49,13,1
2,675,2,1,17,3,14,53,7,1
2,587,1,0,3,18,-15,54,10,1
2,576,2,0,3,18,-15,54,10,1
2,451,2,0,3,18,-15,46,6,1
2,395,1,0,3,18,-15,10,10,1
2,248,1,1,18,3,15,50,10,1
2,226,2,1,18,3,15,50,10,1
2,73,1,0,4,25,-21,38,10,1
2,67,2,0,4,25,-21,38,10,1
2,43,1,1,25,4,21,49,10,1
3,747,1,1,25,4,21,52,10,1
3,586,2,0,4,25,-21,7,6,1
3,385,2,1,28,4,24,35,4,1
3,234,1,0,4,28,-24,36,10,1
3,25,1,0,11,35,-24,50,10,1
4,825,1,0,11,35,-24,43,10,1
4,576,1,0,11,38,-27,27,10,1
4,562,2,0,11,38,-27,27,10,1
4,517,1,1,38,11,27,33,10,1
4,369,1,0,11,38,-27,41,10,1
1,809,1,1,0,0,0,35,10,1
1,704,2,1,0,0,0,51,7,1
1,605,1,1,0,0,0,8,8,1
1,577,2,1,0,0,0,8,8,1
1,438,1,0,3,0,3,21,10,1
1,323,2,0,3,7,-4,39,11,1
1,210,1,1,7,3,4,40,10,1
2,900,2,1,7,3,4,37,6,1
2,845,2,1,7,4,3,41,6,1
2,786,2,0,4,7,-3,25,13,1
2,720,1,1,7,4,3,55,10,1
2,700,2,1,7,4,3,55,10,1
2,575,2,0,4,8,-4,51,4,1
2,286,1,1,8,7,1,45,10,1
2,210,1,1,8,7,1,55,10,1
2,205,2,1,8,7,1,55,10,1
2,167,1,0,7,8,-1,24,10,1
2,148,1,0,7,8,-1,43,10,1
2,127,2,0,7,8,-1,43,10,1
3,815,1,1,8,7,1,17,10,1
3,809,2,1,8,7,1,17,10,1
3,695,1,0,10,8,2,54,10,1
3,386,1,1,9,10,-1,40,10,1
3,364,2,1,9,10,-1,40,10,1
3,259,2,1,9,11,-2,39,11,1
3,217,1,0,11,9,2,11,10,1
4,900,2,0,11,11,0,18,18,1
4,680,2,1,14,11,3,31,6,1
4,487,1,0,14,14,0,48,10,1
4,474,2,0,14,14,0,48,10,1
4,407,2,1,14,14,0,35,6,1
4,354,1,0,14,14,0,41,10,1
4,54,1,0,21,21,0,34,10,1
4,49,2,0,21,21,0,34,10,1
1,791,1,0,0,0,0,8,8,1
1,676,2,1,3,0,3,51,8,1
1,500,1,0,0,3,-3,49,10,1
1,467,2,0,0,3,-3,49,10,1
1,421,1,0,0,3,-3,15,10,1
1,407,2,0,0,3,-3,15,10,1
1,274,1,0,0,3,-3,2,2,1
1,195,2,0,0,10,-10,25,10,1
1,96,2,0,0,10,-10,38,9,1
2,836,2,1,13,0,13,6,6,1
2,328,1,0,4,16,-12,39,10,1
2,240,2,0,4,16,-12,13,9,1
2,173,1,0,4,19,-15,41,10,1
2,84,1,0,11,19,-8,44,10,1
2,37,1,0,11,19,-8,16,10,1
2,32,2,0,11,19,-8,16,10,1
2,13,1,0,11,19,-8,48,10,1
2,4,2,0,11,19,-8,48,10,1
3,894,1,0,11,19,-8,30,10,1
3,871,2,0,11,19,-8,30,10,1
3,783,1,0,11,19,-8,52,10,1
3,761,2,0,11,19,-8,52,10,1
3,627,1,0,11,19,-8,20,10,1
3,430,1,1,26,11,15,21,10,1
3,286,1,1,26,18,8,15,10,1
4,378,1,0,26,26,0,6,6,1
4,274,2,1,33,26,7,50,8,1
4,99,1,0,26,33,-7,45,10,1
4,85,1,1,33,26,7,53,10,1
4,13,2,1,40,26,14,44,8,1
1,574,1,1,7,0,7,29,10,1
1,556,2,1,7,0,7,29,10,1
1,152,1,1,7,0,7,2,2,1
2,701,1,0,7,14,-7,47,10,1
2,640,1,1,14,7,7,51,10,1
2,545,1,1,14,7,7,8,10,1
2,355,2,1,14,16,-2,34,4,1
2,310,1,0,16,14,2,25,10,1
2,154,2,0,16,21,-5,38,6,1
2,93,2,0,16,21,-5,47,4,1
3,675,1,0,16,21,-5,49,10,1
3,655,2,0,16,21,-5,49,10,1
3,497,2,1,21,16,5,35,5,1
3,450,1,0,16,21,-5,38,10,1
3,438,2,0,16,21,-5,38,10,1
3,190,1,1,21,19,2,49,10,1
3,118,1,0,19,21,-2,25,10,1
4,789,2,0,19,21,-2,16,8,1
4,634,2,1,24,19,5,49,22,1
4,557,2,1,24,19,5,17,5,1
4,393,2,0,19,24,-5,52,6,1
4,298,1,1,24,19,5,23,10,1
4,273,2,1,24,19,5,23,10,1
4,141,1,0,22,24,-2,1,10,1
4,136,2,0,22,24,-2,1,10,1
4,18,3,1,26,22,4,35,0,1
1,894,1,0,0,0,0,39,10,1
1,871,2,0,0,0,0,39,10,1
1,480,1,1,0,0,0,38,10,1
1,319,1,0,3,0,3,46,10,1
1,136,1,0,3,0,3,54,10,1
2,793,2,0,3,7,-4,45,6,1
2,556,1,0,3,14,-11,25,10,1
2,136,1,0,3,14,-11,26,10,1
2,27,1,1,14,3,11,24,10,1
3,838,1,1,14,3,11,51,10,1
3,761,1,1,14,4,10,35,10,1
3,653,2,0,4,14,-10,47,9,1
3,474,2,0,4,14,-10,43,7,1
3,374,2,1,14,4,10,9,13,1
3,325,1,1,14,4,10,40,10,1
3,219,2,1,14,4,10,42,7,1
3,145,2,1,14,7,7,38,7,1
4,473,2,0,9,14,-5,32,3,1
4,352,2,0,9,14,-5,47,6,1
4,260,2,1,14,9,5,44,4,1
1,353,1,0,3,7,-4,11,10,1
1,252,1,1,7,3,4,50,10,1
2,900,1,1,7,6,1,41,10,1
2,35,2,0,16,14,2,13,13,1
3,580,1,0,16,24,-8,25,10,1
3,564,2,0,16,24,-8,25,10,1
3,458,1,0,16,24,-8,42,10,1
3,422,2,0,16,24,-8,42,10,1
3,330,2,0,16,24,-8,9,11,1
4,882,1,0,16,33,-17,38,10,1
4,848,2,0,16,33,-17,38,10,1
4,715,1,1,33,16,17,21,10,1
4,680,2,1,33,16,17,21,10,1
4,481,2,1,33,17,16,47,2,1
4,357,0,0,23,33,-10,5,0,1
4,15,1,1,36,26,10,34,20,1
1,866,2,0,0,0,0,45,4,1
1,669,2,1,0,0,0,9,9,1
1,619,2,1,0,3,-3,36,9,1
1,473,2,0,3,0,3,40,8,1
1,319,1,0,3,0,3,45,10,1
1,161,2,0,3,0,3,40,7,1
1,121,1,1,0,3,-3,30,10,1
1,96,2,1,0,3,-3,30,10,1
2,498,1,0,10,0,10,12,10,1
2,395,2,0,10,7,3,54,0,1
2,121,1,0,10,14,-4,33,10,1
2,117,2,0,10,14,-4,33,10,1
2,101,1,0,10,14,-4,12,10,1
2,97,2,0,10,14,-4,12,10,1
2,26,1,1,17,10,7,40,10,1
2,5,1,1,17,17,0,47,10,1
2,1,2,1,17,17,0,47,10,1
3,547,1,0,17,20,-3,45,10,1
3,290,1,1,20,24,-4,55,10,1
3,20,1,0,24,23,1,49,10,1
4,722,1,0,24,23,1,15,10,1
4,705,2,0,24,23,1,15,10,1
4,445,2,1,26,31,-5,45,7,1
4,389,1,0,31,26,5,33,10,1
4,180,1,0,31,26,5,26,10,1
4,167,2,0,31,26,5,26,10,1
4,106,2,1,27,31,-4,54,8,1
4,76,1,1,27,31,-4,31,10,1
4,70,2,1,27,31,-4,31,10,1
4,63,3,1,27,31,-4,31,10,1
1,870,2,0,0,0,0,25,20,1
1,724,1,1,0,0,0,52,10,1
1,111,2,1,0,12,-12,50,8,1
1,41,1,1,0,12,-12,26,10,1
2,864,1,0,12,0,12,44,20,1
2,91,2,1,7,15,-8,25,12,1
2,51,2,1,7,15,-8,37,7,1
2,9,2,1,7,18,-11,17,5,1
3,740,2,0,21,14,7,38,11,1
3,506,2,0,28,21,7,47,6,1
3,456,1,1,21,28,-7,19,10,1
3,335,1,0,28,21,7,47,10,1
3,222,2,0,28,21,7,35,9,1
3,111,2,0,28,24,4,45,7,1
3,77,1,1,24,28,-4,37,10,1
3,1,1,0,28,24,4,38,10,1
4,840,2,0,28,24,4,23,7,1
4,687,1,0,28,27,1,41,10,1
4,610,1,1,27,28,-1,21,10,1
4,565,2,1,27,28,-1,26,15,1
4,193,2,0,38,36,2,33,12,1
4,156,2,0,38,36,2,22,5,1
4,132,1,1,36,38,-2,49,10,1
4,38,2,1,36,38,-2,10,5,1
4,28,1,1,36,38,-2,31,10,1
4,15,1,1,36,38,-2,46,10,1
1,435,2,1,7,0,7,51,2,1
1,397,1,1,7,0,7,13,10,1
1,309,2,1,7,2,5,53,8,1
1,224,2,1,7,2,5,2,13,1
1,72,1,1,7,4,3,25,10,1
1,1,1,1,7,4,3,21,21,1
2,366,2,1,7,14,-7,50,9,1
2,95,1,1,14,14,0,30,10,1
2,60,1,1,14,21,-7,42,10,1
2,33,1,0,21,14,7,40,10,1
3,888,1,1,14,21,-7,29,10,1
3,848,1,1,14,21,-7,46,10,1
3,833,2,1,14,21,-7,46,10,1
3,476,2,0,21,14,7,45,11,1
3,436,1,1,14,21,-7,12,10,1
3,163,1,0,21,14,7,49,10,1
4,422,1,1,14,29,-15,41,10,1
4,93,2,1,14,32,-18,38,7,1
1,762,2,0,0,0,0,46,5,1
1,473,1,1,0,1,-1,35,10,1
1,148,1,0,1,2,-1,23,10,1
2,762,1,1,9,1,8,40,10,1
2,718,2,1,9,1,8,40,10,1
3,330,1,0,8,23,-15,21,10,1
3,299,2,0,8,23,-15,21,10,1
3,160,1,1,24,8,16,33,10,1
3,53,2,1,24,8,16,11,11,1
4,798,2,0,11,24,-13,43,6,1
4,541,1,1,24,11,13,12,10,1
4,436,1,1,24,18,6,43,10,1
4,273,2,0,18,24,-6,48,14,1
4,104,1,1,24,18,6,37,10,1
4,88,2,1,24,18,6,37,10,1
1,871,2,0,0,0,0,36,6,1
1,643,2,0,0,7,-7,40,5,1
1,599,1,1,7,0,7,27,10,1
1,266,1,1,10,0,10,48,10,1
2,893,1,0,0,17,-17,44,10,1
2,785,1,1,17,0,17,37,10,1
2,553,3,1,17,0,17,34,7,1
2,210,2,1,24,0,24,50,10,1
2,154,2,1,24,0,24,25,12,1
2,27,2,1,24,3,21,6,3,1
3,892,1,1,24,6,18,36,10,1
3,546,1,0,7,24,-17,36,10,1
3,365,2,0,7,24,-17,30,9,1
3,244,1,0,7,24,-17,35,15,1
4,857,1,0,7,27,-20,40,10,1
4,761,2,1,27,7,20,16,3,1
4,492,1,0,14,27,-13,37,10,1
4,467,2,0,14,27,-13,37,10,1
4,202,1,0,14,27,-13,15,10,1
4,98,3,0,14,34,-20,35,2,1
4,9,1,1,37,14,23,48,10,1
4,2,2,1,37,14,23,48,10,1
1,894,1,1,0,0,0,27,10,1
1,767,2,0,0,0,0,39,6,1
1,535,2,1,3,3,0,26,19,1
1,447,2,0,3,3,0,33,3,1
2,535,2,0,6,10,-4,40,6,1
2,483,1,1,10,6,4,32,10,1
2,168,1,1,10,9,1,35,10,1
2,90,1,1,10,9,1,23,10,1
3,3,1,0,22,24,-2,44,10,1
4,900,2,0,22,24,-2,44,10,1
4,677,1,0,22,24,-2,35,10,1
4,673,2,0,22,24,-2,35,10,1
4,471,1,1,27,29,-2,49,10,1
4,347,1,0,29,27,2,25,10,1
1,840,1,1,0,0,0,49,10,1
1,625,2,1,0,0,0,30,9,1
1,466,1,1,0,0,0,31,10,1
1,421,1,1,0,0,0,53,10,1
1,330,2,1,0,0,0,16,4,1
1,136,2,1,0,3,-3,33,12,1
1,41,1,0,3,0,3,35,10,1
1,1,2,0,3,0,3,35,10,1
2,756,2,0,3,0,3,40,6,1
2,144,1,0,13,3,10,52,10,1
3,891,1,1,10,20,-10,20,10,1
3,843,1,1,10,20,-10,34,10,1
3,751,2,0,20,10,10,38,10,1
3,670,2,0,20,10,10,20,6,1
3,582,2,0,20,10,10,50,4,1
3,529,1,0,20,10,10,13,10,1
3,315,2,0,20,10,10,55,7,1
3,206,1,1,10,20,-10,43,10,1
3,182,2,1,10,20,-10,43,10,1
4,900,1,1,10,20,-10,37,10,1
4,790,2,1,10,20,-10,4,4,1
4,559,2,0,23,10,13,26,12,1
4,515,1,0,23,13,10,25,20,1
4,140,1,0,24,13,11,19,10,1
4,42,1,1,13,27,-14,35,10,1
4,31,3,1,13,27,-14,44,1,1
1,738,2,0,0,0,0,6,6,1
1,606,1,1,3,0,3,30,10,1
1,585,2,1,3,0,3,30,10,1
1,420,2,1,3,3,0,42,14,1
1,176,2,1,3,3,0,25,10,1
1,1,2,1,3,10,-7,34,7,1
2,768,1,1,3,10,-7,30,10,1
2,442,1,0,17,3,14,50,10,1
2,273,1,1,3,17,-14,16,10,1
2,249,2,1,3,17,-14,16,10,1
2,118,1,0,20,3,17,19,10,1
2,113,2,0,20,3,17,19,10,1
2,109,3,0,20,3,17,19,10,1
2,30,1,0,20,3,17,55,10,1
3,895,1,1,3,23,-20,44,10,1
3,469,2,0,23,10,13,46,11,1
3,394,1,1,10,23,-13,33,10,1
3,374,2,1,10,23,-13,33,10,1
3,296,2,0,23,10,13,36,3,1
3,122,2,0,23,10,13,54,5,1
3,78,1,0,23,10,13,15,10,1
4,900,2,0,23,10,13,34,12,1
4,809,1,1,10,23,-13,33,10,1
4,640,1,0,23,10,13,27,10,1
4,489,2,0,23,17,6,50,13,1
4,412,2,0,23,17,6,22,2,1
4,365,1,1,17,23,-6,35,10,1
4,299,1,1,17,23,-6,50,10,1
4,150,1,0,23,17,6,13,10,1
4,90,2,1,20,23,-3,26,6,1
4,50,1,1,20,26,-6,54,10,1
4,33,3,0,26,20,6,49,3,1
1,849,2,0,0,0,0,43,4,1
1,675,2,1,0,0,0,50,5,1
1,496,1,1,0,7,-7,38,10,1
1,469,2,1,0,7,-7,38,10,1
1,428,1,0,7,0,7,36,10,1
1,1,1,0,7,10,-3,8,10,1
2,757,1,0,7,13,-6,20,10,1
2,378,2,0,7,27,-20,47,5,1
2,253,2,1,27,7,20,45,5,1
2,190,1,0,7,27,-20,36,10,1
2,170,2,0,7,27,-20,36,10,1
2,44,1,0,7,28,-21,8,8,1
2,24,2,0,7,28,-21,8,8,1
3,854,2,0,7,31,-24,34,8,1
3,590,1,1,31,7,24,29,10,1
3,384,2,1,31,14,17,26,7,1
3,288,2,1,31,14,17,47,6,1
3,214,1,1,31,14,17,32,10,1
3,42,2,1,31,14,17,55,13,1
4,842,1,1,31,14,17,49,10,1
4,742,1,0,14,32,-18,35,10,1
4,657,1,0,14,32,-18,51,10,1
4,497,1,1,32,14,18,52,10,1
4,352,1,1,32,14,18,45,20,1
4,175,1,0,14,32,-18,27,10,1
4,145,3,0,14,32,-18,34,3,1
4,90,1,0,14,35,-21,35,10,1
4,85,2,0,14,35,-21,35,10,1
1,893,1,0,0,0,0,40,10,1
1,782,2,1,0,0,0,44,8,1
1,650,2,0,0,0,0,50,4,1
1,498,1,1,0,0,0,34,10,1
1,42,1,1,14,0,14,31,10,1
1,24,2,1,14,0,14,31,10,1
2,882,1,0,0,14,-14,51,10,1
2,836,1,1,14,0,14,19,10,1
2,800,2,1,14,0,14,19,10,1
2,696,1,1,14,3,11,49,10,1
2,500,2,1,21,3,18,48,8,1
2,354,1,1,21,3,18,41,10,1
2,335,2,1,21,3,18,41,10,1
2,180,2,0,3,21,-18,25,8,1
2,159,1,0,3,24,-21,35,10,1
2,20,1,1,31,3,28,50,10,1
2,6,2,1,31,3,28,50,10,1
3,812,1,0,3,31,-28,50,10,1
3,771,2,0,3,31,-28,50,10,1
3,603,2,0,3,31,-28,18,14,1
3,514,2,0,3,34,-31,36,9,1
3,479,3,0,3,34,-31,36,9,1
3,405,1,0,3,34,-31,48,10,1
3,384,2,0,3,34,-31,48,10,1
3,319,1,1,34,3,31,26,10,1
3,183,2,1,34,3,31,40,7,1
3,40,2,0,3,34,-31,48,4,1
4,635,2,1,34,5,29,52,4,1
4,432,2,1,36,5,31,49,9,1
4,136,2,1,36,5,31,21,5,1
4,112,3,1,36,5,31,21,5,1
4,103,2,1,36,5,31,25,6,1
4,39,1,1,36,5,31,31,10,1
4,16,2,1,36,5,31,31,10,1
4,11,3,1,36,5,31,31,10,1
1,746,1,1,0,0,0,52,10,1
1,731,2,1,0,0,0,52,10,1
1,498,2,0,0,7,-7,24,10,1
1,400,1,0,0,7,-7,38,10,1
2,571,2,1,13,7,6,40,5,1
2,196,2,1,21,10,11,48,3,1
2,48,1,1,21,10,11,46,10,1
2,37,1,1,21,10,11,7,7,1
3,847,2,0,17,21,-4,48,11,1
3,594,2,0,17,21,-4,25,6,1
3,378,2,0,17,21,-4,36,5,1
3,332,1,0,17,24,-7,35,10,1
3,317,2,0,17,24,-7,35,10,1
3,188,1,0,17,24,-7,13,10,1
3,171,2,0,17,24,-7,13,10,1
3,69,1,1,27,17,10,10,10,1
3,45,2,1,27,17,10,10,10,1
4,486,2,1,27,20,7,48,12,1
4,438,1,1,27,21,6,35,10,1
4,368,1,0,21,27,-6,50,10,1
4,300,1,0,21,27,-6,1,10,1
4,129,1,0,21,36,-15,50,10,1
4,123,2,0,21,36,-15,50,10,1
1,845,1,1,0,7,-7,35,10,1
1,826,2,1,0,7,-7,35,10,1
1,742,2,0,7,0,7,55,10,1
1,664,2,1,0,7,-7,24,4,1
1,593,1,1,0,7,-7,30,10,1
1,524,1,1,0,7,-7,6,6,1
1,143,2,0,10,0,10,43,11,1
1,106,1,0,10,1,9,35,10,1
2,835,2,0,12,1,11,48,5,1
2,783,1,1,1,12,-11,29,10,1
2,718,1,0,12,1,11,31,10,1
2,452,2,0,12,1,11,52,6,1
2,399,1,1,1,12,-11,39,10,1
2,376,2,1,1,12,-11,39,10,1
2,204,1,0,12,8,4,52,10,1
3,743,2,0,15,22,-7,35,9,1
3,612,1,0,15,22,-7,26,10,1
4,520,1,0,15,36,-21,41,15,1
4,405,1,1,36,15,21,25,10,1
4,108,2,0,22,43,-21,46,5,1
4,84,1,1,43,22,21,30,10,1
1,894,1,1,0,0,0,39,10,1
1,835,1,0,0,0,0,36,10,1
1,716,2,0,0,0,0,53,8,1
1,340,1,1,0,7,-7,55,10,1
2,900,1,1,0,14,-14,54,10,1
2,716,1,1,0,14,-14,25,10,1
2,487,1,1,0,16,-16,21,10,1
2,348,2,1,0,16,-16,34,6,1
2,168,2,1,0,16,-16,48,6,1
2,92,2,0,16,0,16,15,1,1
2,36,1,1,3,16,-13,54,10,1
3,868,2,0,16,3,13,43,9,1
3,46,2,0,23,10,13,47,4,1
4,781,1,0,23,10,13,52,20,1
4,565,1,0,23,17,6,25,10,1
4,325,2,1,20,23,-3,35,9,1
4,165,1,1,27,23,4,34,10,1
4,154,2,1,27,23,4,34,10,1
4,18,1,0,24,27,-3,17,10,1
4,14,2,0,24,27,-3,17,10,1
4,8,3,0,24,27,-3,17,10,1
1,456,2,0,3,0,3,40,6,1
1,58,2,1,3,3,0,30,6,1
1,12,1,0,3,3,0,29,10,1
2,843,1,0,3,3,0,52,10,1
2,595,2,1,10,3,7,48,7,1
2,557,1,1,10,3,7,14,10,1
2,519,1,1,10,3,7,5,5,1
2,410,2,1,10,6,4,35,10,1
2,339,1,1,10,6,4,46,10,1
2,177,2,1,10,6,4,27,9,1
2,100,2,1,10,6,4,25,12,1
2,66,1,1,10,9,1,12,10,1
2,36,0,0,15,10,5,5,0,1
3,855,2,0,15,10,5,27,6,1
3,769,1,0,15,13,2,51,10,1
3,754,2,0,15,13,2,51,10,1
3,187,1,1,19,15,4,23,10,1
4,900,2,1,19,18,1,44,22,1
4,762,1,1,19,18,1,38,10,1
4,664,2,0,18,19,-1,35,3,1
4,502,2,1,22,18,4,31,6,1
4,95,2,0,25,29,-4,25,14,1
1,891,1,1,0,0,0,44,10,1
1,754,1,1,0,0,0,50,10,1
1,591,2,0,0,7,-7,46,7,1
1,394,2,0,0,7,-7,21,8,1
1,341,1,0,0,7,-7,25,10,1
1,329,2,0,0,7,-7,25,10,1
1,169,1,0,0,7,-7,35,10,1
1,148,2,0,0,7,-7,35,10,1
1,73,2,0,0,10,-10,37,8,1
2,887,2,1,10,0,10,51,12,1
2,229,1,1,11,14,-3,32,10,1
2,201,2,1,11,14,-3,32,10,1
3,842,2,0,15,11,4,48,4,1
3,718,1,1,11,15,-4,46,10,1
3,521,1,0,15,11,4,11,10,1
3,333,2,0,15,17,-2,36,8,1
3,285,1,1,17,15,2,29,10,1
3,206,2,0,15,17,-2,17,10,1
3,133,2,0,15,17,-2,53,11,1
4,753,2,1,19,15,4,34,10,1
4,614,2,0,15,19,-4,33,6,1
4,488,2,0,15,20,-5,52,8,1
4,135,1,1,20,23,-3,53,10,1
4,119,2,1,20,23,-3,53,10,1
4,112,3,1,20,23,-3,53,10,1
1,893,1,0,0,0,0,26,10,1
1,446,2,1,0,3,-3,53,8,1
1,190,1,0,3,0,3,10,5,1
2,777,1,0,4,7,-3,43,10,1
2,758,2,0,4,7,-3,43,10,1
2,694,2,0,4,7,-3,15,7,1
2,557,2,0,4,7,-3,38,9,1
2,430,2,0,4,10,-6,50,6,1
2,150,2,0,4,17,-13,47,8,1
2,79,2,1,17,4,13,33,12,1
3,808,1,0,4,17,-13,40,10,1
3,660,2,1,17,4,13,44,5,1
3,539,1,0,4,17,-13,55,10,1
3,384,1,1,17,4,13,26,10,1
3,360,2,1,17,4,13,26,10,1
3,269,1,1,17,4,13,14,10,1
3,242,2,1,17,4,13,14,10,1
3,115,1,1,17,7,10,52,10,1
4,900,2,0,7,17,-10,35,10,1
4,870,1,1,17,7,10,44,10,1
4,600,2,0,7,20,-13,32,13,1
4,418,2,0,7,20,-13,9,9,1
4,345,2,0,7,23,-16,40,5,1
4,267,2,1,23,7,16,37,5,1
4,234,1,0,7,23,-16,40,10,1
1,856,2,1,0,0,0,30,7,1
1,682,2,0,0,0,0,52,5,1
1,636,1,0,0,0,0,8,10,1
1,467,1,1,3,0,3,37,10,1
1,387,1,1,3,0,3,24,10,1
1,362,2,1,3,0,3,24,10,1
1,227,1,1,3,0,3,53,10,1
1,208,2,1,3,0,3,53,10,1
2,866,1,0,3,3,0,33,10,1
2,546,1,1,6,3,3,16,10,1
2,320,2,1,6,10,-4,32,3,1
2,233,2,0,10,6,4,51,12,1
2,197,1,1,6,10,-4,1,10,1
2,160,1,1,6,10,-4,14,10,1
2,140,2,1,6,10,-4,14,10,1
2,39,1,1,6,17,-11,21,10,1
2,38,2,1,6,17,-11,21,10,1
2,28,1,1,6,17,-11,40,10,1
3,725,1,1,6,20,-14,52,10,1
3,700,2,1,6,20,-14,52,10,1
4,751,1,0,30,6,24,48,10,1
4,740,2,0,30,6,24,48,10,1
4,660,2,0,30,7,23,37,8,1
4,455,2,0,30,7,23,19,5,1
4,192,2,1,7,37,-30,45,4,1
4,45,1,1,7,37,-30,1,10,1
4,34,1,1,7,37,-30,12,10,1
1,870,2,0,0,0,0,47,6,1
1,827,1,1,0,0,0,13,10,1
1,809,2,1,0,0,0,13,10,1
1,768,1,1,0,0,0,49,10,1
1,758,2,1,0,0,0,49,10,1
1,675,1,1,0,0,0,14,10,1
1,606,2,1,0,0,0,30,7,1
1,508,1,1,0,0,0,18,10,1
1,482,2,1,0,0,0,18,10,1
1,73,1,0,10,3,7,35,10,1
1,53,2,0,10,3,7,35,10,1
2,805,2,1,3,10,-7,36,5,1
2,140,1,1,10,13,-3,35,10,1
3,698,1,0,13,10,3,34,10,1
3,587,1,0,13,10,3,24,10,1
3,516,2,0,13,10,3,4,4,1
3,218,2,1,13,16,-3,38,7,1
3,177,1,0,16,13,3,45,10,1
4,190,1,0,23,26,-3,50,10,1
1,805,1,1,0,0,0,50,10,1
1,656,2,1,0,0,0,23,9,1
1,548,2,1,0,0,0,33,9,1
1,345,2,1,0,1,-1,54,7,1
1,1,1,1,0,2,-2,29,10,1
2,598,2,0,2,0,2,20,10,1
2,331,1,0,2,0,2,32,10,1
3,869,1,0,2,0,2,41,10,1
3,831,2,0,2,0,2,41,10,1
3,764,1,0,2,0,2,22,10,1
3,746,2,0,2,0,2,22,10,1
3,648,1,1,3,2,1,51,10,1
3,626,2,1,3,2,1,51,10,1
3,568,2,0,2,3,-1,20,9,1
3,482,2,0,2,3,-1,28,7,1
3,96,1,0,9,6,3,35,10,1
3,13,2,0,9,6,3,15,8,1
4,775,2,0,9,6,3,51,3,1
4,727,1,1,6,9,-3,23,10,1
4,715,2,1,6,9,-3,23,10,1
4,659,2,1,6,9,-3,45,3,1
4,532,1,1,6,10,-4,46,10,1
4,495,2,1,6,10,-4,46,10,1
4,399,2,1,6,10,-4,50,10,1
4,215,1,1,6,10,-4,54,10,1
4,163,1,0,10,6,4,46,10,1
4,10,1,1,13,10,3,25,10,1
1,684,1,0,0,0,0,20,10,1
1,668,2,0,0,0,0,20,10,1
2,829,2,0,7,3,4,22,6,1
2,146,1,0,14,13,1,54,10,1
3,350,2,1,16,24,-8,51,21,1
3,240,1,1,16,24,-8,42,10,1
4,900,1,0,25,16,9,45,10,1
4,665,2,0,25,23,2,55,5,1
4,357,2,0,25,23,2,38,8,1
4,226,2,1,26,25,1,48,6,1
1,890,1,1,0,0,0,41,10,1
1,739,2,1,0,0,0,50,8,1
1,436,2,0,0,0,0,6,6,1
2,720,1,1,6,7,-1,35,10,1
2,313,2,1,6,14,-8,45,8,1
2,126,1,1,6,22,-16,47,10,1
2,111,2,1,6,22,-16,47,10,1
2,79,2,0,22,6,16,35,4,1
3,432,2,1,13,22,-9,13,3,1
3,334,1,1,13,22,-9,42,10,1
3,311,2,1,13,22,-9,42,10,1
3,93,1,1,13,22,-9,34,15,1
4,414,1,1,13,25,-12,46,10,1
4,396,2,1,13,25,-12,46,10,1
4,209,2,1,13,25,-12,32,10,1
4,148,3,1,13,28,-15,42,3,1
4,56,2,1,13,35,-22,36,4,1
4,16,2,0,35,13,22,45,5,1
1,890,1,1,0,0,0,35,10,1
1,728,2,1,0,0,0,9,9,1
1,456,1,0,3,7,-4,34,10,1
1,355,2,1,7,3,4,46,5,1
1,234,1,0,3,7,-4,30,10,1
2,781,1,0,10,14,-4,24,10,1
2,757,2,0,10,14,-4,24,10,1
2,648,2,1,14,10,4,48,6,1
2,392,1,0,10,21,-11,43,10,1
2,180,2,0,10,21,-11,21,5,1
2,160,1,0,10,24,-14,35,10,1
3,869,1,0,17,24,-7,55,10,1
3,597,2,1,24,24,0,55,3,1
3,375,2,0,24,24,0,31,6,1
3,305,2,1,24,24,0,44,5,1
4,880,1,1,24,27,-3,55,10,1
4,846,2,1,24,27,-3,55,10,1
4,547,2,1,24,27,-3,53,6,1
4,82,2,1,24,27,-3,14,8,1
4,67,1,0,30,24,6,44,10,1
4,63,2,0,30,24,6,44,10,1
4,58,3,0,30,24,6,44,10,1
1,628,2,1,0,0,0,38,4,1
1,584,1,1,0,3,-3,35,10,1
1,331,1,0,3,7,-4,48,10,1
1,307,2,0,3,7,-4,48,10,1
1,99,1,0,3,7,-4,42,10,1
1,80,2,0,3,7,-4,42,10,1
2,813,2,0,3,7,-4,12,8,1
2,696,1,0,3,10,-7,50,10,1
2,622,1,0,3,10,-7,29,10,1
2,520,1,0,3,17,-14,34,10,1
2,390,2,0,3,17,-14,14,4,1
2,280,1,1,24,3,21,40,10,1
2,188,2,1,24,3,21,17,10,1
2,109,1,0,6,31,-25,33,10,1
2,103,2,0,6,31,-25,33,10,1
3,774,1,1,31,6,25,52,10,1
3,695,1,0,6,31,-25,22,10,1
3,652,1,0,6,31,-25,40,10,1
3,620,2,0,6,31,-25,40,10,1
3,473,1,0,6,31,-25,37,10,1
3,249,1,1,31,6,25,29,10,1
3,120,2,1,31,13,18,45,10,1
3,40,1,1,31,13,18,26,10,1
3,1,2,1,31,13,18,26,10,1
4,888,1,1,31,16,15,35,10,1
4,802,1,0,16,31,-15,23,10,1
4,714,2,0,16,31,-15,45,4,1
4,158,1,1,45,16,29,32,10,1
4,143,1,1,45,16,29,16,10,1
1,814,1,1,0,0,0,52,10,1
1,797,2,1,0,0,0,52,10,1
1,677,2,0,0,0,0,53,12,1
1,569,2,0,0,0,0,36,5,1
1,253,1,1,3,0,3,8,8,1
1,85,1,0,7,3,4,42,10,1
1,60,2,0,7,3,4,42,10,1
2,620,1,1,3,14,-11,49,10,1
2,378,1,0,14,10,4,24,10,1
2,167,1,0,14,13,1,27,10,1
2,85,2,0,14,13,1,51,6,1
2,64,1,0,14,13,1,33,10,1
3,769,2,1,13,14,-1,35,12,1
3,711,1,0,14,13,1,50,10,1
3,692,2,0,14,13,1,50,10,1
3,619,2,1,13,14,-1,30,18,1
3,570,1,0,14,13,1,30,10,1
3,489,2,1,13,14,-1,27,10,1
3,312,1,1,13,14,-1,12,10,1
3,297,2,1,13,14,-1,12,10,1
3,158,2,1,13,14,-1,17,9,1
3,58,2,1,13,14,-1,7,7,1
3,1,1,1,13,17,-4,29,10,1
4,900,2,1,13,17,-4,29,10,1
4,824,2,0,17,13,4,41,9,1
4,593,2,0,17,13,4,33,13,1
4,557,1,0,17,16,1,35,10,1
4,142,1,0,24,22,2,5,5,1
1,892,1,0,0,0,0,35,10,1
1,740,2,1,0,0,0,46,13,1
1,640,1,1,0,0,0,19,10,1
1,540,2,0,0,0,0,46,5,1
2,803,1,0,3,7,-4,50,10,1
2,789,2,0,3,7,-4,50,10,1
2,707,2,0,3,7,-4,49,5,1
2,676,1,0,3,7,-4,20,10,1
2,657,2,0,3,7,-4,20,10,1
2,625,1,0,3,7,-4,52,10,1
2,614,2,0,3,7,-4,52,10,1
2,471,1,1,7,3,4,26,10,1
2,394,1,0,3,7,-4,54,10,1
2,350,1,1,7,3,4,29,10,1
2,250,1,1,7,4,3,35,10,1
2,125,2,1,7,4,3,9,7,1
2,103,3,1,7,4,3,9,7,1
2,72,2,1,7,4,3,23,7,1
3,614,2,0,4,10,-6,45,16,1
3,400,1,0,4,10,-6,30,10,1
3,229,1,1,11,4,7,38,10,1
3,47,1,0,4,11,-7,25,10,1
3,20,2,0,4,11,-7,20,15,1
4,887,1,1,11,4,7,44,15,1
4,871,2,1,11,4,7,44,15,1
4,450,2,1,11,4,7,40,7,1
4,414,1,0,4,11,-7,42,10,1
4,187,1,1,11,4,7,23,10,1
4,158,1,1,11,11,0,38,10,1
4,8,1,1,11,14,-3,35,10,1
4,1,2,1,11,14,-3,35,10,1
1,893,1,0,0,0,0,33,10,1
1,829,1,1,0,0,0,35,10,1
1,655,2,0,0,0,0,42,7,1
1,410,2,0,0,0,0,45,12,1
1,127,1,0,7,0,7,22,10,1
2,880,1,0,7,7,0,20,10,1
2,850,3,0,7,7,0,20,10,1
2,618,1,1,7,7,0,38,10,1
2,175,2,1,7,10,-3,39,10,1
2,51,2,0,17,7,10,29,2,1
3,855,1,1,7,17,-10,43,10,1
3,812,1,1,7,17,-10,34,10,1
3,728,1,1,7,20,-13,35,10,1
3,706,2,1,7,20,-13,35,10,1
3,630,2,0,20,7,13,27,6,1
3,201,1,1,14,20,-6,55,10,1
4,900,1,1,21,20,1,30,10,1
4,810,2,1,21,20,1,19,14,1
4,548,1,0,23,21,2,50,10,1
4,527,2,0,23,21,2,50,10,1
4,488,1,0,23,21,2,19,10,1
4,269,2,0,23,28,-5,40,10,1
4,130,2,0,23,28,-5,33,9,1
1,857,2,0,0,0,0,37,9,1
1,749,2,0,0,7,-7,39,9,1
1,614,2,1,7,0,7,55,5,1
1,140,1,1,10,0,10,15,10,1
1,119,2,1,10,0,10,15,10,1
2,900,1,0,7,10,-3,27,10,1
2,874,2,0,7,10,-3,27,10,1
2,505,2,1,10,14,-4,23,9,1
2,339,1,1,10,14,-4,48,10,1
2,319,2,1,10,14,-4,48,10,1
2,180,2,1,10,14,-4,41,6,1
2,99,2,1,10,14,-4,41,4,1
2,11,1,1,10,14,-4,49,10,1
3,848,1,0,14,10,4,42,10,1
3,752,1,1,10,14,-4,52,10,1
3,412,2,1,10,21,-11,40,4,1
3,183,1,1,10,21,-11,50,10,1
4,436,1,1,17,21,-4,36,10,1
4,100,1,1,17,21,-4,28,10,1
4,45,1,0,21,17,4,52,10,1
4,37,2,0,21,17,4,52,10,1
4,30,3,0,21,17,4,52,10,1
1,622,1,0,0,7,-7,50,10,1
1,585,2,0,0,7,-7,55,5,1
1,414,2,1,7,0,7,46,3,1
1,222,1,1,7,0,7,51,10,1
1,10,1,0,0,14,-14,30,10,1
2,762,1,1,14,0,14,19,10,1
2,595,1,0,3,14,-11,46,10,1
2,435,2,0,3,14,-11,34,18,1
2,300,2,1,17,3,14,52,7,1
2,170,1,0,4,17,-13,51,10,1
2,152,2,0,4,17,-13,51,10,1
2,55,2,1,17,4,13,35,5,1
3,790,1,1,17,7,10,30,10,1
3,664,1,1,17,7,10,7,7,1
3,641,2,1,17,7,10,7,7,1
3,553,2,1,17,10,7,31,6,1
3,423,1,0,10,17,-7,44,10,1
3,325,1,1,17,10,7,42,10,1
3,185,1,1,17,17,0,26,10,1
4,874,2,0,17,17,0,33,5,1
4,787,1,0,17,17,0,28,10,1
4,506,1,1,17,17,0,18,10,1
4,488,2,1,17,17,0,18,10,1
4,439,1,1,17,20,-3,34,10,1
4,372,1,1,17,20,-3,5,5,1
4,264,1,1,17,20,-3,37,10,1
4,243,2,1,17,20,-3,37,10,1
4,137,2,0,20,17,3,51,7,1
4,119,1,0,20,17,3,34,10,1
4,103,2,0,20,17,3,34,10,1
4,88,1,0,20,20,0,46,10,1
1,858,1,1,0,0,0,33,10,1
1,815,1,0,0,0,0,21,10,1
1,767,1,0,0,0,0,32,10,1
1,497,1,0,3,0,3,51,10,1
2,783,1,0,6,14,-8,52,10,1
2,736,1,0,6,14,-8,29,10,1
2,566,2,0,6,21,-15,34,5,1
2,514,1,1,21,6,15,49,10,1
2,501,2,1,21,6,15,49,10,1
2,399,1,0,6,21,-15,27,10,1
2,369,2,0,6,21,-15,27,10,1
2,263,1,0,6,21,-15,48,10,1
2,145,1,1,21,6,15,21,10,1
2,118,2,1,21,6,15,38,10,1
3,815,1,0,13,21,-8,54,10,1
3,806,2,0,13,21,-8,54,10,1
3,449,1,1,28,13,15,38,10,1
4,590,2,1,35,16,19,40,5,1
4,139,1,0,23,38,-15,35,10,1
4,55,1,0,23,41,-18,35,10,1
1,889,1,0,0,0,0,43,10,1
1,842,2,0,0,0,0,48,5,1
1,704,1,0,0,0,0,47,10,1
1,693,2,0,0,0,0,47,10,1
1,313,2,1,1,0,1,29,5,1
1,80,2,0,7,1,6,26,9,1
2,769,1,0,14,4,10,51,10,1
2,750,2,0,14,4,10,51,10,1
2,644,1,0,14,4,10,47,10,1
2,236,1,0,15,4,11,45,10,1
2,194,1,0,15,4,11,18,10,1
2,105,2,0,15,4,11,20,9,1
2,65,1,0,15,7,8,36,10,1
3,892,1,1,7,22,-15,40,10,1
3,711,1,1,7,23,-16,35,10,1
3,609,2,0,23,7,16,45,5,1
3,573,1,0,23,7,16,19,10,1
3,556,2,0,23,7,16,19,10,1
3,512,1,0,23,7,16,35,10,1
3,412,2,0,23,7,16,12,9,1
3,313,2,0,23,10,13,41,5,1
3,250,1,1,10,23,-13,24,15,1
4,828,1,1,10,23,-13,14,10,1
4,808,2,1,10,23,-13,14,10,1
4,657,3,0,26,10,16,47,4,1
4,495,2,1,10,26,-16,44,7,1
4,390,2,0,26,10,16,45,9,1
4,340,1,1,10,26,-16,33,10,1
4,286,1,0,26,10,16,50,10,1
4,170,2,0,26,10,16,50,6,1
4,146,1,1,10,26,-16,51,10,1
4,100,3,0,26,10,16,54,15,1
4,24,1,1,10,26,-16,33,10,1
1,822,2,1,0,0,0,32,11,1
1,792,1,0,0,0,0,51,10,1
1,779,2,0,0,0,0,51,10,1
1,549,1,0,0,0,0,25,10,1
1,474,1,1,0,0,0,32,10,1
1,145,2,1,0,0,0,54,9,1
1,102,1,0,0,0,0,13,10,1
1,88,2,0,0,0,0,13,10,1
2,744,2,1,7,0,7,30,13,1
2,671,2,0,0,7,-7,43,12,1
3,731,1,0,9,14,-5,52,10,1
3,145,2,0,16,14,2,49,6,1
4,788,1,0,16,14,2,25,10,1
4,782,2,0,16,14,2,25,10,1
4,742,1,1,14,16,-2,53,10,1
4,720,2,1,14,16,-2,53,10,1
4,570,2,1,14,16,-2,27,8,1
4,389,1,1,14,16,-2,24,10,1
4,114,3,1,14,16,-2,40,6,1
4,1,1,1,14,19,-5,51,10,1
1,885,1,0,0,0,0,37,10,1
1,874,2,0,0,0,0,37,10,1
1,810,2,0,0,0,0,48,9,1
1,356,1,0,0,14,-14,51,10,1
1,339,2,0,0,14,-14,51,10,1
1,264,1,1,14,0,14,53,10,1
1,133,1,0,0,14,-14,10,10,1
1,117,2,0,0,14,-14,10,10,1
2,652,1,1,18,0,18,23,10,1
2,409,1,1,18,3,15,13,10,1
2,155,1,1,21,10,11,52,10,1
2,87,2,0,10,21,-11,33,9,1
3,437,1,0,13,24,-11,7,17,1
3,290,1,0,13,24,-11,51,10,1
3,89,1,0,13,31,-18,47,10,1
3,42,2,0,13,31,-18,52,5,1
4,900,2,0,13,31,-18,39,4,1
4,806,1,0,13,34,-21,48,10,1
4,759,1,0,13,34,-21,39,10,1
4,676,2,0,13,34,-21,19,7,1
4,637,1,0,13,37,-24,35,10,1
4,402,2,0,13,37,-24,43,8,1
4,290,2,0,13,37,-24,16,19,1
4,56,1,0,13,37,-24,26,10,1
1,552,1,1,7,0,7,15,10,1
1,286,1,0,0,7,-7,9,9,1
1,198,1,0,0,14,-14,18,20,1
1,176,2,0,0,14,-14,18,20,1
2,900,1,0,0,17,-17,35,10,1
2,826,1,0,0,17,-17,45,10,1
2,546,2,0,0,17,-17,28,8,1
2,503,1,1,17,0,17,41,10,1
2,492,2,1,17,0,17,41,10,1
2,380,2,0,0,17,-17,47,5,1
2,116,2,1,24,7,17,32,7,1
2,1,2,1,24,7,17,53,14,1
3,895,1,0,7,24,-17,27,10,1
3,476,2,1,31,7,24,49,5,1
3,450,1,1,31,7,24,39,10,1
3,340,1,1,31,14,17,37,10,1
3,71,2,1,38,14,24,15,6,1
4,360,2,0,14,45,-31,34,26,1
1,821,2,1,0,0,0,52,9,1
1,768,1,0,0,1,-1,35,10,1
1,241,1,0,0,1,-1,39,10,1
1,95,1,0,0,4,-4,51,10,1
2,801,1,1,11,0,11,45,10,1
2,778,2,1,11,0,11,45,10,1
2,513,2,0,0,11,-11,41,6,1
2,475,1,0,0,11,-11,8,10,1
2,455,2,0,0,11,-11,8,10,1
2,414,1,1,11,0,11,46,10,1
2,19,1,0,0,11,-11,52,10,1
2,13,2,0,0,11,-11,52,10,1
3,666,2,0,0,11,-11,19,11,1
3,628,1,0,0,14,-14,35,10,1
3,584,1,0,0,14,-14,50,10,1
3,560,2,0,0,14,-14,50,10,1
3,492,2,1,14,0,14,39,11,1
3,420,2,0,0,14,-14,40,7,1
3,311,2,1,14,0,14,42,8,1
3,197,1,0,0,15,-15,45,10,1
4,770,1,0,1,22,-21,27,10,1
4,439,1,0,1,29,-28,22,10,1
4,415,2,0,1,29,-28,22,10,1
4,350,1,0,1,29,-28,22,20,1
4,328,2,0,1,29,-28,22,20,1
4,139,1,0,1,29,-28,18,10,1
4,135,2,0,1,29,-28,18,10,1
4,57,1,0,1,29,-28,29,10,1
4,46,2,0,1,29,-28,29,10,1
4,30,1,1,29,1,28,24,10,1
1,522,1,1,7,0,7,34,10,1
1,467,1,1,7,0,7,24,10,1
1,284,1,0,7,7,0,32,10,1
1,262,2,0,7,7,0,32,10,1
2,799,1,1,14,7,7,4,4,1
2,599,1,1,14,10,4,53,5,1
2,402,2,1,14,13,1,36,2,1
2,188,1,0,13,14,-1,40,10,1
3,850,2,0,13,17,-4,41,5,1
3,774,2,1,17,13,4,37,6,1
3,695,2,1,17,13,4,48,9,1
3,428,1,0,13,17,-4,12,10,1
3,346,2,0,13,17,-4,25,10,1
3,129,1,1,17,13,4,29,10,1
3,31,1,1,17,13,4,17,10,1
4,452,1,0,27,17,10,51,10,1
4,379,2,0,27,17,10,41,20,1
4,101,2,0,27,20,7,33,3,1
1,803,1,0,0,0,0,44,10,1
1,552,1,1,3,0,3,51,10,1
1,249,1,1,12,0,12,44,15,1
1,60,2,0,0,12,-12,28,22,1
2,703,1,0,0,19,-19,3,10,1
2,623,2,0,0,19,-19,23,6,1
2,473,1,0,0,21,-21,47,10,1
2,279,2,0,1,21,-20,43,10,1
2,64,1,0,1,24,-23,35,10,1
2,41,1,0,1,24,-23,51,10,1
3,859,1,0,1,24,-23,43,10,1
3,608,2,0,1,24,-23,28,8,1
3,255,1,0,3,31,-28,35,10,1
4,864,1,1,31,3,28,28,10,1
4,824,1,1,31,3,28,18,10,1
4,735,2,1,31,3,28,12,5,1
4,512,1,1,31,3,28,4,4,1
4,494,2,1,31,3,28,4,4,1
4,315,1,0,10,31,-21,55,10,1
4,288,2,0,10,31,-21,55,10,1
1,895,1,1,0,0,0,34,10,1
1,871,2,1,0,0,0,34,10,1
1,817,1,0,0,0,0,48,10,1
1,32,1,1,7,14,-7,8,8,1
2,715,2,0,21,7,14,49,6,1
2,183,1,1,14,21,-7,38,10,1
2,13,1,0,21,14,7,40,10,1
3,792,1,1,17,21,-4,50,10,1
3,673,2,0,21,17,4,9,9,1
3,490,1,1,20,21,-1,41,20,1
3,321,2,1,20,22,-2,38,7,1
3,282,1,0,22,20,2,33,10,1
3,260,2,0,22,20,2,33,10,1
3,208,1,1,20,22,-2,37,10,1
3,167,1,1,20,22,-2,49,10,1
3,135,1,1,20,22,-2,39,10,1
4,707,2,1,20,25,-5,12,6,1
4,652,1,0,28,26,2,5,5,1
4,486,1,1,26,28,-2,27,10,1
4,393,1,0,28,26,2,30,20,1
4,370,2,0,28,26,2,30,20,1
4,145,1,0,28,33,-5,45,10,1
4,23,2,0,28,36,-8,38,7,1
4,11,3,0,28,36,-8,28,17,1
1,502,2,1,0,0,0,42,6,1
1,390,2,0,0,7,-7,27,15,1
1,194,1,0,0,7,-7,43,10,1
1,69,1,0,0,14,-14,34,10,1
1,42,2,0,0,14,-14,24,20,1
2,598,1,1,14,0,14,8,10,1
2,300,1,0,0,14,-14,43,10,1
2,248,1,0,0,14,-14,27,10,1
2,232,2,0,0,14,-14,27,10,1
2,151,2,0,0,17,-17,48,8,1
2,113,2,1,17,0,17,29,9,1
2,86,1,0,0,17,-17,37,10,1
2,23,2,0,0,17,-17,20,1,1
3,702,1,1,20,0,20,40,10,1
3,596,2,1,20,0,20,16,10,1
3,551,1,1,20,3,17,23,10,1
3,475,1,0,3,20,-17,52,10,1
3,391,1,1,20,3,17,54,10,1
3,166,1,1,20,3,17,24,10,1
3,66,1,1,20,3,17,48,10,1
4,450,2,0,3,21,-18,49,11,1
4,212,2,0,3,21,-18,41,7,1
4,90,1,1,24,3,21,7,7,1
4,88,2,1,24,3,21,7,7,1
4,80,1,1,24,9,15,5,0,1
1,678,1,0,0,0,0,42,10,1
1,663,2,0,0,0,0,42,10,1
1,412,2,0,0,7,-7,34,5,1
1,357,1,0,0,7,-7,37,10,1
1,1,2,1,7,7,0,48,7,1
2,699,1,0,7,7,0,15,15,1
2,680,2,0,7,7,0,15,15,1
2,522,2,0,7,7,0,6,6,1
2,464,1,0,7,10,-3,47,10,1
2,96,1,0,10,10,0,28,10,1
2,90,2,0,10,10,0,28,10,1
3,872,2,1,10,10,0,23,4,1
3,782,1,1,10,10,0,22,10,1
3,415,1,0,17,13,4,35,10,1
3,389,2,0,17,13,4,35,10,1
3,280,2,1,13,17,-4,42,5,1
3,168,1,0,17,13,4,48,10,1
3,157,2,0,17,13,4,48,10,1
3,82,2,1,13,17,-4,28,6,1
3,24,1,0,17,13,4,45,10,1
4,752,1,1,13,17,-4,10,10,1
4,440,2,0,24,21,3,31,8,1
4,19,2,1,28,24,4,12,4,1
4,8,1,1,28,24,4,5,5,1
1,864,2,1,0,0,0,35,3,1
1,819,1,0,0,0,0,38,10,1
1,802,2,0,0,0,0,38,10,1
1,534,1,0,0,7,-7,50,10,1
1,304,2,1,7,0,7,18,7,1
1,163,2,1,7,0,7,42,8,1
1,1,1,0,0,7,-7,12,10,1
2,900,2,0,0,7,-7,12,10,1
2,514,1,1,17,0,17,31,10,1
2,372,1,1,17,0,17,28,10,1
2,351,2,1,17,0,17,28,10,1
2,101,2,0,1,17,-16,37,2,1
3,749,1,1,17,1,16,31,10,1
3,256,1,1,25,8,17,33,10,1
4,820,1,0,15,28,-13,51,10,1
4,761,1,1,28,15,13,48,10,1
4,506,0,1,34,15,19,5,0,1
4,200,1,1,41,15,26,47,10,1
4,3,2,1,48,15,33,30,1,1
1,817,1,1,0,0,0,30,10,1
1,775,1,1,0,0,0,13,10,1
1,429,1,1,7,3,4,17,10,1
1,249,1,0,10,7,3,39,10,1
1,180,1,1,7,10,-3,30,10,1
1,29,1,0,10,7,3,18,10,1
1,1,2,0,10,7,3,18,10,1
2,783,2,1,10,10,0,47,18,1
2,530,1,1,10,10,0,45,10,1
2,520,2,1,10,10,0,45,10,1
2,25,2,1,13,16,-3,23,4,1
3,392,2,1,20,19,1,20,5,1
3,276,2,1,20,22,-2,37,6,1
4,790,1,0,22,23,-1,25,10,1
4,604,2,0,22,30,-8,45,7,1
4,517,1,1,30,28,2,5,0,1
4,440,2,1,30,28,2,29,6,1
4,403,1,0,28,30,-2,38,10,1
4,230,2,1,30,28,2,55,5,1
4,159,2,0,28,30,-2,15,10,1
4,138,1,0,28,33,-5,35,10,1
4,62,2,1,33,28,5,29,5,1
4,44,1,1,33,28,5,18,10,1
4,39,2,1,33,28,5,18,10,1
4,29,1,1,33,34,-1,5,0,1
4,22,1,1,33,34,-1,22,10,1
4,18,2,1,33,34,-1,22,10,1
4,1,2,0,34,33,1,54,3,1
1,798,1,1,0,0,0,40,10,1
1,720,1,0,0,0,0,31,10,1
1,708,2,0,0,0,0,31,10,1
1,206,1,1,0,0,0,50,10,1
1,101,2,0,0,0,0,44,4,1
1,33,2,0,0,1,-1,41,4,1
2,870,2,1,1,0,1,33,6,1
2,763,2,0,0,1,-1,32,22,1
2,725,1,1,1,0,1,35,10,1
2,715,2,1,1,0,1,35,10,1
2,672,1,0,0,1,-1,34,10,1
2,544,2,1,1,0,1,53,8,1
2,294,2,0,7,1,6,43,10,1
2,160,1,0,7,1,6,47,10,1
2,50,1,0,7,1,6,20,10,1
3,725,2,0,7,10,-3,29,16,1
4,495,1,0,8,25,-17,40,10,1
4,456,1,1,25,8,17,38,10,1
4,374,2,1,25,8,17,26,13,1
4,336,1,1,25,11,14,35,10,1
4,314,2,1,25,11,14,35,10,1
4,269,1,0,11,25,-14,45,10,1
4,244,2,0,11,25,-14,45,10,1
1,754,1,0,0,3,-3,35,10,1
1,659,1,1,3,0,3,37,10,1
1,335,2,0,3,3,0,14,9,1
1,265,1,0,3,6,-3,30,15,1
1,172,2,1,6,3,3,41,6,1
2,662,2,0,10,6,4,27,7,1
2,182,2,0,17,6,11,51,7,1
2,122,1,1,6,17,-11,46,10,1
2,47,1,0,17,9,8,35,10,1
3,855,1,0,17,9,8,40,10,1
3,524,2,0,24,9,15,15,7,1
3,248,1,0,31,12,19,46,10,1
4,646,2,1,15,31,-16,5,5,1
4,379,2,1,15,34,-19,35,5,1
4,174,1,0,34,15,19,46,10,1
4,148,3,0,34,15,19,53,17,1
1,823,2,1,0,0,0,51,3,1
1,625,1,0,1,0,1,54,10,1
1,620,2,0,1,0,1,54,10,1
1,442,2,0,1,0,1,40,7,1
1,407,1,1,0,1,-1,20,10,1
1,196,1,1,0,1,-1,8,8,1
1,172,2,1,0,1,-1,8,8,1
1,77,2,1,0,4,-4,46,10,1
2,677,2,0,11,0,11,11,3,1
2,628,2,0,11,3,8,40,5,1
2,470,1,0,11,3,8,3,3,1
2,434,2,0,11,3,8,3,3,1
2,317,2,0,11,6,5,41,9,1
2,187,1,0,11,6,5,5,5,1
3,687,2,1,13,14,-1,20,6,1
3,388,1,0,14,13,1,45,10,1
3,275,1,1,13,14,-1,47,15,1
3,231,1,1,13,14,-1,11,10,1
3,1,2,1,13,16,-3,29,9,1
4,712,2,1,13,16,-3,23,7,1
4,674,1,1,13,19,-6,35,10,1
4,635,2,1,13,19,-6,25,20,1
4,492,2,1,13,19,-6,33,6,1
4,265,1,1,13,26,-13,51,10,1
4,216,1,0,26,13,13,34,10,1
4,111,1,1,13,26,-13,35,10,1
4,100,2,1,13,26,-13,25,20,1
4,27,1,1,13,26,-13,19,10,1
1,855,2,1,0,0,0,13,6,1
1,817,1,0,0,0,0,45,10,1
1,457,2,1,0,7,-7,31,7,1
1,362,1,1,0,7,-7,40,10,1
1,296,1,0,7,0,7,14,10,1
1,194,2,1,0,7,-7,45,9,1
1,130,2,0,7,0,7,27,13,1
2,637,1,1,0,7,-7,19,10,1
2,499,1,1,0,7,-7,2,2,1
2,486,2,1,0,7,-7,2,2,1
2,445,1,1,0,10,-10,35,10,1
2,431,2,1,0,10,-10,35,10,1
2,379,1,1,0,10,-10,45,10,1
2,135,1,1,0,13,-13,50,10,1
2,90,2,0,13,0,13,15,15,1
2,67,1,0,13,3,10,35,10,1
2,15,1,1,3,13,-10,52,10,1
3,826,1,0,13,3,10,36,10,1
3,546,2,1,3,13,-10,47,4,1
3,50,1,0,13,3,10,37,10,1
3,33,2,0,13,3,10,37,10,1
4,443,2,1,3,20,-17,31,14,1
4,150,2,1,3,26,-23,30,15,1
4,54,2,0,26,3,23,49,7,1
1,637,1,1,0,0,0,29,10,1
1,614,2,1,0,0,0,29,10,1
1,469,2,0,3,0,3,10,7,1
1,304,2,0,3,0,3,19,8,1
1,223,2,0,3,3,0,36,5,1
1,186,1,1,3,3,0,48,10,1
2,786,1,1,3,4,-1,35,10,1
2,772,2,1,3,4,-1,35,10,1
2,599,1,0,4,3,1,22,10,1
2,428,2,1,6,4,2,33,13,1
2,180,1,0,7,6,1,45,10,1
2,168,2,0,7,6,1,45,10,1
3,705,1,0,7,9,-2,49,10,1
3,697,2,0,7,9,-2,49,10,1
3,582,1,0,7,9,-2,36,10,1
3,558,2,0,7,9,-2,36,10,1
3,351,1,1,9,7,2,51,10,1
3,258,1,0,7,9,-2,28,10,1
4,763,1,1,12,14,-2,51,15,1
4,573,2,0,14,12,2,47,17,1
4,547,1,1,12,14,-2,15,10,1
4,500,1,1,12,14,-2,25,10,1
4,182,1,1,15,14,1,51,10,1
4,122,2,1,15,14,1,34,5,1
4,76,1,1,15,17,-2,46,10,1
4,20,1,0,17,18,-1,50,10,1
4,11,2,0,17,18,-1,50,10,1
1,751,2,1,0,1,-1,52,12,1
1,722,1,1,0,1,-1,16,10,1
1,636,2,1,0,1,-1,28,10,1
1,548,2,1,0,1,-1,51,12,1
1,511,1,1,0,1,-1,15,10,1
1,406,2,1,0,1,-1,49,9,1
1,330,2,1,0,1,-1,15,10,1
1,266,1,1,0,1,-1,48,10,1
1,170,2,1,0,1,-1,35,11,1
1,125,1,1,0,4,-4,35,10,1
1,28,2,1,0,4,-4,49,8,1
2,829,2,1,0,4,-4,52,2,1
2,144,1,1,7,4,3,47,10,1
2,127,2,1,7,4,3,47,10,1
2,71,2,0,4,7,-3,41,7,1
3,748,1,1,7,4,3,45,10,1
3,726,2,1,7,4,3,45,10,1
3,559,2,1,7,4,3,53,9,1
3,315,2,1,7,4,3,6,21,1
3,237,1,1,7,4,3,22,15,1
3,213,2,1,7,4,3,22,15,1
4,846,1,1,7,7,0,39,10,1
4,689,2,1,7,7,0,53,4,1
4,564,1,1,7,7,0,54,10,1
4,488,1,0,7,7,0,40,10,1
4,192,1,1,10,7,3,13,10,1
1,894,1,1,0,0,0,37,10,1
1,760,1,0,0,0,0,23,10,1
1,742,2,0,0,0,0,23,10,1
1,699,1,0,0,3,-3,31,10,1
1,683,2,0,0,3,-3,31,10,1
1,297,2,1,10,0,10,35,10,1
1,126,2,0,3,10,-7,38,17,1
2,900,2,1,10,3,7,42,5,1
2,783,2,0,3,10,-7,23,23,1
2,568,2,0,3,10,-7,45,4,1
2,397,1,0,3,10,-7,35,10,1
2,288,1,0,3,10,-7,8,8,1
2,266,2,0,3,10,-7,8,8,1
2,155,2,1,13,3,10,52,8,1
2,79,2,0,3,20,-17,33,6,1
3,876,2,0,3,20,-17,25,9,1
3,580,1,0,3,20,-17,33,10,1
3,227,2,1,27,3,24,50,4,1
3,90,2,1,27,3,24,40,5,1
3,65,3,1,27,3,24,40,5,1
4,650,1,0,3,41,-38,48,10,1
4,550,2,1,41,3,38,22,7,1
4,450,1,1,41,3,38,44,10,1
4,330,2,1,41,3,38,5,6,1
4,240,2,1,41,5,36,51,6,1
4,230,3,1,41,5,36,51,6,1
4,80,2,1,41,5,36,28,3,1
4,60,3,1,41,5,36,28,3,1
1,894,1,0,0,0,0,44,10,1
1,872,2,0,0,0,0,44,10,1
1,823,1,1,0,0,0,32,15,1
1,490,1,1,3,3,0,23,10,1
1,438,1,1,3,3,0,35,10,1
1,310,2,1,3,10,-7,29,4,1
2,828,2,0,10,10,0,24,6,1
2,686,1,0,10,10,0,46,10,1
2,225,1,1,10,10,0,34,10,1
2,95,2,0,13,10,3,33,7,1
2,63,1,0,13,13,0,55,10,1
2,52,2,0,13,13,0,55,10,1
2,38,1,1,13,13,0,6,10,1
3,853,2,1,13,20,-7,37,6,1
3,780,2,0,20,13,7,29,6,1
3,685,1,1,13,20,-7,51,10,1
3,462,2,0,20,20,0,26,8,1
3,152,1,1,20,20,0,17,10,1
3,96,2,1,20,20,0,22,15,1
4,609,1,1,20,23,-3,23,10,1
4,570,2,1,20,23,-3,23,10,1
4,477,1,0,26,20,6,54,10,1
4,306,1,0,26,20,6,21,20,1
4,231,1,1,20,26,-6,46,10,1
4,221,2,1,20,26,-6,46,10,1
4,153,2,0,26,20,6,28,7,1
4,44,1,1,22,26,-4,35,10,1
4,39,2,1,22,26,-4,30,15,1
4,31,3,1,22,26,-4,30,15,1
1,855,2,0,0,0,0,43,7,1
1,695,2,1,0,0,0,36,12,1
1,111,2,1,0,6,-6,22,16,1
1,65,1,0,6,0,6,39,10,1
2,900,2,0,6,0,6,50,11,1
2,690,1,1,0,6,-6,27,10,1
2,528,2,1,0,9,-9,49,10,1
2,448,2,0,9,0,9,25,18,1
2,240,2,0,9,0,9,3,3,1
2,38,1,0,9,3,6,42,10,1
2,18,1,0,9,3,6,26,10,1
3,780,1,0,9,6,3,40,10,1
3,602,2,1,6,9,-3,44,12,1
3,239,1,1,6,20,-14,46,10,1
3,80,2,1,6,20,-14,42,8,1
4,694,1,1,6,23,-17,18,10,1
4,601,2,1,6,23,-17,24,20,1
4,465,1,1,6,23,-17,28,10,1
4,48,3,1,6,23,-17,49,17,1
1,703,1,1,7,0,7,50,10,1
1,488,1,1,7,0,7,10,10,1
1,414,1,1,7,7,0,29,10,1
1,286,2,0,7,14,-7,44,5,1
1,210,2,1,14,7,7,13,6,1
2,883,1,1,14,7,7,24,10,1
2,676,2,1,14,14,0,36,14,1
2,607,1,1,14,14,0,48,10,1
2,582,2,1,14,14,0,48,10,1
2,443,2,1,14,14,0,3,3,1
2,142,2,0,17,14,3,4,4,1
2,90,1,0,17,17,0,52,5,1
3,806,2,0,17,20,-3,50,10,1
3,757,1,1,20,17,3,17,10,1
3,593,2,1,20,17,3,30,3,1
3,459,1,0,20,20,0,10,10,1
3,412,2,0,20,20,0,10,10,1
3,94,2,0,20,23,-3,17,7,1
3,59,1,1,23,20,3,55,10,1
4,748,1,1,23,20,3,18,10,1
4,673,2,1,23,20,3,17,17,1
4,166,3,0,23,30,-7,55,2,1
4,48,2,0,23,33,-10,40,5,1
4,39,3,0,23,33,-10,40,5,1
1,732,1,0,0,7,-7,35,10,1
1,322,2,1,14,0,14,10,9,1
1,255,2,1,14,3,11,37,8,1
1,183,1,1,14,3,11,16,10,1
1,1,1,0,6,14,-8,40,10,1
2,756,1,0,6,14,-8,15,10,1
2,624,1,1,14,6,8,30,10,1
2,543,1,0,6,14,-8,17,10,1
2,202,1,0,6,21,-15,28,10,1
2,68,1,0,6,28,-22,55,10,1
2,45,1,0,6,28,-22,41,10,1
3,861,2,1,28,6,22,39,7,1
3,195,1,1,31,6,25,23,10,1
3,155,2,1,31,6,25,33,20,1
3,61,1,1,31,9,22,51,10,1
4,770,2,0,9,31,-22,31,6,1
4,533,2,0,9,34,-25,36,6,1
4,484,1,0,9,37,-28,35,10,1
4,383,2,1,37,9,28,29,11,1
4,232,1,1,37,9,28,35,10,1
4,153,1,1,37,9,28,24,10,1
4,1,1,1,37,9,28,29,10,1
1,867,1,0,0,0,0,33,10,1
1,609,1,1,0,3,-3,35,10,1
1,598,2,1,0,3,-3,35,10,1
1,368,2,1,0,3,-3,13,15,1
1,266,2,1,0,3,-3,18,4,1
1,74,2,0,6,0,6,23,5,1
2,900,1,0,6,0,6,30,10,1
2,829,1,0,6,6,0,34,10,1
2,740,2,0,6,6,0,55,7,1
2,571,2,1,6,6,0,39,19,1
2,401,2,1,6,6,0,52,9,1
2,74,1,1,6,13,-7,29,10,1
3,890,1,1,6,13,-7,10,10,1
3,872,2,1,6,13,-7,10,10,1
3,413,2,0,20,13,7,27,14,1
3,341,1,1,13,20,-7,19,20,1
3,322,2,1,13,20,-7,19,20,1
3,290,1,1,13,20,-7,53,10,1
3,272,2,1,13,20,-7,53,10,1
3,221,1,1,13,20,-7,24,10,1
3,65,1,0,20,13,7,44,10,1
4,717,2,0,20,27,-7,39,4,1
4,78,1,0,20,29,-9,45,10,1
4,31,1,1,29,20,9,24,10,1
1,735,1,0,0,1,-1,35,10,1
1,457,2,0,0,1,-1,42,15,1
1,298,2,1,4,0,4,31,13,1
1,185,2,1,4,0,4,18,18,1
1,61,1,1,4,0,4,27,10,1
2,760,2,0,3,4,-1,45,12,1
2,691,1,0,3,5,-2,45,10,1
2,513,2,0,3,5,-2,16,14,1
2,472,1,1,5,3,2,30,10,1
2,383,2,1,5,3,2,46,10,1
2,284,2,0,3,5,-2,23,10,1
2,254,1,1,5,3,2,34,10,1
2,167,1,1,5,3,2,41,10,1
2,156,2,1,5,3,2,41,10,1
2,146,1,1,5,3,2,25,10,1
2,139,2,1,5,3,2,25,10,1
2,94,1,0,3,5,-2,50,10,1
2,67,1,1,5,3,2,43,10,1
3,640,2,0,17,5,12,48,12,1
3,518,2,0,17,5,12,22,10,1
3,456,2,1,5,17,-12,54,8,1
3,406,1,0,17,5,12,39,10,1
3,390,2,0,17,5,12,39,10,1
3,351,1,1,5,17,-12,25,10,1
4,795,2,1,5,17,-12,5,8,1
4,714,2,0,19,5,14,44,7,1
4,627,2,1,5,19,-14,13,6,1
4,406,1,1,5,21,-16,48,10,1
4,395,2,1,5,21,-16,48,10,1
4,182,2,1,5,21,-16,11,22,1
4,77,2,1,5,31,-26,41,5,1
1,861,2,1,0,0,0,31,3,1
1,666,1,1,0,0,0,26,10,1
1,563,2,1,0,0,0,50,6,1
1,430,2,0,0,0,0,42,6,1
1,43,2,1,7,7,0,43,10,1
2,302,2,0,10,14,-4,47,5,1
2,223,1,0,10,14,-4,25,10,1
2,109,2,0,10,21,-11,48,5,1
3,822,1,0,10,21,-11,50,10,1
3,515,1,1,21,10,11,14,10,1
3,253,1,1,21,10,11,14,10,1
3,236,2,1,21,10,11,14,10,1
4,647,1,1,21,13,8,4,4,1
4,599,0,0,19,21,-2,5,0,1
4,232,1,1,24,19,5,29,10,1
4,92,0,0,25,24,1,5,0,1
4,58,1,0,25,24,1,53,10,1
4,4,1,1,24,25,-1,12,20,1
1,895,1,1,0,0,0,27,10,1
1,598,1,1,0,7,-7,15,15,1
1,551,1,1,0,7,-7,15,10,1
1,97,1,1,0,24,-24,28,10,1
1,53,1,1,0,24,-24,38,10,1
1,1,1,0,24,0,24,24,10,1
2,900,2,0,24,0,24,24,10,1
2,540,2,0,24,0,24,42,12,1
2,355,2,1,0,32,-32,53,3,1
2,183,3,0,32,7,25,54,2,1
2,125,2,0,32,7,25,39,6,1
2,86,1,0,32,7,25,48,10,1
2,80,2,0,32,7,25,48,10,1
2,54,1,1,7,32,-25,19,10,1
3,740,2,0,32,7,25,55,10,1
3,453,2,1,7,32,-25,17,11,1
3,20,1,0,35,7,28,40,10,1
4,900,2,0,35,7,28,40,10,1
4,755,1,1,7,35,-28,28,20,1
4,575,3,0,35,7,28,40,16,1
4,112,2,0,38,14,24,24,11,1
4,73,1,1,14,38,-24,30,10,1
1,144,1,0,3,0,3,26,10,1
1,72,1,0,3,3,0,35,10,1
2,900,1,1,3,3,0,47,10,1
2,819,2,1,3,3,0,55,13,1
2,744,2,0,3,3,0,50,9,1
2,661,1,1,3,3,0,40,10,1
2,522,1,0,3,3,0,40,10,1
2,210,2,1,10,3,7,41,8,1
2,133,2,1,10,3,7,5,13,1
2,74,2,1,10,3,7,45,20,1
2,50,2,1,10,3,7,54,4,1
2,30,2,0,3,10,-7,29,4,1
3,608,1,0,3,10,-7,51,10,1
3,588,2,0,3,10,-7,51,10,1
3,452,1,0,3,10,-7,23,20,1
3,367,2,1,10,3,7,44,5,1
4,400,1,1,11,16,-5,40,5,1
4,325,0,1,17,16,1,5,0,1
4,192,2,1,17,16,1,54,4,1
4,136,0,0,22,17,5,5,0,1
4,130,1,0,22,17,5,51,10,1
1,860,2,1,0,0,0,30,9,1
1,593,2,0,7,0,7,53,5,1
1,410,2,1,1,7,-6,22,12,1
1,221,2,0,10,1,9,53,6,1
1,173,1,0,10,2,8,35,10,1
1,78,2,0,10,2,8,23,10,1
2,874,1,1,5,10,-5,37,10,1
2,593,1,1,8,17,-9,15,10,1
2,577,2,1,8,17,-9,15,10,1
2,432,2,1,8,20,-12,40,5,1
2,127,2,1,8,27,-19,32,6,1
2,2,1,0,30,8,22,50,10,1
3,455,1,0,30,8,22,36,10,1
3,373,1,0,30,8,22,20,10,1
3,355,2,0,30,8,22,20,10,1
3,260,2,0,30,11,19,50,10,1
4,749,1,0,30,11,19,22,10,1
4,732,2,0,30,11,19,22,10,1
4,592,1,0,30,14,16,50,10,1
4,585,2,0,30,14,16,50,10,1
4,391,1,0,30,14,16,49,10,1
4,294,2,1,14,30,-16,40,4,1
4,269,1,0,30,14,16,25,10,1
4,250,2,0,30,14,16,25,10,1
4,134,1,1,17,30,-13,46,10,1
4,102,2,1,17,30,-13,35,5,1
4,60,1,0,33,17,16,50,10,1
4,30,1,0,33,23,10,5,0,1
1,655,1,0,0,3,-3,30,15,1
1,131,2,1,10,3,7,42,10,1
1,92,1,0,3,10,-7,25,10,1
2,685,2,1,17,6,11,45,4,1
2,563,2,1,17,6,11,50,5,1
2,492,1,1,17,6,11,45,10,1
2,470,2,1,17,6,11,45,10,1
2,325,2,1,17,13,4,36,12,1
2,187,2,1,17,13,4,24,4,1
3,860,2,0,19,17,2,40,4,1
3,646,2,0,19,17,2,39,4,1
3,53,2,1,27,26,1,35,8,1
4,652,1,0,26,27,-1,50,10,1
4,585,1,0,26,27,-1,25,10,1
4,560,2,0,26,27,-1,25,10,1
4,460,1,1,30,26,4,32,10,1
4,441,2,1,30,26,4,32,10,1
4,396,1,1,30,29,1,35,10,1
4,224,1,0,29,30,-1,4,4,1
4,147,2,0,29,33,-4,42,3,1
4,4,1,0,29,36,-7,35,10,1
1,858,2,0,0,0,0,36,8,1
1,775,2,1,0,0,0,40,3,1
1,669,2,0,0,0,0,35,7,1
1,523,1,0,0,0,0,16,10,1
1,308,1,1,7,0,7,27,25,1
1,281,2,1,7,0,7,27,25,1
1,1,1,0,0,7,-7,34,10,1
2,852,1,0,0,7,-7,44,10,1
2,135,2,0,0,21,-21,31,6,1
2,124,1,1,21,0,21,40,10,1
2,59,1,0,7,21,-14,17,10,1
3,778,1,0,7,28,-21,49,10,1
3,570,2,0,7,28,-21,5,5,1
4,493,3,0,17,35,-18,41,4,1
4,297,1,0,17,38,-21,47,10,1
4,147,3,1,38,17,21,16,16,1
1,748,2,1,0,0,0,43,4,1
1,460,1,1,0,7,-7,40,10,1
1,102,2,0,7,0,7,36,4,1
3,798,1,1,21,14,7,46,10,1
3,689,2,1,21,14,7,54,4,1
3,421,2,1,21,21,0,39,6,1
3,344,2,0,21,21,0,40,8,1
3,298,1,1,21,21,0,40,10,1
3,70,1,0,21,21,0,39,10,1
4,554,2,0,21,28,-7,11,7,1
4,499,1,0,21,31,-10,35,10,1
4,130,2,1,38,21,17,43,2,1
4,92,3,1,38,21,17,34,9,1
4,18,1,0,21,38,-17,47,10,1
4,3,1,1,38,21,17,15,10,1
1,830,1,1,0,0,0,53,10,1
1,752,1,0,0,0,0,38,10,1
1,712,2,0,0,0,0,33,5,1
1,627,1,1,1,0,1,51,10,1
1,605,2,1,1,0,1,51,10,1
1,454,2,0,0,1,-1,34,7,1
1,368,2,1,1,0,1,55,6,1
1,174,1,0,0,1,-1,10,10,1
1,150,2,0,0,1,-1,10,10,1
1,1,1,1,4,0,4,38,10,1
2,610,1,1,7,1,6,28,10,1
2,152,2,0,4,8,-4,11,7,1
2,112,2,1,8,4,4,51,11,1
2,32,2,1,8,4,4,43,5,1
3,296,1,1,8,4,4,26,10,1
3,182,2,1,8,7,1,41,4,1
4,14,1,1,8,10,-2,45,10,1
4,4,2,1,8,10,-2,45,10,1
1,710,2,1,0,0,0,42,23,1
1,466,1,1,0,0,0,14,10,1
1,137,2,1,7,7,0,12,4,1
2,900,2,1,7,10,-3,47,8,1
2,732,2,1,7,10,-3,42,3,1
2,612,2,0,10,7,3,50,12,1
2,305,2,0,10,7,3,40,4,1
2,154,1,1,7,17,-10,54,10,1
2,70,1,0,17,7,10,51,10,1
2,27,1,0,17,7,10,53,10,1
2,17,2,0,17,7,10,53,10,1
3,458,1,1,7,17,-10,24,10,1
3,197,1,0,20,10,10,35,10,1
3,68,1,0,20,10,10,45,10,1
4,728,2,1,17,20,-3,13,8,1
4,440,1,0,23,17,6,29,10,1
4,133,1,1,20,23,-3,23,10,1
1,852,2,1,0,0,0,35,7,1
1,530,2,1,0,0,0,21,7,1
1,322,1,1,0,0,0,22,10,1
1,140,2,0,0,0,0,50,13,1
2,644,1,0,1,1,0,23,10,1
2,617,2,0,1,1,0,23,10,1
2,492,1,0,1,4,-3,51,10,1
2,387,2,1,4,1,3,38,6,1
2,169,1,0,4,4,0,28,20,1
2,1,2,0,4,4,0,50,5,1
3,854,2,0,4,4,0,30,25,1
3,759,2,0,4,4,0,42,6,1
3,252,2,0,4,5,-1,47,4,1
3,199,1,1,5,4,1,35,10,1
3,185,2,1,5,4,1,35,10,1
3,106,2,0,4,5,-1,24,8,1
4,800,2,1,12,4,8,45,6,1
4,581,1,1,12,4,8,55,10,1
4,503,1,0,4,12,-8,17,10,1
4,316,1,0,4,12,-8,23,10,1
4,165,2,1,12,11,1,45,6,1
4,120,2,0,11,13,-2,46,4,1
1,892,1,0,0,0,0,43,10,1
1,643,1,1,0,0,0,41,10,1
1,612,2,1,0,0,0,41,10,1
1,455,2,1,0,7,-7,19,17,1
1,304,1,1,0,7,-7,23,10,1
1,275,2,1,0,7,-7,23,10,1
1,232,1,1,0,10,-10,35,10,1
1,94,1,1,0,10,-10,19,10,1
2,883,1,0,10,0,10,46,10,1
2,717,2,0,10,0,10,25,11,1
2,648,2,0,10,3,7,36,9,1
2,502,1,0,10,3,7,26,10,1
2,480,2,0,10,3,7,26,10,1
2,236,2,1,6,10,-4,26,12,1
2,150,1,1,6,10,-4,21,10,1
2,135,2,1,6,10,-4,21,10,1
3,150,1,1,10,13,-3,43,10,1
3,1,1,0,13,10,3,18,10,1
4,796,1,1,17,13,4,25,10,1
4,773,2,1,17,13,4,25,10,1
4,628,2,1,17,16,1,20,8,1
4,565,1,1,17,19,-2,25,10,1
4,321,2,1,17,26,-9,30,6,1
4,161,2,0,26,17,9,51,6,1
1,862,2,1,0,0,0,37,4,1
1,704,2,1,0,0,0,28,7,1
1,626,2,0,0,0,0,37,16,1
1,507,2,0,0,0,0,43,8,1
1,110,2,1,1,0,1,49,9,1
2,602,2,1,1,0,1,12,5,1
2,395,2,1,1,0,1,30,21,1
2,281,3,1,1,3,-2,40,6,1
2,136,2,1,1,3,-2,39,7,1
2,14,1,1,1,3,-2,12,10,1
3,893,1,0,6,1,5,22,10,1
3,874,2,0,6,1,5,22,10,1
3,731,1,0,6,8,-2,13,10,1
4,849,1,0,13,8,5,15,10,1
4,780,1,0,13,11,2,35,10,1
4,763,2,0,13,11,2,35,10,1
4,249,1,1,14,16,-2,36,10,1
4,122,1,0,16,21,-5,25,10,1
4,53,1,0,16,24,-8,35,10,1
1,895,1,0,0,0,0,24,10,1
1,798,2,0,0,0,0,31,16,1
1,630,2,1,0,0,0,52,7,1
1,1,2,0,7,7,0,16,19,1
2,884,1,0,7,7,0,49,10,1
2,871,2,0,7,7,0,49,10,1
2,833,1,0,7,7,0,18,10,1
2,683,1,0,7,14,-7,28,10,1
2,606,1,1,14,7,7,44,10,1
2,518,1,0,7,14,-7,37,10,1
2,508,2,0,7,14,-7,37,10,1
2,232,2,1,24,7,17,30,4,1
2,188,1,0,7,24,-17,21,10,1
2,92,1,0,7,24,-17,20,10,1
2,35,1,1,31,7,24,46,10,1
3,653,2,1,31,13,18,42,3,1
3,610,1,0,13,31,-18,28,10,1
3,519,1,1,31,13,18,45,10,1
3,488,1,1,31,13,18,35,10,1
3,474,2,1,31,13,18,35,10,1
4,717,1,1,31,24,7,47,10,1
4,600,2,0,24,31,-7,18,8,1
4,551,1,0,24,34,-10,35,10,1
4,476,1,1,34,24,10,22,10,1
4,456,2,1,34,24,10,22,10,1
4,413,1,0,24,34,-10,39,10,1
4,125,2,1,34,24,10,38,4,1
1,593,1,1,7,0,7,35,10,1
1,527,2,1,7,0,7,25,20,1
1,162,1,1,7,7,0,7,10,1
1,79,1,1,7,7,0,50,10,1
2,872,1,1,7,7,0,24,10,1
2,841,2,1,7,7,0,24,10,1
2,782,2,1,7,8,-1,35,10,1
2,512,1,1,7,8,-1,44,10,1
2,253,1,0,8,7,1,9,10,1
2,179,1,0,8,7,1,32,10,1
2,162,2,0,8,7,1,32,10,1
2,124,2,0,8,7,1,54,7,1
2,64,1,0,8,7,1,47,10,1
2,54,2,0,8,7,1,47,10,1
3,780,2,0,8,7,1,47,5,1
3,360,1,1,7,8,-1,38,15,1
3,268,2,1,7,8,-1,25,9,1
3,100,2,0,11,7,4,35,7,1
4,884,2,0,11,7,4,53,8,1
4,722,1,1,7,11,-4,34,10,1
4,683,2,1,7,11,-4,34,10,1
4,355,1,1,7,18,-11,35,10,1
4,223,2,1,7,25,-18,46,6,1
4,195,3,1,7,25,-18,46,6,1
4,123,1,1,7,32,-25,35,10,1
4,92,2,1,7,32,-25,51,5,1
4,61,2,0,32,7,25,45,26,1
1,437,2,1,10,0,10,45,6,1
1,14,2,1,10,0,10,34,4,1
2,835,2,1,10,3,7,35,6,1
2,701,2,1,10,3,7,47,6,1
2,312,1,1,13,3,10,38,10,1
2,174,2,1,13,3,10,5,5,1
2,138,2,1,13,6,7,47,8,1
2,11,1,1,13,6,7,38,20,1
3,889,1,0,9,13,-4,24,10,1
3,865,2,0,9,13,-4,24,10,1
3,825,1,0,9,13,-4,17,10,1
3,523,2,1,16,12,4,36,9,1
4,892,1,1,16,19,-3,39,10,1
4,832,1,1,16,19,-3,51,10,1
4,589,1,0,19,16,3,47,10,1
4,568,2,0,19,16,3,47,10,1
4,158,2,1,16,19,-3,45,4,1
4,120,1,1,16,20,-4,35,10,1
4,116,2,1,16,20,-4,35,10,1
4,16,2,1,16,20,-4,48,5,1
4,3,1,0,20,16,4,53,10,1
1,754,1,1,0,0,0,15,10,1
1,580,2,1,0,3,-3,53,7,1
1,540,1,0,3,0,3,25,10,1
2,824,2,0,3,7,-4,50,6,1
2,784,1,0,3,8,-5,35,10,1
2,700,1,1,8,3,5,32,10,1
2,299,1,0,3,8,-5,31,10,1
2,9,1,1,8,3,5,54,10,1
2,3,2,1,8,3,5,54,10,1
3,815,1,1,8,3,5,50,10,1
3,690,2,0,3,9,-6,38,7,1
3,535,2,1,9,3,6,46,6,1
3,263,1,0,3,9,-6,14,10,1
3,230,2,0,3,9,-6,14,10,1
3,36,1,0,3,13,-10,35,10,1
3,24,2,0,3,13,-10,35,10,1
4,859,1,0,3,13,-10,54,10,1
4,839,2,0,3,13,-10,54,10,1
4,771,1,0,3,13,-10,32,10,1
4,751,2,0,3,13,-10,32,10,1
4,220,1,1,20,10,10,51,10,1
4,183,2,0,10,20,-10,49,20,1
1,608,2,1,0,0,0,5,12,1
1,386,2,1,0,7,-7,44,7,1
1,340,1,0,7,0,7,30,10,1
1,315,2,0,7,0,7,30,10,1
2,874,2,0,7,0,7,41,6,1
2,683,1,1,2,7,-5,34,10,1
2,598,2,1,2,7,-5,50,5,1
2,524,2,0,7,2,5,5,8,1
2,259,2,0,7,11,-4,32,3,1
2,168,2,0,7,11,-4,43,0,1
2,79,2,0,7,11,-4,10,10,1
2,62,1,0,7,14,-7,35,10,1
3,250,1,1,21,14,7,18,10,1
3,229,2,1,21,14,7,18,10,1
4,747,2,1,21,21,0,26,14,1
4,627,1,0,24,21,3,51,10,1
4,572,2,0,24,21,3,46,5,1
4,178,1,1,28,30,-2,35,10,1
4,1,2,1,35,30,5,51,1,1
1,870,2,0,0,0,0,21,5,1
1,781,1,0,0,3,-3,40,10,1
1,745,2,0,0,3,-3,40,10,1
1,451,1,0,1,10,-9,42,10,1
1,432,2,0,1,10,-9,42,10,1
1,183,2,1,10,1,9,47,16,1
1,95,2,0,3,10,-7,48,7,1
2,465,2,0,3,10,-7,20,5,1
2,245,1,0,3,10,-7,16,10,1
2,205,2,0,3,10,-7,16,10,1
2,163,1,0,3,13,-10,35,10,1
2,150,2,0,3,13,-10,35,10,1
2,134,1,1,13,3,10,46,10,1
3,868,2,0,10,13,-3,31,12,1
3,789,2,1,13,10,3,3,11,1
3,738,1,0,12,13,-1,51,10,1
3,676,1,0,12,13,-1,40,10,1
3,413,2,1,13,12,1,54,8,1
3,343,2,0,12,13,-1,36,9,1
3,24,2,1,13,12,1,33,7,1
4,697,1,0,12,13,-1,27,10,1
4,499,2,1,13,12,1,49,7,1
4,333,1,1,13,12,1,38,10,1
1,869,1,1,0,0,0,55,10,1
1,403,1,1,8,7,1,27,10,1
1,63,2,0,7,8,-1,52,19,1
2,778,2,0,7,8,-1,50,8,1
2,498,1,0,7,15,-8,23,10,1
2,481,2,0,7,15,-8,23,10,1
2,418,2,1,15,7,8,30,8,1
2,221,1,1,15,7,8,7,7,1
2,206,2,1,15,7,8,7,7,1
2,179,1,1,15,10,5,35,10,1
2,156,2,1,15,10,5,35,10,1
3,671,2,0,10,15,-5,40,9,1
3,500,2,1,18,10,8,36,8,1
3,360,2,0,10,18,-8,45,15,1
3,131,2,1,18,10,8,50,12,1
4,754,2,0,10,18,-8,48,10,1
4,523,1,0,10,25,-15,33,10,1
4,454,1,1,25,10,15,43,10,1
4,310,2,1,25,10,15,37,17,1
4,190,2,0,13,25,-12,26,5,1
4,76,1,1,28,13,15,28,10,1
4,66,2,1,28,13,15,28,10,1
4,62,3,1,28,13,15,28,10,1
1,894,1,1,0,0,0,50,10,1
1,838,1,0,0,0,0,34,10,1
1,554,2,1,3,0,3,32,9,1
1,421,1,0,0,3,-3,51,10,1
1,418,2,0,0,3,-3,51,10,1
1,194,2,0,0,3,-3,39,4,1
2,858,1,0,0,3,-3,9,19,1
2,601,2,1,3,0,3,42,13,1
2,289,1,0,3,3,0,8,8,1
2,130,2,0,3,5,-2,52,15,1
3,666,2,0,6,5,1,51,4,1
3,325,2,1,5,6,-1,49,8,1
3,267,2,1,5,7,-2,37,8,1
3,216,1,0,7,5,2,47,10,1
4,885,1,0,7,5,2,30,10,1
4,783,2,1,5,7,-2,42,6,1
4,288,3,0,7,5,2,26,8,1
4,30,1,1,5,7,-2,20,10,1
4,14,2,1,5,7,-2,25,5,1
4,12,3,1,5,7,-2,25,5,1
1,860,2,1,0,0,0,41,9,1
1,748,2,0,0,0,0,52,4,1
1,708,1,1,0,0,0,14,10,1
1,446,1,1,0,0,0,34,10,1
1,422,2,1,0,0,0,34,10,1
1,268,1,1,0,3,-3,51,10,1
2,900,2,0,3,0,3,45,5,1
2,814,1,1,0,3,-3,33,10,1
2,794,2,1,0,3,-3,33,10,1
2,652,1,1,0,3,-3,38,10,1
2,540,1,0,3,0,3,26,10,1
2,283,2,1,7,10,-3,38,8,1
2,87,1,0,17,7,10,27,10,1
2,30,1,0,17,7,10,19,10,1
3,762,2,0,17,10,7,55,9,1
3,616,1,0,24,10,14,49,10,1
3,603,2,0,24,10,14,49,10,1
3,170,1,0,31,10,21,53,10,1
3,156,2,0,31,10,21,53,10,1
4,696,1,1,13,31,-18,21,10,1
4,688,2,1,13,31,-18,21,10,1
4,611,2,1,13,31,-18,44,6,1
4,530,2,1,13,31,-18,4,8,1
4,504,1,1,13,31,-18,33,10,1
4,420,1,1,13,34,-21,35,10,1
4,354,1,0,34,13,21,36,10,1
4,330,1,0,34,13,21,21,10,1
4,303,2,0,34,13,21,21,10,1
4,227,2,0,34,20,14,15,16,1
1,706,2,1,7,0,7,49,4,1
1,653,2,1,7,0,7,21,7,1
2,893,1,1,7,17,-10,25,10,1
2,704,2,1,7,17,-10,55,13,1
2,545,2,0,17,7,10,50,7,1
2,251,1,1,7,17,-10,54,15,1
2,132,2,1,7,17,-10,5,5,1
2,108,1,1,7,20,-13,50,10,1
2,102,2,1,7,20,-13,50,10,1
3,811,2,0,21,7,14,28,4,1
3,555,1,1,10,21,-11,16,10,1
3,534,2,1,10,21,-11,16,10,1
3,447,2,1,10,24,-14,41,5,1
3,350,1,0,24,10,14,4,4,1
4,795,1,0,24,31,-7,35,10,1
4,721,2,1,31,24,7,23,4,1
4,674,1,0,24,31,-7,44,10,1
4,152,1,0,24,38,-14,48,10,1
4,97,1,1,38,24,14,38,10,1
4,85,2,1,38,24,14,38,10,1
4,38,1,1,38,24,14,19,10,1
1,805,2,0,0,0,0,50,13,1
1,25,1,0,1,7,-6,38,10,1
1,1,2,0,1,7,-6,38,10,1
2,618,2,0,8,8,0,37,8,1
2,250,1,1,8,13,-5,25,20,1
3,233,1,0,30,15,15,52,10,1
4,866,1,1,16,30,-14,34,10,1
4,639,2,0,30,16,14,47,12,1
4,555,1,1,17,30,-13,53,10,1
4,532,2,1,17,30,-13,53,10,1
4,457,1,1,17,30,-13,37,10,1
4,433,2,1,17,30,-13,37,10,1
4,342,2,0,30,17,13,41,6,1
1,891,1,0,0,0,0,38,10,1
1,870,2,0,0,0,0,38,10,1
1,798,2,1,0,0,0,29,7,1
1,745,1,0,0,0,0,36,15,1
1,732,2,0,0,0,0,36,15,1
1,669,1,1,0,0,0,39,10,1
1,552,2,1,0,0,0,53,7,1
1,469,2,0,0,0,0,12,5,1
2,428,1,0,3,5,-2,24,10,1
2,240,1,0,3,6,-3,44,10,1
2,29,2,1,6,3,3,39,15,1
3,759,2,0,6,6,0,9,8,1
3,570,1,1,9,6,3,30,15,1
3,567,2,1,9,6,3,30,15,1
3,350,2,1,9,6,3,34,9,1
3,55,2,0,9,9,0,24,11,1
4,800,1,0,16,12,4,7,7,1
4,728,1,0,16,19,-3,36,10,1
4,708,2,0,16,19,-3,36,10,1
4,397,1,0,16,26,-10,36,10,1
4,61,1,1,33,16,17,45,10,1
4,50,2,1,33,16,17,45,10,1
1,609,2,1,3,7,-4,30,5,1
1,220,1,0,15,3,12,44,10,1
1,68,2,0,15,3,12,25,3,1
1,14,1,1,3,15,-12,36,10,1
2,900,2,1,3,15,-12,36,10,1
2,592,1,1,3,15,-12,2,2,1
2,429,2,1,3,22,-19,38,12,1
2,404,3,1,3,22,-19,38,12,1
2,318,1,1,3,22,-19,27,10,1
2,64,1,0,29,3,26,25,10,1
3,700,1,1,10,29,-19,36,10,1
3,615,1,1,10,32,-22,20,10,1
3,105,2,1,25,32,-7,34,10,1
4,680,2,1,25,33,-8,37,8,1
1,770,2,1,0,0,0,44,5,1
1,193,1,1,0,0,0,10,10,1
1,169,2,1,0,0,0,10,10,1
1,52,2,0,3,0,3,33,6,1
1,3,1,0,3,3,0,29,10,1
2,207,2,0,3,6,-3,20,10,1
3,894,1,1,15,3,12,50,10,1
3,569,2,1,15,3,12,35,10,1
3,362,2,0,6,15,-9,38,10,1
3,155,2,0,6,16,-10,55,20,1
3,113,1,1,16,6,10,28,10,1
3,90,2,1,16,6,10,28,10,1
3,43,1,0,6,16,-10,39,10,1
3,21,2,0,6,16,-10,39,10,1
4,848,2,1,16,6,10,13,4,1
4,768,2,1,16,6,10,41,6,1
4,372,2,1,19,9,10,48,5,1
4,293,2,0,9,19,-10,13,13,1
4,164,2,0,9,26,-17,27,19,1
1,650,2,0,0,3,-3,43,2,1
1,510,2,0,0,3,-3,44,4,1
2,509,2,1,13,0,13,17,8,1
2,316,1,1,13,0,13,25,10,1
2,220,2,1,13,0,13,3,3,1
2,167,2,1,13,3,10,41,4,1
2,132,1,0,3,13,-10,36,10,1
3,850,2,0,3,13,-10,20,12,1
3,393,1,0,3,20,-17,46,10,1
3,28,2,0,3,20,-17,19,16,1
4,900,1,0,3,20,-17,44,10,1
4,890,2,0,3,20,-17,44,10,1
4,808,2,0,3,20,-17,46,9,1
4,705,1,1,20,3,17,50,10,1
4,550,2,0,3,20,-17,31,5,1
4,35,1,0,3,28,-25,50,10,1
4,15,2,0,3,28,-25,50,10,1
1,643,2,0,0,0,0,52,5,1
1,564,2,1,0,1,-1,34,11,1
1,529,1,0,1,0,1,44,10,1
1,247,1,1,0,4,-4,49,10,1
1,226,2,1,0,4,-4,49,10,1
1,118,2,1,0,4,-4,36,6,1
1,58,1,0,4,0,4,44,10,1
2,701,2,0,11,0,11,34,14,1
2,437,1,0,18,1,17,20,10,1
2,118,1,0,18,8,10,28,10,1
2,101,2,0,18,8,10,28,10,1
2,50,1,1,9,18,-9,42,10,1
3,747,2,1,9,21,-12,31,9,1
3,717,1,0,21,9,12,29,10,1
3,546,1,1,9,28,-19,18,10,1
3,465,1,1,9,28,-19,54,10,1
3,83,2,0,28,9,19,48,7,1
4,753,2,1,9,28,-19,13,12,1
4,574,1,0,30,9,21,35,10,1
4,549,1,0,30,9,21,18,10,1
4,156,1,0,33,16,17,13,10,1
4,153,2,0,33,16,17,13,10,1
4,33,1,0,40,23,17,52,10,1
4,17,2,0,40,23,17,52,10,1
4,11,3,0,40,23,17,52,10,1
1,797,2,1,0,0,0,25,12,1
1,400,2,1,0,0,0,53,4,1
1,357,1,0,0,0,0,22,10,1
2,900,1,0,0,0,0,5,5,1
2,887,2,0,0,0,0,5,5,1
2,778,1,1,3,0,3,49,10,1
2,761,2,1,3,0,3,49,10,1
2,652,1,0,1,3,-2,40,10,1
2,381,1,0,1,3,-2,41,10,1
2,247,1,1,3,1,2,7,7,1
2,211,1,1,3,1,2,4,4,1
2,153,1,1,3,8,-5,25,10,1
2,71,1,0,15,3,12,28,10,1
2,26,2,0,15,3,12,51,14,1
3,726,2,0,15,3,12,12,3,1
3,327,1,0,15,6,9,45,10,1
3,245,1,0,15,7,8,35,10,1
3,105,1,0,15,7,8,41,10,1
4,900,1,0,15,10,5,48,10,1
4,523,2,0,15,17,-2,51,6,1
4,155,1,0,16,24,-8,42,10,1
4,149,2,0,16,24,-8,42,10,1
4,141,3,0,16,24,-8,42,10,1
4,76,1,0,16,25,-9,30,10,1
4,65,1,0,16,25,-9,41,10,1
4,42,1,1,25,16,9,53,10,1
1,828,2,1,0,0,0,50,4,1
1,568,2,1,0,0,0,19,10,1
1,524,1,0,0,0,0,53,10,1
1,363,2,1,0,0,0,34,6,1
1,257,1,1,0,0,0,54,10,1
1,239,2,1,0,0,0,54,10,1
1,8,1,0,0,0,0,25,10,1
2,576,1,0,0,8,-8,35,10,1
2,543,1,0,0,8,-8,45,10,1
2,524,2,0,0,8,-8,45,10,1
2,252,1,0,1,15,-14,43,10,1
3,892,1,1,15,8,7,27,10,1
3,873,2,1,15,8,7,27,10,1
3,829,1,1,15,8,7,54,10,1
3,464,1,0,15,15,0,33,10,1
3,391,1,1,15,15,0,45,10,1
3,1,2,0,15,18,-3,27,4,1
4,499,2,0,15,25,-10,27,8,1
4,445,2,0,15,28,-13,39,6,1
4,178,2,0,15,28,-13,20,5,1
4,95,1,0,15,31,-16,8,10,1
4,73,1,0,15,31,-16,35,10,1
1,224,2,0,7,0,7,33,8,1
1,152,1,0,7,3,4,36,5,1
1,138,2,0,7,3,4,36,5,1
1,23,1,0,7,3,4,50,10,1
2,629,1,1,3,8,-5,29,10,1
2,338,1,1,3,15,-12,52,10,1
2,327,2,1,3,15,-12,52,10,1
2,245,2,0,15,3,12,30,7,1
2,155,1,0,15,10,5,45,10,1
2,40,1,1,10,15,-5,21,10,1
2,9,1,1,10,22,-12,41,10,1
3,885,1,1,10,22,-12,36,10,1
3,402,2,1,17,29,-12,44,5,1
3,370,1,0,29,17,12,1,10,1
3,318,1,0,29,17,12,25,10,1
3,136,2,0,29,17,12,36,6,1
4,760,1,0,29,24,5,47,10,1
4,725,2,0,29,24,5,47,10,1
4,437,1,1,24,29,-5,23,10,1
4,423,2,1,24,29,-5,23,10,1
4,372,1,1,24,29,-5,19,10,1
4,274,2,1,24,29,-5,25,20,1
4,86,1,0,32,24,8,47,10,1
4,43,1,0,32,32,0,38,10,1
5,0,1,0,32,32,0,35,10,1
5,0,2,0,32,32,0,15,6,1
1,883,2,1,0,0,0,50,5,1
1,773,1,0,0,0,0,37,10,1
1,748,2,0,0,0,0,37,10,1
1,40,2,0,0,0,0,7,1,1
2,559,1,0,7,0,7,54,10,1
2,493,2,1,0,7,-7,46,20,1
2,373,1,1,0,7,-7,7,7,1
2,335,2,1,0,7,-7,7,7,1
2,33,1,0,10,7,3,27,10,1
3,888,1,0,10,7,3,45,10,1
3,835,1,1,7,10,-3,46,10,1
3,804,2,1,7,10,-3,46,10,1
3,577,2,0,11,7,4,55,6,1
3,493,2,1,7,12,-5,40,5,1
3,430,1,0,12,7,5,20,10,1
3,419,2,0,12,7,5,20,10,1
3,268,2,0,12,7,5,46,6,1
3,17,2,1,7,12,-5,50,15,1
4,423,2,1,7,12,-5,9,5,1
4,58,1,1,7,15,-8,43,10,1
1,893,1,1,0,0,0,35,10,1
1,692,1,0,0,7,-7,39,10,1
1,519,1,1,7,0,7,34,10,1
1,230,1,0,0,7,-7,20,10,1
1,200,2,0,0,7,-7,20,10,1
1,1,1,0,0,10,-10,53,10,1
2,825,2,0,0,10,-10,9,7,1
2,525,1,1,13,0,13,26,10,1
2,160,1,0,0,14,-14,33,10,1
3,709,1,0,0,14,-14,45,10,1
3,600,1,0,0,17,-17,50,10,1
3,580,2,0,0,17,-17,50,10,1
3,537,1,1,17,0,17,10,10,1
3,362,2,1,17,0,17,48,6,1
3,3,2,1,17,0,17,20,5,1
4,644,2,1,17,0,17,43,5,1
4,457,1,1,17,0,17,45,10,1
4,435,2,1,17,0,17,45,10,1
4,351,2,1,17,0,17,17,4,1
4,10,1,1,24,0,24,54,10,1
4,1,2,1,24,0,24,54,10,1
1,814,1,1,0,0,0,47,10,1
1,708,2,1,0,0,0,36,9,1
1,641,2,1,0,3,-3,19,6,1
1,596,1,1,0,3,-3,53,10,1
1,353,2,0,3,0,3,25,9,1
1,208,2,1,0,3,-3,47,12,1
1,140,2,0,3,0,3,47,6,1
2,829,1,1,2,3,-1,41,10,1
2,275,1,0,10,5,5,35,10,1
2,149,2,1,5,10,-5,34,4,1
2,93,1,0,10,5,5,50,10,1
2,64,1,1,5,10,-5,49,10,1
2,55,2,1,5,10,-5,49,10,1
2,40,2,1,5,10,-5,24,17,1
3,839,1,1,5,10,-5,42,20,1
3,706,2,1,5,13,-8,25,20,1
3,384,2,0,13,5,8,45,6,1
3,321,2,1,5,13,-8,22,9,1
3,35,2,1,5,13,-8,41,9,1
4,686,1,1,5,13,-8,32,10,1
4,672,2,1,5,13,-8,32,10,1
4,614,1,0,16,5,11,47,10,1
4,598,2,0,16,5,11,47,10,1
4,539,2,0,16,5,11,17,3,1
4,352,0,1,11,16,-5,5,0,1
4,288,2,0,16,11,5,15,4,1
4,158,2,0,16,11,5,51,6,1
4,103,1,1,11,16,-5,55,10,1
4,29,1,0,16,11,5,3,3,1
4,16,3,0,16,11,5,3,3,1
1,458,2,1,0,7,-7,51,4,1
1,314,1,0,7,0,7,47,10,1
1,187,1,0,7,0,7,32,10,1
2,867,2,0,7,0,7,45,7,1
2,498,2,1,0,7,-7,52,11,1
2,427,1,0,7,0,7,17,10,1
2,417,2,0,7,0,7,17,10,1
2,380,1,0,7,3,4,35,10,1
2,193,2,0,7,3,4,44,7,1
3,873,2,1,3,7,-4,38,4,1
3,706,2,0,7,3,4,38,13,1
3,627,2,0,7,3,4,13,5,1
3,462,1,0,7,8,-1,35,10,1
3,315,1,0,7,8,-1,46,10,1
3,120,1,0,7,11,-4,45,10,1
4,820,2,0,7,11,-4,16,6,1
4,743,1,0,7,11,-4,23,10,1
4,724,2,0,7,11,-4,23,10,1
4,580,1,0,7,14,-7,50,10,1
4,405,1,1,14,7,7,42,10,1
4,386,2,1,14,7,7,42,10,1
4,102,1,0,7,14,-7,50,10,1
1,894,1,0,0,0,0,25,10,1
1,790,2,0,0,7,-7,38,3,1
1,717,1,1,7,0,7,52,10,1
1,688,1,0,0,7,-7,46,10,1
1,501,2,1,7,7,0,30,7,1
1,340,2,0,7,7,0,37,3,1
2,67,1,1,21,17,4,43,10,1
2,54,2,1,21,17,4,38,5,1
2,49,3,1,21,17,4,38,5,1
3,426,2,1,31,17,14,15,5,1
4,488,1,1,42,20,22,26,10,1
4,461,2,1,42,20,22,26,10,1
4,190,3,0,20,42,-22,33,3,1
4,186,1,0,20,42,-22,33,10,1
1,723,2,1,0,0,0,34,5,1
1,117,1,1,0,2,-2,33,10,1
2,848,2,1,0,2,-2,54,8,1
2,772,2,1,0,2,-2,18,7,1
2,712,1,0,2,0,2,35,10,1
2,704,2,0,2,0,2,35,10,1
2,554,2,1,0,2,-2,43,7,1
2,410,1,1,0,2,-2,11,10,1
2,39,1,1,0,9,-9,26,10,1
3,667,1,1,0,9,-9,50,10,1
3,649,2,1,0,9,-9,50,10,1
3,573,2,1,0,10,-10,39,6,1
3,497,1,1,0,10,-10,7,7,1
3,291,1,1,0,17,-17,14,10,1
4,863,2,0,24,16,8,47,7,1
4,757,1,1,16,24,-8,20,10,1
4,497,1,0,24,24,0,49,10,1
4,310,1,1,24,24,0,50,10,1
1,890,1,1,0,0,0,42,10,1
1,782,2,0,0,0,0,48,4,1
1,720,2,0,0,0,0,6,9,1
2,841,1,1,17,7,10,36,5,1
2,199,1,1,20,21,-1,45,10,1
2,48,1,0,21,20,1,41,10,1
3,890,1,0,21,20,1,30,10,1
3,717,1,1,20,21,-1,35,10,1
3,483,1,0,21,20,1,6,6,1
3,456,2,0,21,20,1,6,6,1
3,16,1,0,21,23,-2,21,10,1
4,900,2,0,21,23,-2,21,10,1
4,866,1,0,21,26,-5,35,10,1
4,709,2,0,21,26,-5,20,16,1
4,328,2,0,24,29,-5,14,5,1
4,274,1,0,24,30,-6,35,10,1
4,48,1,1,33,24,9,30,10,1
1,820,1,0,0,0,0,40,10,1
1,732,1,0,0,0,0,55,10,1
1,596,2,1,0,0,0,45,7,1
1,458,2,1,0,0,0,52,10,1
1,242,2,0,0,0,0,37,4,1
1,108,1,1,0,0,0,28,10,1
2,900,1,0,10,0,10,50,10,1
2,820,2,0,10,0,10,27,8,1
2,355,2,0,10,3,7,8,6,1
2,302,1,1,6,10,-4,54,10,1
2,282,2,1,6,10,-4,54,10,1
2,248,1,1,6,10,-4,26,10,1
2,116,1,0,10,6,4,24,10,1
2,75,1,0,10,9,1,35,10,1
2,69,2,0,10,9,1,35,10,1
3,563,1,0,10,9,1,30,10,1
3,547,2,0,10,9,1,30,10,1
3,451,2,0,10,12,-2,40,9,1
3,355,1,1,12,10,2,24,10,1
3,335,2,1,12,10,2,24,10,1
4,809,1,1,12,17,-5,29,10,1
4,768,1,1,12,17,-5,39,10,1
4,742,2,1,12,17,-5,39,10,1
4,666,1,0,17,12,5,42,10,1
4,563,1,0,17,12,5,23,10,1
4,429,1,1,14,17,-3,49,10,1
4,69,2,1,19,17,2,51,12,1
4,64,3,1,19,17,2,51,12,1
4,21,1,0,17,19,-2,28,10,1
4,17,2,0,17,19,-2,28,10,1
1,164,1,0,7,0,7,45,10,1
2,695,1,1,0,10,-10,24,10,1
2,616,2,1,0,10,-10,13,8,1
2,167,1,1,7,13,-6,33,10,1
3,868,1,1,10,20,-10,52,10,1
3,687,2,1,10,20,-10,31,17,1
3,603,1,1,10,23,-13,25,20,1
3,268,1,1,13,23,-10,22,10,1
3,2,1,0,30,13,17,18,10,1
4,754,1,0,30,20,10,40,10,1
4,610,1,1,20,30,-10,53,10,1
4,573,2,1,20,30,-10,53,10,1
4,389,1,1,20,30,-10,33,10,1
4,285,1,1,20,33,-13,45,10,1
4,253,2,1,20,33,-13,45,10,1
4,211,1,0,33,20,13,50,10,1
4,113,2,0,33,27,6,26,8,1
4,59,2,0,33,34,-1,46,15,1
4,23,3,0,33,34,-1,7,7,1
1,765,2,0,0,0,0,54,9,1
1,624,1,0,0,0,0,33,10,1
1,580,1,0,0,0,0,22,10,1
1,559,2,0,0,0,0,22,10,1
1,354,1,1,3,0,3,44,10,1
1,330,2,1,3,0,3,44,10,1
1,229,2,1,3,0,3,37,4,1
1,45,2,1,3,0,3,51,19,1
2,820,2,1,3,0,3,26,16,1
2,709,1,1,3,0,3,48,10,1
2,263,2,1,10,0,10,27,4,1
2,169,1,1,10,3,7,50,10,1
2,140,2,0,3,17,-14,29,7,1
2,60,1,0,3,17,-14,50,10,1
2,44,2,0,3,17,-14,50,10,1
3,572,1,0,3,24,-21,44,10,1
3,345,2,0,3,24,-21,23,12,1
3,96,1,1,27,3,24,52,10,1
4,870,2,1,27,3,24,40,6,1
4,281,2,0,3,34,-31,47,4,1
4,159,1,0,3,41,-38,35,10,1
4,75,2,0,3,41,-38,53,9,1
4,51,3,0,3,41,-38,53,9,1
1,714,2,1,0,0,0,52,6,1
1,594,2,1,0,0,0,19,13,1
1,457,1,1,0,0,0,7,10,1
1,255,1,1,0,0,0,11,10,1
1,164,2,1,0,7,-7,39,6,1
2,726,2,1,0,7,-7,31,4,1
2,470,1,1,7,7,0,47,10,1
2,450,2,1,7,7,0,47,10,1
2,194,2,0,7,14,-7,20,8,1
2,59,1,0,7,14,-7,52,10,1
2,54,2,0,7,14,-7,52,10,1
2,43,1,0,7,14,-7,38,10,1
3,358,2,0,7,21,-14,18,3,1
3,302,1,0,7,24,-17,30,10,1
3,87,2,0,7,31,-24,34,7,1
4,900,1,1,34,7,27,32,10,1
4,889,2,1,34,7,27,32,10,1
4,814,2,1,34,7,27,49,12,1
4,170,1,1,37,9,28,49,10,1
1,752,2,1,0,0,0,34,4,1
1,690,2,0,0,0,0,31,5,1
1,432,1,0,0,0,0,11,10,1
1,242,1,0,0,7,-7,18,10,1
1,110,2,0,0,10,-10,40,5,1
2,832,2,0,0,10,-10,34,4,1
2,570,2,0,0,11,-11,26,6,1
2,456,2,0,0,14,-14,53,6,1
2,294,2,0,0,21,-21,10,8,1
2,155,1,0,0,28,-28,2,13,1
2,107,2,1,30,0,30,53,3,1
2,65,2,0,0,30,-30,33,2,1
2,19,1,0,0,30,-30,41,10,1
3,862,1,1,37,0,37,46,10,1
3,637,1,0,0,40,-40,35,10,1
3,560,2,1,40,0,40,45,3,1
3,486,2,1,40,0,40,36,9,1
3,456,1,1,40,3,37,35,10,1
3,445,2,1,40,3,37,35,10,1
3,245,3,0,3,40,-37,34,2,1
3,110,2,1,40,3,37,24,6,1
4,870,2,0,6,40,-34,39,13,1
4,785,1,0,6,41,-35,55,10,1
4,664,1,1,41,6,35,19,10,1
4,640,2,1,41,6,35,19,10,1
4,334,3,1,41,9,32,25,3,1
4,176,1,0,9,41,-32,45,10,1
4,151,1,0,9,41,-32,2,10,1
4,117,2,0,9,41,-32,38,3,1
4,87,1,1,41,9,32,49,10,1
4,78,2,1,41,9,32,49,10,1
4,1,2,0,9,41,-32,36,8,1
1,831,1,1,0,0,0,51,10,1
1,728,1,0,0,0,0,48,10,1
1,567,2,0,0,0,0,14,3,1
1,525,2,0,0,3,-3,34,11,1
1,425,2,1,3,0,3,43,13,1
1,350,1,0,0,3,-3,53,20,1
1,326,2,0,0,3,-3,53,20,1
1,289,1,0,0,4,-4,35,10,1
1,1,1,1,4,0,4,46,10,1
2,693,1,1,4,0,4,47,10,1
2,422,2,0,1,4,-3,30,19,1
2,316,1,1,4,1,3,48,10,1
2,179,1,1,4,1,3,18,10,1
2,164,2,1,4,1,3,18,10,1
3,841,1,0,1,7,-6,51,10,1
3,674,1,1,7,1,6,15,10,1
3,90,2,1,7,3,4,20,9,1
4,821,1,0,6,15,-9,35,10,1
4,803,2,0,6,15,-9,35,10,1
4,681,2,0,6,15,-9,53,3,1
4,591,2,0,6,15,-9,19,12,1
4,569,1,1,15,6,9,51,10,1
4,460,1,0,6,16,-10,51,10,1
4,431,2,0,6,16,-10,51,10,1
4,315,1,0,6,16,-10,29,10,1
4,296,2,0,6,16,-10,29,10,1
4,210,2,0,6,16,-10,33,2,1
1,540,1,0,0,0,0,23,10,1
1,510,2,0,0,0,0,23,10,1
1,128,1,1,3,3,0,44,5,1
2,894,1,1,3,10,-7,35,10,1
2,602,1,0,10,6,4,47,10,1
2,576,2,0,10,6,4,47,10,1
2,401,2,0,10,6,4,54,4,1
2,160,2,0,10,6,4,36,13,1
2,145,1,1,6,10,-4,37,10,1
2,31,2,1,6,10,-4,50,4,1
3,764,2,1,6,10,-4,44,8,1
3,720,1,1,6,10,-4,4,10,1
3,703,2,1,6,10,-4,4,10,1
3,617,1,1,6,10,-4,30,10,1
3,592,2,1,6,10,-4,30,10,1
3,494,2,1,6,13,-7,36,9,1
4,753,2,1,6,20,-14,55,7,1
4,360,2,1,9,20,-11,48,5,1
4,317,1,1,9,20,-11,52,10,1
4,241,1,0,20,9,11,44,10,1
4,169,2,0,20,12,8,40,5,1
4,107,1,0,20,12,8,44,10,1
1,606,1,1,0,0,0,20,10,1
1,532,1,1,0,7,-7,36,10,1
1,521,2,1,0,7,-7,36,10,1
1,170,1,0,14,0,14,28,10,1
2,800,1,0,15,3,12,22,10,1
2,780,2,0,15,3,12,22,10,1
2,235,1,0,16,6,10,49,10,1
2,213,2,0,16,6,10,49,10,1
2,117,2,1,6,16,-10,47,9,1
2,70,2,1,6,16,-10,47,5,1
2,52,1,0,16,6,10,26,10,1
3,825,2,0,16,6,10,50,5,1
3,407,1,0,23,7,16,30,10,1
3,391,2,0,23,7,16,30,10,1
3,344,1,0,23,7,16,25,10,1
3,327,2,0,23,7,16,25,10,1
3,244,2,1,7,23,-16,55,5,1
4,422,1,0,26,23,3,51,10,1
4,413,2,0,26,23,3,51,10,1
4,195,1,1,23,26,-3,37,10,1
4,76,2,1,23,33,-10,39,3,1
4,67,3,1,23,33,-10,39,3,1
1,896,1,1,0,0,0,27,10,1
1,780,2,1,0,0,0,35,10,1
1,587,2,1,0,0,0,33,9,1
1,527,2,0,0,0,0,36,7,1
1,114,1,1,3,0,3,48,10,1
2,770,1,1,3,0,3,35,10,1
2,544,1,1,3,3,0,33,10,1
2,172,2,0,4,3,1,34,6,1
2,144,1,1,3,4,-1,54,10,1
2,83,1,0,4,3,1,17,10,1
2,41,1,0,4,10,-6,10,10,1
2,35,2,0,4,10,-6,10,10,1
3,682,2,0,11,13,-2,20,4,1
3,538,1,1,13,11,2,54,20,1
3,509,2,1,13,11,2,54,20,1
3,462,1,0,11,13,-2,53,10,1
3,138,1,0,14,13,1,41,10,1
4,826,2,1,13,14,-1,22,21,1
4,790,1,1,13,17,-4,35,10,1
4,775,2,1,13,17,-4,35,10,1
4,360,1,1,13,24,-11,55,10,1
4,347,2,1,13,24,-11,55,10,1
4,166,3,1,13,24,-11,38,3,1
4,70,1,0,24,13,11,28,10,1
4,55,2,0,24,13,11,28,10,1
4,42,0,1,19,24,-5,5,0,1
4,1,3,1,19,24,-5,31,4,1
1,680,1,0,0,0,0,5,5,1
2,854,2,0,7,7,0,43,8,1
2,635,1,0,7,7,0,53,10,1
2,628,2,0,7,7,0,53,10,1
2,572,2,0,7,7,0,10,5,1
2,146,1,0,10,7,3,48,10,1
3,770,1,1,7,13,-6,11,10,1
3,591,1,1,7,20,-13,39,10,1
3,556,2,1,7,20,-13,39,10,1
3,211,1,0,23,7,16,10,10,1
4,885,1,0,23,10,13,53,10,1
4,672,2,0,23,17,6,34,11,1
4,630,1,1,17,23,-6,48,10,1
4,537,1,0,23,17,6,9,10,1
4,215,1,1,17,23,-6,49,10,1
4,177,2,1,17,23,-6,49,10,1
4,140,2,1,17,23,-6,17,3,1
4,75,1,1,17,23,-6,23,10,1
4,69,2,1,17,23,-6,23,10,1
1,682,1,0,0,0,0,30,10,1
1,663,2,0,0,0,0,30,10,1
1,621,1,0,0,1,-1,35,10,1
1,602,2,0,0,1,-1,35,10,1
1,285,1,1,1,0,1,28,10,1
2,870,2,0,3,8,-5,20,13,1
2,432,2,1,8,10,-2,33,9,1
2,210,2,1,8,10,-2,25,5,1
2,178,1,1,8,13,-5,35,10,1
2,137,1,0,13,8,5,29,10,1
2,102,1,0,13,8,5,51,10,1
2,77,2,0,13,8,5,51,10,1
3,436,2,1,15,27,-12,36,10,1
3,326,1,0,27,15,12,47,10,1
3,249,1,1,15,27,-12,25,10,1
3,104,1,0,27,15,12,24,10,1
3,83,2,0,27,15,12,24,10,1
4,728,0,1,21,27,-6,5,0,1
4,533,1,0,27,23,4,43,10,1
4,492,1,0,27,23,4,21,10,1
4,142,1,0,27,40,-13,35,10,1
4,118,2,0,27,40,-13,54,5,1
1,548,2,0,0,5,-5,44,11,1
1,322,2,0,0,5,-5,15,5,1
1,279,1,0,0,8,-8,35,10,1
1,265,2,0,0,8,-8,35,10,1
1,146,1,0,0,8,-8,32,10,1
2,700,1,1,15,0,15,55,20,1
2,230,2,1,15,7,8,49,11,1
2,141,1,1,15,7,8,33,10,1
2,120,2,1,15,7,8,33,10,1
2,103,1,0,7,15,-8,19,10,1
2,77,1,1,15,7,8,53,10,1
3,894,1,1,15,7,8,45,10,1
3,746,1,0,7,15,-8,30,10,1
3,690,1,0,7,15,-8,53,10,1
3,481,2,0,14,15,-1,45,7,1
3,57,1,0,21,15,6,47,10,1
4,752,2,0,21,15,6,22,8,1
4,421,1,0,21,18,3,3,3,1
4,176,1,1,25,21,4,38,10,1
4,161,2,1,25,21,4,38,10,1
4,21,1,0,24,26,-2,35,10,1
4,14,2,0,24,26,-2,35,10,1
1,860,2,1,0,0,0,42,7,1
1,560,1,0,0,3,-3,35,15,1
1,342,1,1,4,7,-3,30,10,1
1,193,1,1,4,7,-3,23,10,1
1,4,2,0,7,4,3,30,11,1
2,860,1,1,4,7,-3,54,10,1
2,756,2,0,7,4,3,42,8,1
2,624,2,0,7,4,3,40,7,1
2,399,2,0,7,7,0,24,13,1
2,80,1,1,14,7,7,15,10,1
2,55,2,1,14,7,7,15,10,1
3,900,1,0,13,14,-1,45,10,1
3,795,2,1,14,13,1,15,4,1
3,523,1,0,13,14,-1,34,10,1
3,252,1,0,13,17,-4,51,10,1
3,57,1,1,17,13,4,35,10,1
4,844,2,0,13,17,-4,22,7,1
4,411,2,1,17,20,-3,43,14,1
4,346,2,1,17,21,-4,29,16,1
4,147,0,1,23,28,-5,5,0,1
1,866,2,1,0,0,0,52,6,1
1,774,1,0,0,0,0,25,10,1
1,683,2,0,0,0,0,28,19,1
1,435,2,0,0,0,0,21,18,1
1,357,2,0,0,1,-1,43,2,1
1,184,1,0,0,1,-1,40,10,1
2,900,1,1,8,0,8,32,10,1
2,630,1,0,7,8,-1,42,10,1
2,415,2,1,15,14,1,41,4,1
2,255,2,1,15,14,1,42,9,1
2,124,1,1,15,14,1,44,10,1
2,51,2,1,15,14,1,44,33,1
3,676,1,1,15,14,1,15,10,1
3,653,2,1,15,14,1,15,10,1
3,201,1,1,22,24,-2,19,10,1
3,175,2,1,22,24,-2,19,10,1
4,757,1,1,22,24,-2,21,5,1
4,735,2,1,22,24,-2,21,5,1
4,676,1,1,22,27,-5,46,10,1
4,400,2,0,27,25,2,50,11,1
4,220,1,1,25,34,-9,46,10,1
4,162,1,0,34,25,9,36,10,1
1,581,2,0,0,7,-7,34,7,1
1,205,2,1,7,0,7,46,6,1
1,120,2,1,7,0,7,14,8,1
2,720,2,0,3,10,-7,45,7,1
2,535,2,1,10,3,7,40,12,1
2,82,2,0,3,10,-7,55,5,1
2,14,1,1,10,3,7,7,7,1
3,615,1,1,10,9,1,41,10,1
3,514,1,0,9,10,-1,40,10,1
3,493,2,0,9,10,-1,40,10,1
3,446,1,0,9,11,-2,35,10,1
3,414,2,0,9,11,-2,30,15,1
3,310,2,1,11,9,2,47,12,1
3,57,2,1,11,9,2,35,8,1
4,847,1,1,11,9,2,40,20,1
4,660,1,0,9,11,-2,51,10,1
4,455,2,1,11,9,2,3,3,1
4,368,2,1,11,12,-1,23,8,1
4,172,1,1,11,18,-7,20,20,1
4,78,2,0,18,11,7,17,14,1
4,56,3,0,18,11,7,17,14,1
1,845,2,0,0,0,0,35,11,1
1,808,1,1,0,0,0,38,10,1
1,715,2,0,0,0,0,40,11,1
1,495,1,1,3,0,3,35,10,1
1,324,1,0,0,10,-10,34,10,1
1,306,2,0,0,10,-10,34,10,1
1,82,1,1,10,3,7,31,10,1
1,52,2,1,10,3,7,31,10,1
2,900,2,0,3,10,-7,29,9,1
2,545,2,0,3,17,-14,47,4,1
2,426,2,1,17,3,14,40,4,1
2,372,1,0,3,17,-14,27,10,1
2,75,2,0,3,20,-17,15,7,1
2,55,1,0,3,20,-17,53,10,1
3,854,2,1,20,3,17,30,3,1
3,375,1,1,27,3,24,21,10,1
3,136,2,0,3,27,-24,8,6,1
3,2,1,0,3,30,-27,46,10,1
4,900,2,0,3,30,-27,46,10,1
4,457,1,1,37,3,34,43,10,1
4,442,1,1,37,3,34,43,10,1
4,143,1,0,3,37,-34,26,10,1
4,138,2,0,3,37,-34,26,10,1
1,822,1,0,0,0,0,46,10,1
1,790,2,0,0,0,0,46,10,1
1,636,1,0,0,0,0,38,10,1
1,618,2,0,0,0,0,38,10,1
1,408,1,1,0,0,0,36,10,1
1,399,2,1,0,0,0,36,10,1
1,104,1,0,3,0,3,38,10,1
1,91,2,0,3,0,3,38,10,1
2,890,2,0,3,0,3,23,18,1
2,297,1,1,7,4,3,35,10,1
2,276,2,1,7,4,3,35,10,1
2,201,2,0,4,7,-3,52,6,1
2,66,1,1,7,4,3,27,10,1
2,1,1,1,7,11,-4,43,10,1
3,651,3,1,7,11,-4,25,12,1
3,572,2,0,11,7,4,48,5,1
3,493,2,1,7,11,-4,46,4,1
4,900,1,0,14,7,7,38,10,1
4,883,2,0,14,7,7,38,10,1
4,805,1,0,14,10,4,30,10,1
4,412,2,1,17,14,3,47,10,1
4,305,2,0,14,17,-3,40,10,1
4,203,2,1,17,14,3,51,7,1
4,123,1,0,14,17,-3,51,10,1
4,119,2,0,14,17,-3,51,10,1
4,115,3,0,14,17,-3,51,10,1
1,832,2,0,0,0,0,42,14,1
1,760,1,1,0,0,0,51,10,1
1,480,1,0,0,14,-14,20,20,1
1,300,1,0,0,14,-14,37,10,1
1,230,1,0,0,14,-14,25,10,1
1,30,2,0,0,14,-14,32,7,1
2,663,2,1,17,0,17,53,11,1
2,280,1,0,0,17,-17,7,7,1
2,170,2,0,0,20,-20,29,16,1
2,113,1,1,20,0,20,45,10,1
2,27,1,0,0,20,-20,29,10,1
3,662,1,0,1,20,-19,34,10,1
3,488,2,0,1,20,-19,45,11,1
3,197,2,1,20,1,19,46,8,1
3,127,2,1,20,2,18,40,5,1
4,763,1,1,20,2,18,14,10,1
4,737,2,1,20,2,18,14,10,1
4,251,1,1,23,5,18,14,10,1
4,189,3,1,23,5,18,7,3,1
4,132,1,0,5,23,-18,47,10,1
4,121,3,0,5,23,-18,52,6,1
4,99,1,0,5,23,-18,52,10,1
4,59,1,0,5,23,-18,7,10,1
4,31,1,0,5,23,-18,44,10,1
1,843,1,1,0,0,0,35,10,1
1,730,1,1,0,0,0,5,5,1
1,712,2,1,0,0,0,5,5,1
1,464,2,0,3,0,3,11,6,1
1,282,2,1,3,3,0,43,11,1
1,90,1,0,3,3,0,49,10,1
1,70,2,0,3,3,0,49,10,1
2,622,1,0,10,3,7,29,10,1
2,228,1,1,6,10,-4,13,10,1
3,729,2,0,24,13,11,43,8,1
3,639,2,0,24,13,11,24,5,1
3,589,1,0,24,13,11,45,10,1
3,500,2,0,24,13,11,18,11,1
3,227,1,1,16,24,-8,24,10,1
4,794,1,1,16,27,-11,33,10,1
4,678,1,1,16,30,-14,35,10,1
4,145,2,1,16,30,-14,7,6,1
4,118,1,1,16,33,-17,45,10,1
1,779,1,0,0,0,0,11,10,1
1,757,2,0,0,0,0,11,10,1
1,385,2,0,0,4,-4,48,8,1
1,155,1,0,0,4,-4,47,10,1
2,850,1,0,0,4,-4,35,10,1
2,630,2,0,0,4,-4,40,5,1
2,395,2,1,11,0,11,16,7,1
2,280,1,1,11,3,8,37,10,1
2,178,2,1,11,3,8,23,6,1
2,81,1,0,6,11,-5,41,10,1
3,894,1,0,6,11,-5,32,10,1
3,712,2,0,6,11,-5,41,14,1
3,575,1,0,6,14,-8,35,10,1
3,567,2,0,6,14,-8,35,10,1
3,506,1,1,14,6,8,34,10,1
3,320,2,1,14,6,8,55,13,1
3,225,2,0,6,14,-8,27,6,1
4,545,1,1,21,6,15,21,10,1
4,460,2,1,21,6,15,5,5,1
4,182,1,0,9,28,-19,13,10,1
4,152,1,0,9,28,-19,27,15,1
4,117,3,0,9,28,-19,50,7,1
4,62,1,0,9,29,-20,35,10,1
4,19,0,0,15,29,-14,5,0,1
1,730,2,1,0,0,0,30,4,1
1,665,1,1,0,1,-1,47,10,1
1,537,1,0,1,0,1,16,10,1
1,510,2,0,1,0,1,16,10,1
2,746,1,1,7,1,6,51,10,1
2,681,2,1,7,1,6,29,5,1
2,483,1,1,7,1,6,18,10,1
2,401,1,1,7,4,3,41,10,1
2,237,1,0,4,7,-3,31,10,1
2,222,2,0,4,7,-3,31,10,1
2,175,2,0,4,10,-6,35,10,1
2,151,2,1,10,4,6,47,9,1
2,84,1,0,4,10,-6,40,10,1
2,45,0,1,16,4,12,5,0,1
3,799,2,1,16,4,12,47,10,1
3,747,2,0,4,16,-12,30,4,1
4,641,2,1,24,7,17,50,7,1
4,434,1,1,24,7,17,17,10,1
4,418,2,1,24,7,17,17,10,1
4,380,1,1,24,10,14,35,10,1
4,302,1,0,10,24,-14,50,10,1
4,295,2,0,10,24,-14,50,10,1
4,40,2,0,17,24,-7,20,8,1
4,18,1,0,17,24,-7,31,10,1
1,565,2,1,0,0,0,37,7,1
1,535,1,0,0,0,0,37,10,1
1,331,2,0,0,0,0,44,11,1
1,232,1,0,0,1,-1,49,10,1
1,213,2,0,0,1,-1,49,10,1
1,50,2,1,1,0,1,50,2,1
1,9,1,0,0,1,-1,32,10,1
2,788,2,0,0,1,-1,34,6,1
2,592,2,0,0,1,-1,27,9,1
2,257,1,0,0,8,-8,55,10,1
2,178,1,1,8,0,8,22,10,1
2,164,2,1,8,0,8,22,10,1
2,91,1,0,3,8,-5,32,10,1
2,79,1,0,3,8,-5,16,10,1
2,63,1,0,3,15,-12,22,10,1
2,57,2,0,3,15,-12,22,10,1
2,36,2,0,3,15,-12,47,3,1
3,214,1,0,3,29,-26,8,15,1
3,80,1,0,3,36,-33,29,10,1
4,365,2,0,3,50,-47,37,3,1
4,53,1,1,50,11,39,8,8,1
1,852,2,1,0,0,0,30,11,1
1,814,1,0,0,0,0,17,10,1
1,524,2,1,7,0,7,17,11,1
1,459,2,1,7,0,7,45,9,1
1,30,2,1,7,1,6,48,13,1
2,900,1,1,7,1,6,19,10,1
2,715,1,0,1,14,-13,31,10,1
2,622,2,0,1,15,-14,41,4,1
2,580,1,1,15,1,14,32,10,1
2,437,2,0,1,22,-21,42,8,1
2,272,1,0,1,22,-21,31,10,1
2,231,1,0,1,22,-21,45,10,1
2,183,1,0,1,22,-21,55,10,1
2,146,1,1,22,1,21,35,10,1
2,121,2,1,22,1,21,35,10,1
3,742,1,0,4,29,-25,47,10,1
3,410,1,1,36,4,32,3,3,1
3,137,2,1,36,18,18,33,7,1
4,900,2,0,18,36,-18,48,18,1
4,485,1,0,18,36,-18,27,10,1
4,343,2,0,18,36,-18,49,6,1
4,295,1,0,18,36,-18,10,10,1
4,247,3,0,18,36,-18,16,4,1
4,126,1,0,18,43,-25,42,10,1
4,120,2,0,18,43,-25,42,10,1
4,48,1,1,43,18,25,43,10,1
1,715,2,0,0,0,0,54,7,1
1,624,2,1,0,0,0,17,15,1
1,254,2,0,0,7,-7,27,12,1
2,751,2,0,0,14,-14,50,7,1
2,639,2,1,14,0,14,33,6,1
2,384,2,1,14,0,14,19,4,1
2,167,1,0,0,14,-14,9,9,1
3,295,2,0,7,17,-10,12,5,1
3,65,2,1,20,7,13,28,8,1
4,741,2,1,20,7,13,18,5,1
4,715,1,1,20,10,10,35,10,1
4,590,1,1,20,10,10,39,10,1
4,299,2,1,20,13,7,38,7,1
4,160,1,1,20,13,7,24,10,1
4,125,1,1,20,16,4,35,10,1
4,6,1,0,16,20,-4,54,10,1
1,434,1,1,3,0,3,38,10,1
1,263,2,0,0,3,-3,34,5,1
1,172,1,1,6,0,6,55,10,1
1,28,1,0,0,6,-6,35,10,1
1,7,2,0,0,6,-6,35,10,1
2,529,2,0,0,7,-7,14,6,1
2,434,2,0,0,10,-10,38,8,1
2,125,1,0,0,17,-17,52,10,1
2,105,2,0,0,17,-17,52,10,1
2,87,2,1,17,0,17,16,10,1
2,62,1,1,17,0,17,54,10,1
3,862,1,1,17,7,10,45,10,1
3,846,2,1,17,7,10,45,10,1
3,684,2,1,17,7,10,50,5,1
3,630,2,1,17,7,10,15,8,1
3,446,2,0,7,17,-10,31,4,1
3,396,1,0,7,18,-11,35,10,1
3,327,1,0,7,18,-11,47,10,1
3,129,2,1,18,7,11,23,5,1
4,881,3,1,18,10,8,51,1,1
4,737,1,0,10,18,-8,50,10,1
4,719,2,0,10,18,-8,50,10,1
4,595,1,1,18,10,8,24,10,1
4,485,2,0,10,18,-8,35,15,1
4,134,1,1,18,10,8,54,20,1
1,893,1,0,0,0,0,35,10,1
1,871,2,0,0,0,0,35,10,1
1,727,2,1,0,0,0,38,8,1
1,298,2,0,7,0,7,38,7,1
1,151,2,0,7,0,7,25,8,1
2,140,1,0,14,10,4,41,10,1
2,89,2,0,14,10,4,13,4,1
2,69,1,0,14,13,1,50,10,1
2,53,2,0,14,13,1,50,10,1
3,766,2,0,14,20,-6,40,20,1
3,630,1,1,20,14,6,33,10,1
3,75,2,1,27,14,13,26,10,1
3,1,2,1,27,17,10,37,7,1
4,879,1,0,17,27,-10,49,10,1
4,764,2,1,27,17,10,35,8,1
4,400,1,0,24,27,-3,35,10,1
4,375,2,0,24,27,-3,35,10,1
4,215,1,0,24,37,-13,38,10,1
4,5,1,1,40,24,16,27,10,1
1,851,1,0,0,0,0,53,10,1
1,745,2,1,0,0,0,24,4,1
1,222,3,1,7,0,7,40,3,1
2,835,2,0,0,7,-7,35,10,1
2,710,1,0,0,7,-7,43,10,1
2,634,2,0,0,7,-7,24,6,1
2,481,2,0,0,10,-10,42,4,1
2,342,2,0,0,10,-10,29,8,1
2,185,1,0,0,13,-13,23,10,1
2,136,1,0,0,20,-20,48,10,1
2,61,2,0,0,20,-20,25,5,1
3,516,1,0,0,34,-34,25,10,1
3,288,1,0,0,34,-34,9,9,1
3,48,2,1,34,0,34,50,3,1
4,663,2,0,7,34,-27,25,4,1
4,457,2,1,37,7,30,36,10,1
4,66,1,1,37,10,27,33,10,1
4,53,3,1,37,10,27,31,8,1
1,865,2,1,0,0,0,33,6,1
1,467,1,1,0,0,0,49,10,1
1,423,1,0,0,0,0,36,10,1
1,260,2,0,0,6,-6,48,6,1
2,536,2,1,6,6,0,50,24,1
2,421,2,1,6,6,0,35,7,1
2,196,1,0,6,6,0,46,10,1
2,173,2,0,6,6,0,46,10,1
2,113,1,0,6,6,0,53,10,1
3,884,1,0,13,6,7,24,10,1
3,725,2,0,13,6,7,50,11,1
3,674,2,0,13,7,6,31,14,1
3,476,1,1,7,13,-6,21,10,1
3,286,1,0,20,14,6,21,10,1
3,267,2,0,20,14,6,21,10,1
3,149,1,1,14,20,-6,42,10,1
4,880,1,1,14,27,-13,41,10,1
4,730,2,1,14,27,-13,50,13,1
4,332,0,1,20,34,-14,3,0,1
4,220,2,0,34,20,14,30,12,1
4,74,1,0,34,27,7,52,10,1
4,74,2,0,34,27,7,52,10,1
1,555,1,0,0,0,0,21,10,1
1,538,2,0,0,0,0,21,10,1
1,299,2,1,3,0,3,5,5,1
1,268,1,1,3,3,0,29,10,1
1,0,1,0,3,3,0,20,10,1
2,886,2,0,3,3,0,25,15,1
2,775,2,0,3,6,-3,38,9,1
2,703,1,1,6,3,3,42,10,1
2,660,2,1,6,3,3,42,10,1
2,572,2,0,3,6,-3,49,6,1
2,391,2,0,3,6,-3,26,7,1
2,195,1,1,6,3,3,54,10,1
2,153,1,1,6,3,3,22,10,1
2,90,1,1,6,6,0,47,10,1
3,770,2,0,6,6,0,34,4,1
3,426,2,0,6,9,-3,21,10,1
3,352,2,0,6,12,-6,39,6,1
3,186,1,1,12,6,6,43,10,1
3,87,1,0,6,12,-6,48,10,1
4,73,1,0,6,20,-14,22,10,1
1,894,1,1,0,0,0,30,10,1
1,483,2,0,0,0,0,33,4,1
1,760,1,0,0,0,0,32,10,1
1,573,2,0,0,0,0,32,5,1
1,499,1,0,0,0,0,25,10,1
1,455,2,0,0,0,0,30,15,1
1,337,1,0,0,0,0,50,10,1
1,319,2,0,0,0,0,50,10,1
1,220,1,1,0,0,0,49,10,1
1,206,2,1,0,0,0,49,10,1
2,604,2,1,0,1,-1,21,6,1
2,557,1,1,0,4,-4,35,10,1
2,264,2,0,4,0,4,28,4,1
2,169,1,0,4,0,4,33,10,1
2,158,2,0,4,0,4,33,10,1
2,142,1,0,4,3,1,40,10,1
3,759,2,0,12,3,9,53,14,1
3,655,2,1,3,12,-9,34,7,1
3,609,1,0,12,3,9,40,10,1
3,427,1,1,3,12,-9,38,10,1
3,408,2,1,3,12,-9,38,10,1
3,116,1,1,3,19,-16,48,10,1
4,844,1,0,19,3,16,55,10,1
1,37,1,1,7,3,4,42,10,1
1,16,2,1,7,3,4,42,10,1
2,805,1,0,3,7,-4,49,10,1
2,636,1,1,7,10,-3,22,10,1
2,520,1,1,7,10,-3,26,10,1
2,217,2,1,7,20,-13,42,5,1
2,88,1,1,7,20,-13,3,10,1
2,83,2,1,7,20,-13,3,10,1
2,50,1,0,22,7,15,33,10,1
2,35,2,0,22,7,15,2,2,1
2,10,3,0,22,7,15,2,2,1
3,690,2,1,7,22,-15,7,7,1
4,712,2,1,10,30,-20,50,16,1
4,632,1,0,30,10,20,42,10,1
4,618,2,0,30,10,20,42,10,1
4,538,2,0,30,10,20,15,8,1
4,210,3,1,10,30,-20,20,4,1
4,161,2,1,10,30,-20,20,10,1
4,40,1,1,10,30,-20,46,10,1
1,447,1,0,7,7,0,48,10,1
1,331,2,1,7,7,0,42,13,1
1,204,2,1,7,10,-3,39,12,1
2,795,2,1,7,10,-3,12,3,1
2,681,2,1,7,13,-6,45,7,1
2,296,1,1,7,20,-13,39,10,1
2,275,2,1,7,20,-13,39,10,1
2,246,1,0,20,7,13,29,10,1
2,224,2,0,20,7,13,29,10,1
2,111,1,0,20,7,13,34,10,1
2,93,2,1,7,20,-13,54,4,1
2,21,1,0,20,7,13,22,10,1
3,827,1,1,7,20,-13,42,10,1
3,764,1,0,20,7,13,40,10,1
3,688,2,1,7,20,-13,52,6,1
3,620,2,1,7,20,-13,19,8,1
3,429,2,1,7,20,-13,13,6,1
3,374,1,1,7,23,-16,38,10,1
3,240,1,0,23,7,16,47,10,1
3,220,2,0,23,7,16,47,10,1
3,146,2,0,23,7,16,18,6,1
4,731,2,1,13,23,-10,9,4,1
4,582,1,0,26,13,13,46,10,1
4,567,2,0,26,13,13,46,10,1
4,320,1,0,26,13,13,50,10,1
4,180,1,0,26,13,13,17,10,1
4,169,2,0,26,13,13,17,10,1
4,97,1,1,15,26,-11,35,10,1
4,32,2,0,26,15,11,33,6,1
1,890,1,1,0,0,0,35,10,1
1,878,2,1,0,0,0,35,10,1
1,837,1,0,0,0,0,53,10,1
1,474,2,1,6,0,6,7,3,1
1,382,2,1,6,3,3,37,8,1
1,315,2,0,3,6,-3,30,5,1
1,230,2,1,6,3,3,44,7,1
1,161,2,0,3,6,-3,32,4,1
2,398,2,0,10,16,-6,35,19,1
2,334,1,0,10,19,-9,52,10,1
2,37,1,0,10,19,-9,48,20,1
3,446,2,0,16,19,-3,32,9,1
3,394,1,0,16,19,-3,22,10,1
3,379,2,0,16,19,-3,22,10,1
3,58,2,1,27,16,11,46,7,1
4,460,1,1,30,23,7,22,10,1
4,400,1,1,30,23,7,9,9,1
4,301,2,1,30,30,0,24,9,1
4,23,1,1,30,37,-7,48,10,1
1,756,1,0,0,0,0,10,10,1
1,461,1,1,6,0,6,27,10,1
1,449,2,1,6,0,6,27,10,1
1,294,2,1,6,0,6,50,7,1
1,224,2,1,6,0,6,14,6,1
1,165,1,0,0,6,-6,46,10,1
1,165,1,0,0,6,-6,46,10,1
1,151,2,0,0,6,-6,46,10,1
1,82,1,1,6,0,6,21,15,1
1,68,2,1,6,0,6,21,15,1
2,831,1,0,0,6,-6,53,10,1
2,670,2,1,6,0,6,33,5,1
2,626,1,1,6,3,3,8,10,1
2,179,2,1,13,5,8,29,7,1
2,87,1,1,13,5,8,30,10,1
2,61,1,1,13,5,8,45,10,1
2,43,2,1,13,5,8,45,10,1
3,550,1,1,13,5,8,13,10,1
3,440,2,1,13,13,0,29,9,1
3,379,2,0,13,13,0,26,6,1
3,312,1,1,13,13,0,37,10,1
3,73,1,0,13,16,-3,30,15,1
4,588,1,1,16,20,-4,35,10,1
4,485,1,0,20,16,4,44,10,1
4,433,1,0,20,16,4,55,10,1
4,296,1,1,16,20,-4,50,10,1
4,274,2,1,16,20,-4,50,10,1
1,396,1,0,7,0,7,30,10,1
1,151,1,1,7,7,0,23,10,1
2,889,1,1,7,15,-8,43,15,1
2,465,2,1,9,15,-6,44,27,1
2,117,1,1,10,15,-5,34,10,1
2,97,1,1,10,15,-5,13,10,1
2,77,2,1,10,15,-5,13,10,1
2,55,2,1,10,18,-8,24,21,1
3,797,2,0,18,10,8,27,17,1
3,695,1,0,18,10,8,16,10,1
3,345,2,0,18,18,0,23,16,1
3,92,1,1,18,18,0,40,10,1
3,50,1,1,18,18,0,27,10,1
4,826,1,1,18,21,-3,48,10,1
4,667,2,1,18,21,-3,42,18,1
4,271,1,0,22,18,4,6,15,1
4,175,1,0,22,18,4,36,10,1
4,165,2,0,22,18,4,36,10,1
4,80,2,1,21,22,-1,45,9,1
4,36,1,1,21,23,-2,45,10,1
1,569,1,0,0,2,-2,17,10,1
1,537,2,0,0,2,-2,17,10,1
1,359,2,0,0,2,-2,53,10,1
1,100,2,0,1,3,-2,42,7,1
2,758,2,0,7,10,-3,55,5,1
2,405,1,0,7,10,-3,24,10,1
2,193,2,1,10,7,3,32,12,1
2,26,1,1,10,10,0,28,10,1
3,880,1,0,10,10,0,36,10,1
3,700,1,1,10,10,0,49,10,1
3,387,0,1,16,10,6,1,0,1
3,269,1,1,16,10,6,41,10,1
4,780,2,0,11,24,-13,14,6,1
4,704,2,0,11,24,-13,38,11,1
4,645,1,1,25,11,14,49,10,1
4,598,2,1,25,11,14,44,5,1
4,187,1,1,26,11,15,33,10,1
4,170,2,1,26,11,15,43,20,1
4,100,2,0,11,26,-15,48,2,1
4,96,3,0,11,26,-15,48,2,1
1,591,2,0,0,0,0,48,7,1
1,342,1,1,0,0,0,18,10,1
1,100,1,1,0,0,0,6,6,1
1,1,1,0,7,0,7,53,10,1
2,121,1,1,7,15,-8,45,10,1
2,65,2,1,14,15,-1,51,3,1
2,43,2,1,14,15,-1,39,2,1
3,469,1,0,15,22,-7,33,10,1
3,437,2,0,15,22,-7,33,10,1
3,239,1,1,23,15,8,14,10,1
4,678,1,0,23,23,0,25,15,1
4,220,1,1,26,30,-4,48,10,1
1,474,1,0,3,1,2,26,10,1
1,231,1,1,7,3,4,22,20,1
1,146,2,1,7,3,4,3,3,1
2,870,1,1,7,17,-10,27,20,1
2,851,2,1,7,17,-10,27,20,1
2,713,1,1,7,17,-10,16,10,1
2,373,1,0,31,7,24,52,10,1
2,316,1,1,7,31,-24,48,10,1
2,52,1,0,38,7,31,44,5,1
3,895,1,1,13,38,-25,34,10,1
3,859,2,1,13,38,-25,29,15,1
3,653,2,1,13,38,-25,25,12,1
3,612,1,1,13,41,-28,35,10,1
3,584,2,1,13,41,-28,35,10,1
3,532,2,0,41,13,28,10,15,1
3,316,2,0,41,15,26,24,20,1
3,224,1,0,41,18,23,55,10,1
4,253,1,0,52,26,26,52,10,1
4,242,2,0,52,26,26,52,10,1
1,880,1,0,0,0,0,10,10,1
1,600,2,1,0,0,0,54,10,1
1,114,1,1,7,0,7,47,10,1
2,830,1,0,0,7,-7,27,10,1
2,626,2,0,0,7,-7,16,9,1
2,525,2,0,0,10,-10,40,5,1
2,446,2,1,10,0,10,42,6,1
2,370,2,0,0,10,-10,33,7,1
2,171,1,0,0,10,-10,23,10,1
2,113,1,0,0,16,-16,31,10,1
2,78,1,1,16,0,16,29,10,1
2,70,2,1,16,0,16,29,10,1
3,101,1,1,22,3,19,48,10,1
4,589,1,1,25,11,14,28,10,1
4,332,3,0,11,25,-14,28,3,1
4,173,1,0,11,28,-17,35,10,1
1,482,1,1,0,0,0,4,4,1
1,451,2,1,0,0,0,4,4,1
1,158,1,0,3,0,3,13,15,1
1,153,2,0,3,0,3,13,15,1
1,109,1,0,3,0,3,42,10,1
1,102,2,0,3,0,3,42,10,1
2,864,2,0,3,0,3,50,5,1
2,470,2,1,0,3,-3,5,5,1
2,137,1,1,7,6,1,51,10,1
2,14,1,1,7,7,0,51,10,1
3,259,1,1,13,9,4,26,10,1
3,26,1,0,16,13,3,44,10,1
4,802,1,1,20,16,4,50,10,1
4,792,2,1,20,16,4,50,10,1
4,466,1,0,16,27,-11,16,10,1
4,425,1,0,16,27,-11,41,10,1
4,269,2,1,27,16,11,47,5,1
4,226,1,0,16,27,-11,42,10,1
1,653,2,1,0,0,0,43,17,1
1,248,1,0,3,3,0,40,10,1
2,521,1,0,10,3,7,29,10,1
2,403,2,0,10,3,7,23,18,1
2,383,1,0,10,6,4,35,10,1
2,298,2,0,10,6,4,42,4,1
3,391,1,1,20,10,10,30,10,1
3,228,2,1,20,11,9,48,9,1
4,775,1,1,21,11,10,34,10,1
4,267,1,1,21,18,3,36,10,1
4,34,1,1,28,21,7,35,10,1
5,0,1,1,34,28,6,35,10,1
5,0,0,1,40,42,-2,3,0,1
1,894,1,0,0,0,0,27,10,1
1,753,1,0,0,0,0,55,10,1
1,694,1,1,0,0,0,39,10,1
1,556,2,1,0,0,0,28,7,1
1,273,1,0,0,7,-7,9,9,1
1,190,2,0,0,14,-14,35,10,1
1,1,2,0,0,14,-14,1,1,1
2,821,2,0,0,20,-20,15,15,1
2,698,1,0,0,20,-20,15,10,1
2,542,1,0,0,26,-26,41,10,1
2,525,2,0,0,26,-26,41,10,1
2,445,2,0,0,26,-26,37,18,1
2,401,1,0,0,29,-29,35,10,1
2,245,1,1,29,0,29,33,10,1
2,127,1,0,8,29,-21,9,9,1
2,57,1,1,36,8,28,50,10,1
2,54,2,1,36,8,28,50,10,1
2,15,2,1,36,8,28,35,7,1
3,860,2,1,36,11,25,32,6,1
3,819,1,0,11,36,-25,43,10,1
3,790,1,1,36,11,25,52,10,1
3,695,1,1,36,11,25,28,10,1
3,579,1,1,36,11,25,13,10,1
3,230,1,0,14,43,-29,42,10,1
3,208,2,0,14,43,-29,42,10,1
4,900,3,1,43,14,29,8,6,1
4,507,1,0,17,43,-26,27,10,1
4,386,2,0,17,46,-29,50,5,1
4,304,2,1,46,17,29,17,15,1
4,260,1,1,46,17,29,18,10,1
4,182,2,1,46,17,29,29,6,1
4,104,2,0,17,46,-29,55,10,1
1,189,2,0,0,3,-3,14,8,1
2,746,1,0,3,6,-3,50,20,1
2,415,1,1,12,3,9,2,2,1
2,228,2,1,12,10,2,23,12,1
2,77,2,1,12,10,2,54,3,1
3,753,2,1,19,10,9,15,3,1
3,619,1,0,13,19,-6,34,10,1
3,460,2,0,13,19,-6,33,3,1
3,144,1,0,13,19,-6,17,10,1
3,130,2,0,13,19,-6,17,10,1
4,607,1,0,20,25,-5,35,10,1
4,541,1,1,25,20,5,29,10,1
4,388,2,1,25,20,5,45,5,1
4,229,1,1,25,20,5,38,10,1
4,105,2,0,23,25,-2,26,8,1
4,86,3,0,23,25,-2,26,8,1
1,553,2,1,0,0,0,36,11,1
1,326,1,1,0,7,-7,34,10,1
2,670,1,0,7,3,4,11,10,1
2,167,1,0,7,6,1,44,20,1
2,66,1,1,6,7,-1,48,10,1
2,43,1,0,7,6,1,52,10,1
3,799,1,0,7,6,1,53,10,1
3,645,2,0,7,6,1,4,4,1
3,584,2,0,7,9,-2,40,5,1
3,361,1,1,9,7,2,10,10,1
3,162,2,0,15,9,6,35,6,1
4,773,1,1,12,22,-10,34,10,1
4,666,2,0,22,12,10,43,7,1
4,43,1,0,29,26,3,48,10,1
5,0,1,1,29,29,0,40,15,1
1,322,1,1,0,0,0,40,10,1
1,150,1,1,0,0,0,42,10,1
1,67,1,1,0,0,0,8,8,1
2,900,2,1,0,7,-7,22,6,1
2,810,2,0,7,0,7,45,12,1
2,564,1,0,7,0,7,31,10,1
2,330,2,0,7,14,-7,15,3,1
3,536,2,1,22,14,8,34,5,1
3,428,1,1,22,14,8,49,10,1
3,198,2,0,17,22,-5,46,11,1
3,88,1,1,22,17,5,26,10,1
4,675,1,0,20,22,-2,37,10,1
4,664,2,0,20,22,-2,37,10,1
4,600,1,1,22,20,2,31,10,1
4,514,2,1,22,20,2,46,5,1
4,427,2,0,20,22,-2,43,7,1
4,180,1,0,20,22,-2,34,10,1
4,82,2,0,20,25,-5,42,3,1
4,62,1,0,20,25,-5,46,10,1
4,55,2,0,20,25,-5,46,10,1
4,50,3,0,20,25,-5,46,10,1
1,837,2,0,0,0,0,45,13,1
1,672,1,1,1,0,1,10,10,1
1,575,2,1,1,0,1,43,12,1
1,433,1,0,0,1,-1,34,10,1
1,433,2,0,0,1,-1,34,10,1
2,900,1,0,0,4,-4,50,10,1
2,121,1,0,7,4,3,35,10,1
2,104,2,0,7,4,3,35,10,1
3,775,1,0,10,7,3,45,10,1
3,753,2,0,10,7,3,45,10,1
3,426,1,0,10,14,-4,31,10,1
3,359,1,1,14,10,4,45,10,1
3,327,2,1,14,10,4,45,10,1
3,289,1,1,14,10,4,23,10,1
3,180,1,0,10,14,-4,52,10,1
3,158,2,0,10,14,-4,52,10,1
3,53,1,0,10,14,-4,34,20,1
3,21,1,1,14,10,4,53,10,1
4,830,1,1,14,10,4,29,10,1
4,812,2,1,14,10,4,29,10,1
4,375,1,0,13,14,-1,20,10,1
4,354,2,0,13,14,-1,20,10,1
4,158,1,0,13,17,-4,45,10,1
4,29,1,1,17,13,4,43,10,1
1,875,1,0,0,0,0,49,10,1
1,775,2,1,0,0,0,10,9,1
1,562,1,1,0,2,-2,27,10,1
1,525,1,1,0,2,-2,15,10,1
1,390,1,1,0,2,-2,51,10,1
1,309,1,1,0,2,-2,16,10,1
1,285,2,1,0,2,-2,16,10,1
1,225,2,1,0,5,-5,38,7,1
1,188,1,0,5,0,5,26,10,1
1,174,2,0,5,0,5,26,10,1
1,125,1,1,0,5,-5,22,10,1
1,103,2,1,0,5,-5,22,10,1
2,807,1,1,0,5,-5,19,10,1
2,629,1,1,0,5,-5,38,10,1
3,615,1,0,8,6,2,45,20,1
3,597,2,0,8,6,2,45,20,1
3,445,2,1,6,11,-5,35,10,1
4,705,0,1,12,11,1,3,0,1
4,584,0,0,17,12,5,3,0,1
4,463,2,1,12,17,-5,51,9,1
4,394,1,0,17,12,5,41,10,1
4,299,2,1,12,17,-5,32,4,1
1,800,1,0,0,0,0,28,10,1
1,430,2,0,7,0,7,49,6,1
1,206,2,0,7,0,7,29,12,1
2,671,1,0,8,0,8,38,10,1
2,513,2,0,8,0,8,42,7,1
2,458,1,0,8,3,5,35,10,1
2,388,1,1,3,9,-6,35,10,1
2,353,1,1,3,9,-6,50,10,1
2,259,1,0,9,3,6,29,10,1
2,241,2,0,9,3,6,29,10,1
2,170,2,0,9,4,5,37,8,1
2,68,2,0,9,4,5,55,2,1
3,752,1,1,4,17,-13,50,10,1
3,557,1,0,17,11,6,30,10,1
3,320,2,1,11,17,-6,7,13,1
3,278,1,1,11,20,-9,35,10,1
3,187,2,0,20,11,9,43,5,1
3,1,1,1,11,20,-9,2,2,1
4,763,1,0,27,11,16,45,10,1
4,640,1,0,27,11,16,35,10,1
4,375,1,1,14,27,-13,33,10,1
4,252,1,0,27,14,13,29,10,1
4,70,1,0,27,17,10,16,10,1
4,53,1,0,27,17,10,1,1,1
1,860,2,1,0,1,-1,40,5,1
1,579,2,1,0,8,-8,22,7,1
1,303,1,1,0,16,-16,35,10,1
2,763,2,0,16,8,8,19,5,1
2,695,2,0,16,9,7,35,10,1
2,574,2,0,16,16,0,46,10,1
2,451,1,1,16,16,0,18,10,1
2,303,2,1,16,16,0,38,9,1
2,246,1,1,16,16,0,44,10,1
3,818,2,0,16,16,0,47,8,1
3,665,1,1,16,16,0,38,10,1
3,641,2,1,16,16,0,38,10,1
4,853,2,1,23,22,1,30,6,1
1,895,1,1,0,0,0,27,10,1
1,830,2,1,0,0,0,46,6,1
1,768,1,0,0,0,0,43,10,1
1,750,2,0,0,0,0,43,10,1
1,702,1,1,0,0,0,28,10,1
1,677,2,1,0,0,0,28,10,1
1,282,1,1,0,11,-11,35,10,1
1,215,1,0,11,0,11,54,10,1
1,145,1,0,11,0,11,37,10,1
2,900,1,0,11,8,3,36,10,1
2,645,2,1,8,19,-11,43,3,1
2,345,1,0,19,11,8,35,10,1
2,327,2,0,19,11,8,35,10,1
2,168,1,0,19,11,8,6,6,1
2,133,1,0,19,17,2,29,10,1
2,73,1,1,17,19,-2,51,10,1
2,69,2,1,17,19,-2,51,10,1
2,29,1,0,19,17,2,43,5,1
2,24,2,0,19,17,2,43,5,1
3,868,1,0,19,17,2,23,20,1
3,765,2,1,17,19,-2,52,8,1
3,709,1,1,17,19,-2,4,10,1
3,693,2,1,17,19,-2,4,10,1
3,590,2,1,17,19,-2,16,6,1
3,510,1,1,17,22,-5,35,10,1
3,397,2,0,22,17,5,37,7,1
3,230,1,1,20,22,-2,51,10,1
3,203,2,1,20,22,-2,51,10,1
4,609,1,0,23,20,3,54,10,1
4,602,2,0,23,20,3,54,10,1
4,466,1,0,23,26,-3,24,10,1
4,19,1,0,26,26,0,47,15,1
4,14,2,0,26,26,0,47,15,1
1,894,1,1,0,0,0,24,10,1
1,331,1,1,7,0,7,54,10,1
2,465,2,1,21,7,14,49,11,1
2,328,1,1,21,7,14,29,10,1
2,247,1,0,7,21,-14,25,10,1
2,223,2,0,7,21,-14,25,10,1
2,144,2,1,21,7,14,55,5,1
3,715,2,1,21,7,14,26,11,1
3,635,2,1,21,10,11,36,9,1
3,597,1,0,10,21,-11,30,10,1
3,480,1,1,21,10,11,55,10,1
3,405,3,0,10,21,-11,49,4,1
3,183,2,1,21,18,3,19,6,1
4,840,1,1,21,18,3,39,20,1
4,712,2,1,21,21,0,35,10,1
4,525,1,0,21,21,0,48,10,1
4,380,1,0,21,24,-3,35,10,1
4,188,1,0,27,24,3,35,10,1
4,167,2,0,27,24,3,35,10,1
4,36,2,1,27,30,-3,42,3,1
4,32,3,1,27,30,-3,42,3,1
1,760,2,1,0,0,0,35,12,1
1,513,1,0,0,0,0,6,10,1
1,371,1,0,0,0,0,41,10,1
1,363,2,0,0,0,0,41,10,1
1,49,1,0,3,1,2,54,10,1
1,22,2,0,3,1,2,54,10,1
2,875,2,1,1,3,-2,54,6,1
2,766,1,0,3,1,2,47,10,1
2,630,2,0,3,1,2,28,11,1
2,426,1,1,4,3,1,23,10,1
2,364,1,0,3,4,-1,29,10,1
2,180,2,0,3,4,-1,43,7,1
2,111,2,0,3,4,-1,54,14,1
3,814,1,0,3,4,-1,52,10,1
3,804,2,0,3,4,-1,52,10,1
3,634,1,0,3,4,-1,17,10,1
3,606,2,0,3,4,-1,17,10,1
3,479,2,0,3,4,-1,9,15,1
3,1,1,0,3,18,-15,47,10,1
4,820,2,1,18,3,15,26,7,1
4,740,1,0,3,18,-15,44,10,1
4,649,2,0,3,18,-15,42,6,1
4,455,1,1,25,3,22,44,10,1
4,427,2,1,25,3,22,44,10,1
4,272,1,0,3,32,-29,27,10,1
4,230,2,0,3,32,-29,22,15,1
4,180,2,0,3,32,-29,40,6,1
4,88,1,0,3,32,-29,55,10,1
1,805,2,1,0,0,0,50,3,1
1,522,1,0,0,0,0,22,10,1
1,508,2,0,0,0,0,22,10,1
1,271,1,1,3,7,-4,32,10,1
2,900,2,1,3,7,-4,36,11,1
2,654,1,0,10,3,7,23,10,1
2,607,2,0,10,3,7,33,20,1
2,383,1,1,6,10,-4,32,10,1
2,205,1,1,6,11,-5,49,10,1
2,186,2,1,6,11,-5,49,10,1
2,98,2,1,6,11,-5,14,2,1
2,80,1,1,6,14,-8,35,10,1
2,63,1,0,14,6,8,49,10,1
2,1,2,0,14,14,0,45,13,1
3,843,1,0,14,14,0,51,10,1
3,513,2,1,21,14,7,42,6,1
4,882,2,1,21,17,4,18,18,1
4,488,1,1,21,20,1,18,15,1
4,390,1,1,21,28,-7,21,10,1
4,64,3,1,21,31,-10,44,1,1
1,492,2,1,7,0,7,41,5,1
1,354,2,1,7,3,4,45,2,1
1,261,2,0,3,7,-4,15,7,1
1,115,2,0,3,7,-4,30,18,1
2,878,2,1,7,3,4,34,9,1
2,574,2,0,6,7,-1,37,8,1
2,325,2,1,7,6,1,52,6,1
2,280,1,0,6,7,-1,8,10,1
2,103,2,1,7,13,-6,38,15,1
2,54,2,0,13,7,6,36,18,1
3,437,2,0,15,10,5,19,8,1
3,302,2,1,10,15,-5,40,19,1
3,238,1,1,10,15,-5,46,10,1
3,1,1,1,10,15,-5,34,10,1
4,900,2,1,10,15,-5,34,10,1
4,635,1,1,10,18,-8,25,10,1
4,535,2,0,18,10,8,42,7,1
4,180,2,0,18,13,5,33,5,1
4,134,2,0,18,13,5,50,3,1
1,900,0,1,0,0,0,35,0,5
1,106,0,0,0,3,-3,35,0,5
2,97,0,1,3,14,-11,35,0,5
3,900,0,0,14,3,11,35,0,5
3,633,0,1,3,17,-14,35,0,5
3,213,0,0,17,6,11,35,0,5
4,900,0,1,6,24,-18,35,0,5
1,900,0,1,0,0,0,35,0,5
1,745,0,0,0,7,-7,35,0,5
1,392,0,1,7,3,4,35,0,5
1,15,0,1,7,6,1,35,0,5
2,743,0,1,7,13,-6,35,0,5
2,535,0,1,7,16,-9,35,0,5
2,15,0,1,10,23,-13,35,0,5
3,900,0,0,23,10,13,35,0,5
3,590,0,1,12,23,-11,25,0,5
4,800,0,1,12,33,-21,30,0,5
4,716,0,0,33,19,14,35,0,5
4,255,0,0,33,26,7,35,0,5
1,900,0,1,0,0,0,35,0,5
1,498,0,0,0,7,-7,35,0,5
2,478,0,1,7,7,0,35,0,5
2,431,0,0,7,14,-7,35,0,5
2,7,0,0,9,14,-5,25,0,5
3,900,0,0,9,14,-5,35,0,5
3,554,0,0,9,21,-12,35,0,5
3,241,0,1,21,16,5,35,0,5
4,579,0,1,22,19,3,35,0,5
4,337,0,0,19,29,-10,35,0,5
4,25,0,1,29,26,3,35,0,5
1,515,0,1,0,3,-3,35,0,5
1,165,0,0,3,7,-4,35,0,5
1,53,0,1,7,10,-3,35,0,5
3,900,0,0,11,14,-3,35,0,5
3,299,0,1,14,14,0,35,0,5
3,63,0,0,14,21,-7,35,0,5
4,54,0,1,24,24,0,35,0,5
4,24,0,1,24,31,-7,35,0,5
1,900,0,0,0,0,0,35,0,5
1,379,0,0,2,0,2,25,0,5
1,28,0,0,2,7,-5,35,0,5
2,586,0,1,7,10,-3,35,0,5
2,121,0,1,7,17,-10,35,0,5
2,90,0,0,17,14,3,35,0,5
3,900,0,1,14,18,-4,35,0,5
3,647,0,0,18,21,-3,35,0,5
4,785,0,0,18,31,-13,35,0,5
4,662,0,1,31,25,6,35,0,5
4,324,0,0,25,38,-13,35,0,5
4,127,0,0,25,48,-23,35,0,5
1,900,0,1,0,0,0,35,0,5
1,351,0,0,0,3,-3,35,0,5
2,900,0,1,3,7,-4,35,0,5
2,680,0,0,7,10,-3,35,0,5
2,73,0,0,7,17,-10,35,0,5
2,73,0,1,17,14,3,35,0,5
3,900,0,0,17,17,0,35,0,5
4,775,0,1,17,26,-9,35,0,5
4,189,0,0,26,27,-1,35,0,5
4,73,0,1,27,29,-2,35,0,5
1,900,0,1,0,0,0,35,0,5
3,900,0,0,7,17,-10,35,0,5
3,291,0,0,7,30,-23,35,0,5
4,642,0,0,7,37,-30,35,0,5
4,466,0,1,37,13,24,25,0,5
4,251,0,1,37,20,17,35,0,5
4,178,0,1,37,27,10,35,0,5
4,137,0,1,37,34,3,35,0,5
1,893,0,1,0,0,0,30,0,5
1,286,0,0,0,8,-8,35,0,5
2,683,0,1,8,3,5,35,0,5
2,358,0,1,8,10,-2,35,0,5
2,89,0,1,8,17,-9,50,0,5
3,900,0,0,17,8,9,35,0,5
1,900,0,0,0,0,0,35,0,5
1,349,0,1,2,0,2,25,0,5
1,10,0,1,2,7,-5,35,0,5
2,653,0,0,7,9,-2,35,0,5
3,900,0,1,9,10,-1,35,0,5
3,529,0,1,10,17,-7,35,0,5
3,191,0,0,17,17,0,35,0,5
4,151,0,0,20,24,-4,35,0,5
1,900,0,1,0,0,0,35,0,5
1,663,0,1,0,7,-7,35,0,5
2,460,0,0,7,8,-1,35,0,5
3,900,0,0,10,9,1,35,0,5
1,900,0,0,0,0,0,35,0,5
1,528,0,0,0,3,-3,35,0,5
1,127,0,0,2,3,-1,25,0,5
2,861,0,1,3,5,-2,35,0,5
2,704,0,0,5,10,-5,35,0,5
2,375,0,0,5,17,-12,35,0,5
3,900,0,1,17,8,9,35,0,5
3,742,0,0,8,24,-16,35,0,5
3,673,0,0,8,31,-23,35,0,5
3,473,0,0,8,34,-26,35,0,5
4,845,0,1,34,15,19,35,0,5
4,536,0,1,34,22,12,35,0,5
4,117,0,1,37,29,8,35,0,5
1,900,0,0,0,0,0,35,0,5
1,185,0,0,1,10,-9,35,0,5
2,118,0,1,13,5,8,35,0,5
3,900,0,0,5,16,-11,35,0,5
3,411,0,0,8,23,-15,35,0,5
3,312,0,1,23,15,8,35,0,5
3,212,0,1,23,21,2,35,0,5
3,81,0,1,23,28,-5,35,0,5
4,878,0,0,28,30,-2,35,0,5
4,77,0,1,30,37,-7,35,0,5
1,900,0,0,0,0,0,35,0,5
1,418,0,0,0,7,-7,35,0,5
2,900,0,0,0,14,-14,35,0,5
3,900,0,1,35,0,35,35,0,5
4,305,0,0,0,51,-51,35,0,5
1,900,0,1,0,0,0,35,0,5
1,506,0,1,0,3,-3,35,0,5
1,493,0,0,3,7,-4,35,0,5
3,900,0,0,12,10,2,35,0,5
3,594,0,0,12,17,-5,35,0,5
1,705,0,0,0,7,-7,35,0,5
1,117,0,1,7,10,-3,35,0,5
3,900,0,1,7,14,-7,35,0,5
3,700,0,1,9,14,-5,25,0,5
3,261,0,0,14,23,-9,35,0,5
4,842,0,1,23,21,2,35,0,5
1,900,0,0,0,0,0,35,0,5
1,770,0,1,0,7,-7,35,0,5
1,508,0,0,7,3,4,35,0,5
2,546,0,0,8,13,-5,40,0,5
2,17,0,1,13,15,-2,35,0,5
3,900,0,1,13,15,-2,35,0,5
3,470,0,1,13,22,-9,45,0,5
4,78,0,0,22,26,-4,35,0,5
1,900,0,0,0,0,0,35,0,5
1,589,0,0,0,7,-7,35,0,5
1,89,0,1,8,7,1,35,0,5
2,593,0,1,8,14,-6,35,0,5
3,497,0,0,17,15,2,35,0,5
3,299,0,1,15,20,-5,35,0,5
4,701,0,1,15,27,-12,35,0,5
4,583,0,0,27,22,5,35,0,5
1,900,0,1,0,0,0,35,0,5
1,553,0,0,0,7,-7,35,0,5
1,83,0,0,0,17,-17,35,0,5
2,58,0,0,3,24,-21,35,0,5
3,900,0,0,3,24,-21,35,0,5
1,900,0,0,0,0,0,35,0,5
1,699,0,1,0,7,-7,35,0,5
1,598,0,1,0,14,-14,35,0,5
1,463,0,0,14,3,11,35,0,5
1,103,0,0,14,10,4,50,0,5
2,595,0,1,11,17,-6,35,0,5
2,487,0,1,11,20,-9,35,0,5
2,242,0,1,13,20,-7,25,0,5
3,900,0,1,13,23,-10,35,0,5
3,808,0,0,23,20,3,35,0,5
3,692,0,0,23,27,-4,35,0,5
4,617,0,1,33,31,2,35,0,5
1,900,0,0,0,0,0,35,0,5
1,613,0,1,0,8,-8,35,0,5
2,344,0,0,11,10,1,35,0,5
2,144,0,0,11,20,-9,35,0,5
3,900,0,1,20,12,8,35,0,5
4,630,0,1,23,23,0,35,0,5
4,467,0,1,23,30,-7,35,0,5
4,14,0,0,31,29,2,35,0,5
1,900,0,1,0,0,0,35,0,5
1,714,0,0,0,7,-7,35,0,5
1,698,0,1,7,7,0,40,0,5
1,254,0,1,8,14,-6,35,0,5
1,50,0,1,8,21,-13,35,0,5
2,527,0,1,15,24,-9,35,0,5
2,478,0,0,24,22,2,35,0,5
2,192,0,0,24,25,-1,35,0,5
2,72,0,1,25,31,-6,30,0,5
3,900,0,0,31,25,6,35,0,5
3,593,0,0,34,32,2,35,0,5
4,301,0,0,34,39,-5,35,0,5
1,900,0,1,0,0,0,35,0,5
1,755,0,1,2,0,2,25,0,5
2,167,0,0,0,15,-15,35,0,5
3,900,0,0,0,15,-15,35,0,5
3,168,0,1,15,7,8,35,0,5
4,900,0,0,7,22,-15,35,0,5
4,509,0,0,7,29,-22,35,0,5
4,400,0,1,29,14,15,25,0,5
4,154,0,0,14,36,-22,25,0,5
1,900,0,1,0,0,0,35,0,5
1,570,0,0,0,7,-7,35,0,5
1,198,0,0,0,14,-14,35,0,5
1,131,0,1,16,0,16,25,0,5
2,579,0,1,16,6,10,35,0,5
2,356,0,0,6,23,-17,35,0,5
2,100,0,0,6,31,-25,35,0,5
3,900,0,0,6,31,-25,35,0,5
3,625,0,1,31,13,18,35,0,5
3,117,0,0,21,38,-17,35,0,5
4,1,0,1,44,32,12,35,0,5
1,900,0,1,0,0,0,35,0,5
1,572,0,0,0,7,-7,35,0,5
2,23,0,1,20,11,9,35,0,5
3,900,0,0,11,20,-9,35,0,5
3,856,0,0,11,27,-16,35,0,5
4,335,0,1,27,24,3,35,0,5
4,23,0,1,27,27,0,35,0,5
1,900,0,0,0,0,0,35,0,5
1,609,0,1,0,7,-7,35,0,5
1,49,0,1,0,14,-14,35,0,5
3,582,0,1,1,36,-35,35,0,5
3,469,0,0,36,4,32,35,0,5
3,156,0,1,6,36,-30,25,0,5
4,367,0,0,39,12,27,45,0,5
1,900,0,0,0,0,0,35,0,5
2,754,0,1,3,7,-4,35,0,5
3,900,0,1,3,8,-5,35,0,5
4,349,0,1,4,16,-12,35,0,5
4,130,0,0,16,11,5,35,0,5
1,900,0,0,0,0,0,35,0,5
1,360,0,0,0,7,-7,35,0,5
2,294,0,1,13,3,10,35,0,5
3,900,0,1,14,3,11,35,0,5
3,7,0,1,17,6,11,35,0,5
4,733,0,1,17,9,8,35,0,5
4,254,0,0,9,24,-15,35,0,5
1,701,0,1,0,7,-7,35,0,5
2,863,0,1,3,14,-11,35,0,5
2,540,0,0,14,11,3,35,0,5
2,14,0,1,14,21,-7,35,0,5
3,900,0,1,14,21,-7,35,0,5
4,777,0,0,21,28,-7,35,0,5
4,308,0,0,21,35,-14,35,0,5
1,900,0,0,0,0,0,35,0,5
1,570,0,0,9,0,9,25,0,5
1,391,0,1,0,16,-16,35,0,5
1,226,0,0,16,7,9,35,0,5
3,900,0,1,13,16,-3,35,0,5
3,456,0,1,13,23,-10,50,0,5
4,567,0,1,13,30,-17,35,0,5
4,382,0,0,30,20,10,35,0,5
1,900,0,0,0,0,0,35,0,5
1,346,0,0,0,3,-3,35,0,5
1,72,0,1,3,7,-4,35,0,5
2,863,0,0,7,10,-3,35,0,5
2,145,0,1,10,10,0,35,0,5
3,900,0,0,10,13,-3,35,0,5
3,656,0,1,13,16,-3,35,0,5
4,875,0,1,15,19,-4,25,0,5
4,634,0,0,19,22,-3,35,0,5
4,28,0,1,28,26,2,35,0,5
1,900,0,1,0,0,0,35,0,5
1,673,0,0,0,3,-3,35,0,5
1,143,0,1,4,7,-3,35,0,5
2,900,0,0,7,11,-4,35,0,5
2,441,0,1,11,14,-3,35,0,5
3,900,0,0,21,14,7,35,0,5
3,473,0,1,14,29,-15,35,0,5
4,599,0,0,32,21,11,35,0,5
4,135,0,1,21,39,-18,35,0,5
4,23,0,0,39,28,11,35,0,5
1,900,0,1,0,0,0,35,0,5
1,660,0,1,0,7,-7,35,0,5
1,297,0,0,7,10,-3,35,0,5
2,530,0,0,8,18,-10,35,0,5
2,330,0,1,18,15,3,35,0,5
3,900,0,1,18,15,3,35,0,5
3,761,0,0,15,25,-10,35,0,5
3,619,0,1,25,22,3,35,0,5
3,222,0,1,25,25,0,35,0,5
4,462,0,1,25,32,-7,35,0,5
1,900,0,0,0,0,0,35,0,5
1,420,0,0,0,7,-7,35,0,5
2,222,0,1,7,13,-6,35,0,5
3,900,0,1,7,13,-6,35,0,5
4,213,0,0,19,14,5,35,0,5
1,900,0,1,0,0,0,35,0,5
1,853,0,1,0,7,-7,35,0,5
1,712,0,0,7,7,0,35,0,5
2,336,0,1,7,18,-11,35,0,5
2,222,0,1,7,25,-18,35,0,5
2,62,0,0,33,14,19,35,0,5
3,900,0,0,33,14,19,35,0,5
3,618,0,1,14,40,-26,35,0,5
3,26,0,1,14,47,-33,35,0,5
1,900,0,1,0,0,0,35,0,5
1,758,0,0,0,7,-7,35,0,5
2,797,0,1,9,6,3,35,0,5
4,350,0,0,13,25,-12,50,0,5
1,900,0,1,0,0,0,35,0,5
3,900,0,0,1,3,-2,35,0,5
3,232,0,1,3,15,-12,35,0,5
1,900,0,1,0,0,0,35,0,5
2,829,0,1,1,7,-6,35,0,5
2,717,0,1,1,14,-13,35,0,5
2,32,0,0,17,4,13,35,0,5
3,900,0,0,17,4,13,35,0,5
3,551,0,1,4,20,-16,35,0,5
3,186,0,1,4,27,-23,35,0,5
4,900,0,0,27,11,16,35,0,5
4,780,0,1,11,34,-23,35,0,5
1,900,0,1,0,0,0,35,0,5
1,729,0,0,0,3,-3,35,0,5
1,399,0,1,3,7,-4,35,0,5
2,890,0,0,7,6,1,35,0,5
2,427,0,1,6,14,-8,35,0,5
3,900,0,0,21,6,15,35,0,5
3,631,0,1,6,28,-22,35,0,5
3,319,0,1,6,31,-25,35,0,5
4,93,0,1,11,35,-24,25,0,5
4,29,0,0,35,19,16,35,0,5
1,900,0,1,0,0,0,35,0,5
2,819,0,0,3,1,2,25,0,5
3,91,0,0,4,11,-7,35,0,5
4,704,0,1,11,11,0,35,0,5
4,522,0,0,11,14,-3,35,0,5
1,900,0,0,0,0,0,35,0,5
1,514,0,1,0,7,-7,35,0,5
1,181,0,1,0,17,-17,35,0,5
2,900,0,1,0,24,-24,35,0,5
2,2,0,0,24,19,5,35,0,5
3,900,0,1,19,24,-5,35,0,5
3,278,0,0,24,28,-4,35,0,5
3,56,0,0,24,35,-11,35,0,5
4,246,0,0,27,38,-11,35,0,5
1,900,0,1,0,0,0,35,0,5
1,317,0,1,0,3,-3,35,0,5
2,502,0,0,3,10,-7,35,0,5
2,192,0,1,10,10,0,35,0,5
3,900,0,0,10,10,0,35,0,5
3,670,0,0,10,17,-7,35,0,5
3,299,0,0,10,24,-14,35,0,5
4,885,0,1,24,13,11,35,0,5
4,120,0,0,14,31,-17,35,0,5
4,69,0,1,31,21,10,35,0,5
2,1,0,0,6,9,-3,35,0,5
3,900,0,0,6,9,-3,35,0,5
3,329,0,1,12,13,-1,35,0,5
4,38,0,0,21,22,-1,35,0,5
1,900,0,0,0,0,0,35,0,5
2,218,0,0,0,13,-13,35,0,5
3,900,0,0,0,16,-16,35,0,5
4,900,0,0,0,23,-23,35,0,5
4,752,0,0,0,30,-30,35,0,5
4,338,0,0,0,37,-37,35,0,5
1,900,0,1,0,0,0,35,0,5
1,61,0,0,3,10,-7,35,0,5
2,46,0,0,6,20,-14,35,0,5
3,900,0,0,6,20,-14,35,0,5
3,608,0,1,20,13,7,35,0,5
4,742,0,1,26,20,6,35,0,5
4,668,0,1,26,27,-1,35,0,5
1,900,0,1,0,0,0,35,0,5
1,142,0,1,0,8,-8,35,0,5
2,900,0,0,8,7,1,35,0,5
2,673,0,0,8,14,-6,35,0,5
3,900,0,0,17,14,3,35,0,5
3,566,0,1,14,24,-10,35,0,5
4,886,0,0,27,17,10,35,0,5
4,756,0,1,17,34,-17,35,0,5
4,79,0,0,37,24,13,35,0,5
1,900,0,1,0,0,0,35,0,5
1,472,0,0,0,10,-10,35,0,5
1,108,0,1,10,3,7,35,0,5
2,817,0,0,5,10,-5,25,0,5
2,675,0,1,10,12,-2,35,0,5
2,435,0,0,12,17,-5,35,0,5
2,261,0,1,17,19,-2,35,0,5
2,128,0,1,17,26,-9,35,0,5
3,900,0,0,26,17,9,35,0,5
1,900,0,0,0,0,0,35,0,5
1,468,0,1,0,3,-3,35,0,5
2,776,0,0,3,7,-4,35,0,5
2,513,0,1,7,6,1,35,0,5
2,240,0,0,6,14,-8,35,0,5
3,900,0,1,14,6,8,35,0,5
4,900,0,1,21,12,9,35,0,5
4,56,0,0,12,38,-26,35,0,5
1,900,0,0,0,0,0,35,0,5
1,8,0,0,1,8,-7,35,0,5
2,455,0,0,1,15,-14,35,0,5
3,900,0,0,1,15,-14,4,0,5
3,521,0,0,1,22,-21,35,0,5
3,35,0,1,22,11,11,35,0,5
4,626,0,1,22,19,3,35,0,5
4,180,0,1,22,27,-5,35,0,5
4,40,0,1,22,34,-12,35,0,5
1,900,0,0,0,0,0,35,0,5
1,535,0,0,0,3,-3,35,0,5
2,672,0,0,3,6,-3,35,0,5
2,403,0,1,6,10,-4,35,0,5
3,900,0,1,6,17,-11,35,0,5
3,610,0,1,8,17,-9,25,0,5
3,66,0,0,20,15,5,35,0,5
4,737,0,1,15,27,-12,35,0,5
4,312,0,0,27,22,5,35,0,5
4,83,0,0,30,28,2,35,0,5
1,900,0,0,0,0,0,35,0,5
1,636,0,1,0,7,-7,35,0,5
2,885,0,0,8,3,5,35,0,5
2,466,0,1,3,15,-12,35,0,5
2,118,0,1,3,22,-19,35,0,5
2,32,0,0,22,6,16,35,0,5
3,900,0,1,6,22,-16,35,0,5
3,605,0,0,22,9,13,35,0,5
3,489,0,0,22,16,6,35,0,5
1,900,0,0,0,0,0,35,0,5
1,676,0,0,0,3,-3,35,0,5
1,70,0,1,3,8,-5,35,0,5
2,426,0,0,9,10,-1,35,0,5
2,246,0,0,9,17,-8,50,0,5
2,110,0,1,17,16,1,35,0,5
3,900,0,1,17,16,1,35,0,5
4,636,0,1,19,17,2,25,0,5
4,370,0,0,17,26,-9,35,0,5
1,900,0,0,0,0,0,35,0,5
1,335,0,0,0,3,-3,35,0,5
2,668,0,1,3,7,-4,35,0,5
2,209,0,1,3,15,-12,35,0,5
3,766,0,0,16,10,6,35,0,5
3,621,0,1,10,23,-13,35,0,5
3,6,0,0,25,10,15,25,0,5
4,133,0,0,28,17,11,35,0,5
1,900,0,1,0,0,0,35,0,5
1,812,0,1,0,7,-7,35,0,5
1,391,0,1,0,14,-14,35,0,5
1,229,0,1,0,21,-21,35,0,5
2,207,0,1,0,28,-28,35,0,5
3,900,0,0,31,3,28,35,0,5
4,848,0,0,32,10,22,35,0,5
1,900,0,1,0,0,0,35,0,5
1,722,0,0,0,7,-7,35,0,5
1,323,0,0,0,13,-13,35,0,5
2,585,0,1,16,7,9,35,0,5
2,126,0,0,7,23,-16,20,0,5
3,900,0,0,7,26,-19,35,0,5
3,487,0,1,26,17,9,35,0,5
4,490,0,0,20,35,-15,35,0,5
4,301,0,1,35,27,8,35,0,5
4,154,0,0,27,42,-15,25,0,5
1,900,0,1,0,0,0,35,0,5
1,557,0,1,0,7,-7,35,0,5
1,181,0,1,0,14,-14,35,0,5
2,606,0,1,3,21,-18,35,0,5
2,82,0,1,3,31,-28,35,0,5
3,900,0,0,31,3,28,35,0,5
4,264,0,0,40,17,23,35,0,5
4,180,0,0,40,24,16,35,0,5
4,84,0,1,24,47,-23,35,0,5
1,900,0,0,0,0,0,35,0,5
2,499,0,0,10,7,3,35,0,5
3,48,0,1,7,24,-17,35,0,5
4,704,0,0,24,11,13,35,0,5
4,324,0,1,11,34,-23,35,0,5
4,159,0,0,34,18,16,35,0,5
1,900,0,1,0,0,0,35,0,5
1,397,0,0,0,10,-10,35,0,5
1,278,0,1,10,3,7,35,0,5
1,83,0,0,3,17,-14,35,0,5
2,79,0,0,4,25,-21,35,0,5
3,900,0,0,4,25,-21,35,0,5
3,544,0,0,4,28,-24,35,0,5
3,149,0,0,4,35,-31,35,0,5
3,132,0,1,35,11,24,35,0,5
1,900,0,0,0,0,0,35,0,5
1,542,0,1,0,3,-3,35,0,5
1,373,0,0,3,7,-4,35,0,5
3,900,0,1,8,7,1,35,0,5
3,148,0,1,11,11,0,25,0,5
4,868,0,0,11,14,-3,35,0,5
4,105,0,1,14,21,-7,35,0,5
1,900,0,1,0,0,0,35,0,5
1,221,0,0,0,10,-10,50,0,5
2,807,0,1,13,3,10,35,0,5
2,668,0,0,3,16,-13,35,0,5
2,181,0,0,4,19,-15,35,0,5
2,105,0,1,19,11,8,35,0,5
3,900,0,0,11,19,-8,35,0,5
3,573,0,0,11,26,-15,35,0,5
3,296,0,1,26,18,8,35,0,5
4,478,0,1,26,26,0,35,0,5
4,314,0,0,26,33,-7,35,0,5
4,67,0,0,26,40,-14,35,0,5
1,900,0,1,0,0,0,35,0,5
1,742,0,0,0,7,-7,35,0,5
1,90,0,1,7,7,0,35,0,5
1,73,0,0,7,14,-7,35,0,5
2,403,0,1,14,16,-2,35,0,5
2,163,0,0,16,21,-5,35,0,5
3,900,0,0,16,21,-5,35,0,5
3,220,0,1,21,19,2,35,0,5
1,900,0,0,0,0,0,35,0,5
2,854,0,0,3,7,-4,35,0,5
2,556,0,0,3,14,-11,35,0,5
3,900,0,0,3,14,-11,35,0,5
1,900,0,1,0,0,0,35,0,5
1,697,0,0,0,7,-7,35,0,5
1,487,0,1,7,3,4,25,0,5
2,617,0,0,9,14,-5,35,0,5
2,102,0,1,14,16,-2,35,0,5
3,900,0,0,16,17,-1,35,0,5
3,294,0,1,26,16,10,25,0,5
3,151,0,0,16,33,-17,25,0,5
4,332,0,1,33,23,10,35,0,5
4,1,0,1,36,33,3,35,0,5
1,900,0,0,0,0,0,35,0,5
1,12,0,1,0,10,-10,35,0,5
2,420,0,0,10,7,3,35,0,5
2,129,0,0,10,14,-4,35,0,5
2,89,0,0,10,17,-7,35,0,5
2,9,0,1,17,17,0,35,0,5
3,900,0,1,17,17,0,35,0,5
3,620,0,0,17,20,-3,35,0,5
3,326,0,1,20,24,-4,35,0,5
3,114,0,0,24,23,1,35,0,5
4,665,0,0,24,26,-2,35,0,5
4,482,0,1,26,31,-5,35,0,5
1,900,0,0,0,0,0,35,0,5
1,413,0,0,5,0,5,25,0,5
1,244,0,1,0,12,-12,35,0,5
2,402,0,1,0,15,-15,35,0,5
2,202,0,0,15,7,8,35,0,5
3,900,0,1,7,21,-14,35,0,5
3,823,0,0,21,14,7,35,0,5
3,538,0,0,28,21,7,35,0,5
3,162,0,0,28,24,4,35,0,5
4,431,0,1,27,38,-11,35,0,5
4,397,0,0,38,33,5,35,0,5
1,900,0,0,0,0,0,35,0,5
1,183,0,0,4,7,-3,25,0,5
2,430,0,1,7,14,-7,35,0,5
2,112,0,0,14,14,0,35,0,5
2,76,0,1,14,21,-7,35,0,5
3,900,0,0,21,14,7,11,0,5
4,642,0,1,14,29,-15,35,0,5
1,900,0,0,0,0,0,35,0,5
1,289,0,1,2,1,1,25,0,5
1,36,0,0,1,9,-8,35,0,5
2,435,0,0,1,16,-15,35,0,5
2,79,0,1,16,8,8,35,0,5
3,900,0,1,16,8,8,35,0,5
3,640,0,0,8,23,-15,35,0,5
3,14,0,1,24,11,13,35,0,5
4,480,0,1,24,18,6,35,0,5
1,900,0,0,0,0,0,35,0,5
1,686,0,0,0,7,-7,35,0,5
1,327,0,0,0,10,-10,35,0,5
2,900,0,1,17,0,17,5,0,5
2,440,0,0,0,24,-24,20,0,5
2,126,0,1,24,3,21,35,0,5
3,900,0,1,24,6,18,35,0,5
4,863,0,0,7,27,-20,35,0,5
4,671,0,1,27,14,13,35,0,5
4,128,0,0,14,34,-20,35,0,5
1,900,0,1,0,0,0,35,0,5
2,681,0,0,6,10,-4,35,0,5
3,900,0,0,12,10,2,35,0,5
3,410,0,0,15,17,-2,35,0,5
3,184,0,1,17,22,-5,35,0,5
3,40,0,0,22,24,-2,35,0,5
4,480,0,1,27,29,-2,35,0,5
1,900,0,0,0,0,0,35,0,5
2,716,0,0,3,3,0,35,0,5
2,576,0,1,3,10,-7,35,0,5
2,1,0,0,20,10,10,35,0,5
1,900,0,1,0,0,0,35,0,5
1,699,0,0,0,3,-3,35,0,5
1,548,0,1,3,3,0,35,0,5
1,52,0,1,3,10,-7,35,0,5
2,706,0,1,3,17,-14,35,0,5
3,900,0,1,3,23,-20,35,0,5
3,550,0,0,23,10,13,35,0,5
4,582,0,0,23,17,6,35,0,5
1,900,0,0,0,0,0,35,0,5
1,504,0,1,0,7,-7,35,0,5
1,167,0,0,7,3,4,35,0,5
1,87,0,0,7,10,-3,35,0,5
2,830,0,0,7,13,-6,35,0,5
2,698,0,0,7,20,-13,35,0,5
2,471,0,0,7,27,-20,35,0,5
3,900,0,0,7,31,-24,35,0,5
1,900,0,0,0,0,0,35,0,5
1,406,0,0,0,7,-7,35,0,5
1,183,0,0,0,14,-14,35,0,5
2,32,0,0,3,31,-28,35,0,5
3,900,0,1,31,3,28,35,0,5
4,842,0,0,5,34,-29,25,0,5
1,900,0,1,0,0,0,35,0,5
1,549,0,0,0,7,-7,35,0,5
1,46,0,1,10,7,3,35,0,5
2,796,0,0,7,13,-6,35,0,5
2,527,0,1,13,10,3,35,0,5
2,27,0,0,17,21,-4,35,0,5
3,900,0,0,17,21,-4,35,0,5
4,236,0,1,29,21,8,25,0,5
4,164,0,0,21,36,-15,35,0,5
1,900,0,0,0,0,0,35,0,5
1,852,0,1,0,7,-7,35,0,5
1,462,0,1,0,10,-10,35,0,5
2,887,0,0,12,1,11,25,0,5
2,211,0,0,12,8,4,35,0,5
2,104,0,1,8,15,-7,35,0,5
2,27,0,0,15,15,0,35,0,5
3,900,0,1,15,15,0,35,0,5
3,787,0,0,15,22,-7,35,0,5
4,558,0,0,15,36,-21,35,0,5
4,316,0,1,36,22,14,35,0,5
4,121,0,0,22,43,-21,35,0,5
4,48,0,1,43,29,14,35,0,5
1,900,0,1,0,0,0,35,0,5
1,504,0,1,0,7,-7,35,0,5
1,250,0,1,0,14,-14,35,0,5
2,620,0,0,16,0,16,25,0,5
3,900,0,0,16,3,13,35,0,5
3,531,0,0,16,10,6,35,0,5
3,364,0,1,10,23,-13,35,0,5
4,223,0,0,23,27,-4,35,0,5
1,900,0,1,0,0,0,35,0,5
1,688,0,1,0,3,-3,35,0,5
2,671,0,0,3,10,-7,35,0,5
2,36,0,1,10,15,-5,35,0,5
3,437,0,0,15,19,-4,20,0,5
4,292,0,1,22,25,-3,35,0,5
4,108,0,0,25,29,-4,35,0,5
1,900,0,1,0,0,0,35,0,5
1,674,0,0,0,7,-7,35,0,5
2,756,0,1,10,7,3,35,0,5
2,562,0,1,10,14,-4,35,0,5
4,892,0,1,19,15,4,25,0,5
4,167,0,1,20,23,-3,35,0,5
1,900,0,0,0,0,0,35,0,5
1,550,0,1,0,3,-3,35,0,5
1,92,0,0,3,7,-4,35,0,5
2,517,0,0,4,10,-6,35,0,5
2,165,0,0,4,17,-13,35,0,5
3,900,0,1,17,4,13,35,0,5
3,201,0,1,17,7,10,35,0,5
1,900,0,1,0,0,0,35,0,5
1,478,0,0,0,3,-3,35,0,5
1,76,0,1,3,3,0,35,0,5
2,719,0,0,3,6,-3,30,0,5
2,358,0,1,6,10,-4,35,0,5
2,43,0,1,6,17,-11,50,0,5
3,900,0,0,17,6,11,35,0,5
3,567,0,1,6,27,-21,50,0,5
4,236,0,1,7,37,-30,35,0,5
1,900,0,0,0,0,0,35,0,5
1,382,0,1,0,10,-10,35,0,5
2,237,0,0,10,10,0,35,0,5
3,900,0,1,10,13,-3,35,0,5
3,98,0,0,16,20,-4,35,0,5
4,900,0,1,20,23,-3,35,0,5
4,625,0,0,23,23,0,35,0,5
4,66,0,1,26,30,-4,35,0,5
1,900,0,0,0,0,0,35,0,5
3,900,0,1,0,2,-2,35,0,5
3,252,0,1,6,9,-3,35,0,5
4,64,0,0,10,13,-3,35,0,5
1,900,0,1,0,0,0,35,0,5
2,872,0,1,3,7,-4,25,0,5
2,786,0,0,7,6,1,35,0,5
2,266,0,1,6,14,-8,35,0,5
2,161,0,0,14,13,1,35,0,5
3,900,0,0,17,16,1,35,0,5
3,616,0,1,16,24,-8,35,0,5
4,782,0,0,25,23,2,35,0,5
1,900,0,1,0,0,0,35,0,5
1,160,0,1,3,7,-4,35,0,5
2,520,0,1,6,14,-8,35,0,5
2,163,0,1,6,22,-16,35,0,5
3,900,0,1,6,22,-16,35,0,5
3,563,0,0,22,13,9,35,0,5
4,72,0,1,13,35,-22,35,0,5
1,900,0,1,0,0,0,35,0,5
1,696,0,1,0,3,-3,35,0,5
1,467,0,0,3,7,-4,35,0,5
1,29,0,1,7,10,-3,35,0,5
2,790,0,0,10,14,-4,25,0,5
2,403,0,0,10,21,-11,35,0,5
2,24,0,1,24,17,7,35,0,5
3,892,0,0,17,24,-7,30,0,5
1,900,0,0,0,0,0,35,0,5
1,398,0,0,3,7,-4,35,0,5
2,529,0,0,3,17,-14,35,0,5
2,322,0,0,3,24,-21,35,0,5
2,116,0,0,6,31,-25,35,0,5
3,900,0,0,6,31,-25,35,0,5
4,228,0,0,16,45,-29,35,0,5
4,116,0,1,45,23,22,35,0,5
1,900,0,1,0,0,0,35,0,5
1,528,0,0,0,3,-3,35,0,5
1,194,0,1,3,7,-4,35,0,5
2,702,0,1,3,14,-11,35,0,5
2,383,0,0,14,10,4,35,0,5
2,174,0,0,14,13,1,35,0,5
3,900,0,0,14,13,1,35,0,5
3,22,0,1,13,17,-4,35,0,5
4,406,0,1,16,24,-8,35,0,5
4,142,0,0,24,22,2,35,0,5
1,900,0,0,0,0,0,35,0,5
1,338,0,0,0,7,-7,35,0,5
3,900,0,1,10,4,6,35,0,5
4,163,0,1,11,11,0,35,0,5
1,900,0,0,0,0,0,35,0,5
1,309,0,1,0,7,-7,35,0,5
2,900,0,0,7,7,0,35,0,5
2,280,0,1,7,10,-3,35,0,5
3,900,0,1,7,17,-10,35,0,5
3,488,0,0,20,14,6,40,0,5
3,130,0,0,20,21,-1,35,0,5
4,316,0,0,23,28,-5,35,0,5
1,900,0,0,0,0,0,35,0,5
1,785,0,0,0,7,-7,35,0,5
1,231,0,0,0,10,-10,35,0,5
1,58,0,1,10,7,3,35,0,5
2,544,0,1,10,14,-4,35,0,5
3,900,0,0,14,10,4,35,0,5
3,622,0,1,10,21,-11,35,0,5
3,115,0,0,21,17,4,35,0,5
1,900,0,1,0,0,0,35,0,5
1,742,0,0,0,7,-7,35,0,5
1,17,0,0,0,14,-14,35,0,5
2,698,0,1,14,3,11,35,0,5
2,398,0,0,3,17,-14,35,0,5
2,27,0,1,17,7,10,35,0,5
3,900,0,0,7,17,-10,35,0,5
3,599,0,1,17,10,7,35,0,5
3,190,0,1,17,17,0,35,0,5
4,445,0,1,17,20,-3,35,0,5
1,900,0,1,0,0,0,35,0,5
1,365,0,0,3,7,-4,35,0,5
1,189,0,0,3,14,-11,35,0,5
2,593,0,0,6,21,-15,35,0,5
2,54,0,1,21,13,8,35,0,5
3,900,0,0,13,21,-8,35,0,5
3,538,0,0,13,28,-15,35,0,5
3,118,0,0,13,35,-22,35,0,5
4,341,0,1,35,23,12,35,0,5
1,900,0,0,0,0,0,35,0,5
1,147,0,1,1,7,-6,35,0,5
2,845,0,1,4,14,-10,35,0,5
2,82,0,0,15,7,8,35,0,5
2,7,0,1,7,22,-15,35,0,5
3,900,0,1,7,22,-15,35,0,5
3,363,0,0,23,10,13,35,0,5
1,900,0,0,0,0,0,35,0,5
2,874,0,0,0,7,-7,35,0,5
2,460,0,0,0,14,-14,35,0,5
3,900,0,0,2,14,-12,35,0,5
3,748,0,1,14,9,5,35,0,5
3,514,0,1,14,16,-2,35,0,5
1,900,0,0,0,0,0,35,0,5
1,607,0,0,0,7,-7,35,0,5
1,489,0,0,0,14,-14,35,0,5
2,594,0,1,18,3,15,35,0,5
2,356,0,1,18,10,8,35,0,5
2,169,0,0,10,21,-11,35,0,5
3,900,0,1,21,13,8,35,0,5
3,609,0,0,13,24,-11,35,0,5
3,169,0,0,13,31,-18,35,0,5
1,900,0,1,0,0,0,35,0,5
1,677,0,0,0,7,-7,35,0,5
1,227,0,0,0,14,-14,35,0,5
2,174,0,0,0,24,-24,35,0,5
2,126,0,1,24,7,17,35,0,5
3,900,0,0,7,24,-17,35,0,5
3,642,0,0,7,31,-24,35,0,5
3,346,0,1,31,14,17,35,0,5
4,202,0,1,45,21,24,35,0,5
1,900,0,1,0,0,0,35,0,5
2,900,0,0,0,11,-11,35,0,5
3,900,0,1,11,0,11,20,0,5
4,795,0,0,1,22,-21,35,0,5
4,446,0,0,1,29,-28,35,0,5
1,900,0,1,0,0,0,35,0,5
1,782,0,0,0,7,-7,35,0,5
1,370,0,1,7,7,0,35,0,5
1,46,0,0,7,14,-7,35,0,5
2,733,0,1,14,10,4,35,0,5
2,449,0,1,14,13,1,35,0,5
3,894,0,0,13,17,-4,40,0,5
4,900,0,1,17,20,-3,35,0,5
4,560,0,1,17,27,-10,35,0,5
1,900,0,1,0,0,0,35,0,5
1,273,0,1,12,0,12,25,0,5
2,819,0,0,0,19,-19,35,0,5
2,581,0,1,21,0,21,25,0,5
3,496,0,0,1,31,-30,35,0,5
4,421,0,1,31,10,21,45,0,5
1,900,0,1,0,0,0,35,0,5
1,648,0,1,0,7,-7,40,0,5
1,481,0,1,0,14,-14,35,0,5
2,900,0,1,7,21,-14,35,0,5
3,900,0,0,21,17,4,35,0,5
4,652,0,1,20,28,-8,35,0,5
1,900,0,1,0,0,0,35,0,5
1,437,0,0,0,7,-7,35,0,5
1,74,0,0,0,14,-14,35,0,5
2,14,0,0,0,20,-20,35,0,5
3,900,0,0,0,20,-20,35,0,5
3,559,0,1,20,3,17,35,0,5
4,80,0,1,24,9,15,35,0,5
1,900,0,0,0,0,0,35,0,5
1,458,0,0,0,7,-7,35,0,5
1,119,0,1,7,7,0,35,0,5
3,900,0,1,10,10,0,35,0,5
3,685,0,1,10,17,-7,35,0,5
4,695,0,1,13,24,-11,35,0,5
4,518,0,0,24,21,3,20,0,5
1,900,0,1,0,0,0,35,0,5
1,571,0,0,0,7,-7,35,0,5
2,680,0,0,0,17,-17,35,0,5
3,900,0,0,1,17,-16,23,0,5
3,563,0,0,1,24,-23,35,0,5
3,269,0,1,25,8,17,35,0,5
4,485,0,0,15,34,-19,35,0,5
4,142,0,0,15,48,-33,35,0,5
1,900,0,0,0,0,0,35,0,5
1,707,0,1,0,3,-3,35,0,5
1,571,0,0,3,7,-4,35,0,5
1,348,0,1,7,10,-3,35,0,5
2,887,0,0,10,10,0,35,0,5
2,246,0,1,10,16,-6,35,0,5
3,900,0,1,13,19,-6,35,0,5
3,349,0,1,20,22,-2,40,0,5
4,648,0,0,22,30,-8,35,0,5
4,494,0,1,30,28,2,35,0,5
4,28,0,1,33,34,-1,35,0,5
1,900,0,0,0,0,0,35,0,5
3,900,0,1,2,7,-5,35,0,5
4,540,0,0,8,25,-17,35,0,5
1,900,0,1,0,0,0,35,0,5
2,900,0,1,6,10,-4,35,0,5
2,578,0,1,6,17,-11,35,0,5
3,900,0,0,17,9,8,35,0,5
3,656,0,1,9,24,-15,35,0,5
3,289,0,1,12,31,-19,35,0,5
1,900,0,0,0,0,0,35,0,5
1,10,0,1,0,11,-11,35,0,5
2,411,0,0,11,6,5,35,0,5
2,151,0,0,11,13,-2,35,0,5
3,900,0,0,14,13,1,35,0,5
3,176,0,0,16,13,3,25,0,5
4,331,0,1,13,26,-13,35,0,5
1,900,0,1,0,0,0,35,0,5
1,499,0,1,0,7,-7,25,0,5
3,900,0,0,13,3,10,35,0,5
1,900,0,0,0,0,0,35,0,5
1,587,0,1,0,3,-3,35,0,5
1,260,0,0,3,3,0,35,0,5
2,401,0,1,6,7,-1,35,0,5
4,840,0,1,12,14,-2,35,0,5
2,476,0,0,4,7,-3,35,0,5
3,900,0,0,4,7,-3,35,0,5
1,900,0,1,0,0,0,35,0,5
1,705,0,0,0,3,-3,35,0,5
1,471,0,0,0,10,-10,35,0,5
1,253,0,1,10,3,7,35,0,5
2,89,0,0,3,20,-17,35,0,5
3,900,0,0,3,20,-17,35,0,5
3,400,0,0,3,27,-24,35,0,5
4,820,0,0,3,34,-31,35,0,5
4,690,0,0,3,41,-38,35,0,5
4,262,0,0,5,41,-36,25,0,5
1,900,0,0,0,0,0,35,0,5
1,610,0,0,3,3,0,35,0,5
1,351,0,1,3,10,-7,35,0,5
2,869,0,0,10,10,0,35,0,5
2,170,0,1,10,13,-3,35,0,5
2,10,0,1,13,20,-7,35,0,5
3,506,0,0,20,20,0,35,0,5
1,900,0,0,0,0,0,35,0,5
1,136,0,1,0,6,-6,35,0,5
2,612,0,1,0,9,-9,35,0,5
2,203,0,0,9,3,6,35,0,5
3,900,0,1,6,9,-3,35,0,5
1,900,0,1,0,0,0,35,0,5
1,426,0,1,7,7,0,35,0,5
1,309,0,0,7,14,-7,35,0,5
3,900,0,0,17,20,-3,35,0,5
4,304,0,0,23,30,-7,35,0,5
1,900,0,0,0,0,0,35,0,5
1,744,0,0,0,7,-7,35,0,5
2,209,0,0,6,21,-15,35,0,5
2,99,0,0,6,28,-22,35,0,5
3,900,0,1,28,6,22,35,0,5
4,728,0,0,9,34,-25,35,0,5
1,900,0,0,0,0,0,35,0,5
2,835,0,0,6,6,0,35,0,5
2,107,0,1,6,13,-7,35,0,5
3,722,0,1,6,20,-14,35,0,5
3,487,0,0,20,13,7,35,0,5
4,874,0,0,20,20,0,35,0,5
4,748,0,0,20,27,-7,35,0,5
4,667,0,1,29,20,9,25,0,5
1,900,0,1,0,0,0,35,0,5
1,419,0,0,0,4,-4,35,0,5
2,893,0,1,4,3,1,30,0,5
2,44,0,1,5,10,-5,35,0,5
3,900,0,0,10,5,5,35,0,5
3,703,0,1,5,17,-12,35,0,5
4,760,0,0,19,5,14,25,0,5
4,606,0,0,21,5,16,25,0,5
4,93,0,1,5,31,-26,35,0,5
1,900,0,1,0,0,0,35,0,5
1,362,0,1,0,7,-7,20,0,5
1,163,0,0,7,7,0,35,0,5
2,346,0,0,10,14,-4,35,0,5
2,122,0,0,10,21,-11,35,0,5
3,900,0,0,10,21,-11,35,0,5
3,194,0,1,21,13,8,35,0,5
4,581,0,1,21,19,2,35,0,5
4,92,0,1,24,25,-1,35,0,5
1,900,0,1,0,0,0,35,0,5
1,277,0,1,0,17,-17,35,0,5
1,102,0,1,0,24,-24,35,0,5
2,296,0,0,32,7,25,35,0,5
3,900,0,1,7,32,-25,35,0,5
1,900,0,1,0,0,0,35,0,5
3,900,0,0,3,10,-7,35,0,5
4,885,0,1,10,13,-3,35,0,5
1,900,0,1,0,0,0,35,0,5
1,722,0,1,0,7,-7,35,0,5
1,374,0,1,1,10,-9,35,0,5
1,42,0,0,10,5,5,35,0,5
2,600,0,1,8,17,-9,35,0,5
2,157,0,1,8,27,-19,35,0,5
4,30,0,0,33,23,10,35,0,5
1,900,0,1,0,0,0,35,0,5
1,420,0,0,0,10,-10,35,0,5
1,313,0,1,10,3,7,35,0,5
2,900,0,0,3,17,-14,35,0,5
2,724,0,1,17,6,11,35,0,5
3,900,0,0,19,17,2,35,0,5
3,289,0,0,19,27,-8,35,0,5
3,94,0,1,27,26,1,35,0,5
1,900,0,0,0,0,0,35,0,5
1,415,0,0,0,7,-7,35,0,5
2,150,0,0,0,21,-21,35,0,5
2,96,0,1,21,7,14,35,0,5
3,900,0,1,28,7,21,35,0,5
1,900,0,1,0,0,0,35,0,5
2,700,0,0,7,7,0,35,0,5
2,233,0,1,7,14,-7,35,0,5
2,81,0,0,14,14,0,35,0,5
2,3,0,0,14,21,-7,35,0,5
4,823,0,0,21,28,-7,35,0,5
4,184,0,0,21,38,-17,35,0,5
1,900,0,1,0,0,0,35,0,5
3,900,0,0,4,8,-4,35,0,5
1,900,0,1,0,0,0,35,0,5
1,404,0,1,0,7,-7,35,0,5
1,290,0,0,7,7,0,35,0,5
1,89,0,1,7,10,-3,35,0,5
2,169,0,1,7,17,-10,35,0,5
3,900,0,0,17,7,10,35,0,5
3,375,0,1,7,20,-13,35,0,5
4,872,0,0,20,17,3,35,0,5
4,349,0,0,23,20,3,35,0,5
4,33,0,1,20,30,-10,35,0,5
1,900,0,1,0,0,0,35,0,5
2,571,0,0,1,4,-3,35,0,5
3,900,0,0,4,4,0,35,0,5
4,864,0,0,4,12,-8,35,0,5
4,194,0,1,12,11,1,35,0,5
1,900,0,0,0,0,0,35,0,5
1,487,0,1,0,7,-7,35,0,5
2,434,0,0,10,6,4,35,0,5
3,900,0,1,9,13,-4,35,0,5
4,869,0,0,13,17,-4,35,0,5
4,570,0,1,17,19,-2,35,0,5
4,368,0,1,17,26,-9,35,0,5
4,116,0,1,17,33,-16,50,0,5
1,900,0,1,0,0,0,35,0,5
2,353,0,1,1,3,-2,35,0,5
3,900,0,0,6,1,5,35,0,5
3,822,0,0,6,8,-2,35,0,5
3,82,0,1,8,13,-5,35,0,5
4,258,0,1,14,16,-2,35,0,5
4,128,0,0,16,21,-5,35,0,5
1,900,0,0,0,0,0,35,0,5
1,179,0,1,0,7,-7,35,0,5
1,79,0,0,7,7,0,35,0,5
2,690,0,0,7,14,-7,35,0,5
2,366,0,0,7,24,-17,35,0,5
2,62,0,0,7,31,-24,45,0,5
3,900,0,1,31,10,21,35,0,5
3,190,0,1,31,23,8,35,0,5
4,12,0,0,27,41,-14,35,0,5
1,900,0,0,0,0,0,35,0,5
1,789,0,0,0,7,-7,35,0,5
3,900,0,1,7,8,-1,45,0,5
4,362,0,1,7,18,-11,35,0,5
4,252,0,1,7,25,-18,35,0,5
4,130,0,1,7,32,-25,35,0,5
1,900,0,1,0,0,0,35,0,5
1,753,0,0,0,3,-3,35,0,5
1,632,0,0,0,10,-10,35,0,5
2,879,0,1,10,3,7,40,0,5
2,151,0,1,13,6,7,35,0,5
4,900,0,1,16,19,-3,35,0,5
1,900,0,0,0,0,0,35,0,5
1,704,0,1,0,3,-3,35,0,5
1,100,0,0,3,7,-4,35,0,5
4,366,0,1,13,10,3,35,0,5
4,290,0,0,10,20,-10,25,0,5
1,900,0,0,0,0,0,35,0,5
1,450,0,1,0,7,-7,35,0,5
2,719,0,1,2,7,-5,25,0,5
2,468,0,1,4,7,-3,25,0,5
3,900,0,0,7,14,-7,35,0,5
3,505,0,0,7,21,-14,35,0,5
3,259,0,1,21,14,7,35,0,5
3,158,0,1,21,21,0,35,0,5
4,468,0,1,21,27,-6,35,0,5
4,319,0,0,27,28,-1,35,0,5
4,28,0,0,30,35,-5,35,0,5
1,900,0,0,0,0,0,35,0,5
1,815,0,0,0,3,-3,35,0,5
1,457,0,0,1,10,-9,35,0,5
1,127,0,0,3,10,-7,25,0,5
3,900,0,0,10,13,-3,35,0,5
1,408,0,1,8,7,1,35,0,5
2,503,0,0,7,15,-8,35,0,5
3,900,0,1,15,10,5,35,0,5
4,529,0,0,10,25,-15,35,0,5
2,219,0,1,5,3,2,25,0,5
3,900,0,0,6,5,1,35,0,5
1,900,0,1,0,0,0,35,0,5
1,380,0,1,0,3,-3,35,0,5
2,323,0,1,7,10,-3,35,0,5
2,150,0,1,7,17,-10,35,0,5
3,900,0,0,17,10,7,35,0,5
3,625,0,1,10,24,-14,35,0,5
3,275,0,1,10,31,-21,35,0,5
4,275,0,0,34,20,14,35,0,5
4,154,0,0,34,27,7,35,0,5
4,93,0,1,27,41,-14,35,0,5
4,21,0,0,41,34,7,35,0,5
1,770,0,0,0,7,-7,35,0,5
1,440,0,1,7,3,4,35,0,5
1,389,0,1,7,10,-3,35,0,5
2,900,0,1,7,17,-10,35,0,5
3,900,0,1,7,21,-14,35,0,5
3,492,0,1,10,24,-14,35,0,5
3,255,0,0,24,17,7,35,0,5
4,900,0,0,24,24,0,35,0,5
4,803,0,0,24,31,-7,35,0,5
4,175,0,0,24,38,-14,35,0,5
1,900,0,1,0,0,0,35,0,5
1,108,0,0,1,7,-6,35,0,5
2,491,0,0,10,8,2,25,0,5
2,93,0,1,8,20,-12,35,0,5
3,900,0,1,8,27,-19,35,0,5
3,713,0,0,27,15,12,35,0,5
3,362,0,1,15,30,-15,35,0,5
4,147,0,0,30,24,6,35,0,5
1,900,0,0,0,0,0,35,0,5
1,435,0,1,2,0,2,25,0,5
2,665,0,1,5,3,2,35,0,5
3,900,0,1,6,6,0,35,0,5
3,311,0,1,9,9,0,35,0,5
4,735,0,0,16,19,-3,35,0,5
4,97,0,0,16,33,-17,35,0,5
1,640,0,1,3,7,-4,35,0,5
2,536,0,1,3,22,-19,35,0,5
2,38,0,0,29,10,19,35,0,5
3,484,0,0,32,18,14,40,0,5
4,282,0,0,33,33,0,40,0,5
4,108,0,0,33,40,-7,35,0,5
1,900,0,0,0,0,0,35,0,5
1,128,0,1,0,3,-3,35,0,5
1,11,0,0,3,3,0,35,0,5
2,674,0,0,3,6,-3,35,0,5
2,162,0,1,8,3,5,25,0,5
2,45,0,0,3,15,-12,35,0,5
4,181,0,0,9,26,-17,35,0,5
1,900,0,1,0,0,0,35,0,5
2,812,0,0,0,13,-13,35,0,5
3,900,0,0,3,13,-10,35,0,5
3,444,0,0,3,20,-17,35,0,5
1,900,0,1,0,0,0,35,0,5
2,840,0,1,0,11,-11,35,0,5
2,376,0,0,18,8,10,30,0,5
3,900,0,0,21,9,12,35,0,5
4,711,0,0,30,9,21,25,0,5
4,462,0,0,30,16,14,35,0,5
4,109,0,0,33,23,10,35,0,5
4,53,0,1,23,40,-17,35,0,5
2,842,0,0,0,3,-3,35,0,5
2,160,0,1,3,8,-5,35,0,5
2,138,0,1,3,15,-12,35,0,5
4,689,0,0,15,17,-2,35,0,5
4,160,0,0,16,24,-8,35,0,5
4,6,0,1,25,23,2,35,0,5
1,900,0,0,0,0,0,35,0,5
2,825,0,0,0,7,-7,35,0,5
2,265,0,0,1,15,-14,35,0,5
2,22,0,1,15,8,7,35,0,5
3,900,0,1,15,8,7,35,0,5
3,687,0,1,15,15,0,35,0,5
3,35,0,0,15,18,-3,35,0,5
4,681,0,0,15,25,-10,35,0,5
4,162,0,0,15,31,-16,35,0,5
1,900,0,0,0,0,0,35,0,5
1,479,0,1,0,7,-7,35,0,5
1,173,0,0,7,3,4,35,0,5
2,347,0,1,3,15,-12,35,0,5
2,167,0,0,15,10,5,35,0,5
2,15,0,1,10,22,-12,35,0,5
3,900,0,1,10,22,-12,35,0,5
3,697,0,0,22,17,5,35,0,5
3,448,0,1,17,29,-12,35,0,5
4,827,0,0,29,24,5,35,0,5
4,49,0,0,32,32,0,35,0,5
2,653,0,1,0,7,-7,35,0,5
2,303,0,1,0,10,-10,35,0,5
2,39,0,0,10,7,3,35,0,5
3,900,0,0,10,7,3,35,0,5
1,900,0,1,0,0,0,35,0,5
1,699,0,0,0,7,-7,35,0,5
1,163,0,0,0,10,-10,35,0,5
2,786,0,1,12,0,12,25,0,5
3,900,0,0,0,14,-14,35,0,5
4,52,0,0,0,24,-24,35,0,5
1,900,0,0,0,0,0,35,0,5
2,836,0,1,2,3,-1,25,0,5
2,573,0,1,2,10,-8,35,0,5
3,900,0,0,10,5,5,35,0,5
4,625,0,1,5,16,-11,35,0,5
1,900,0,0,0,0,0,35,0,5
1,597,0,1,0,7,-7,35,0,5
3,900,0,1,3,7,-4,35,0,5
3,601,0,1,5,7,-2,25,0,5
4,677,0,0,7,14,-7,35,0,5
1,900,0,0,0,0,0,35,0,5
1,826,0,0,0,7,-7,35,0,5
1,546,0,1,7,7,0,35,0,5
2,546,0,0,10,14,-4,35,0,5
2,361,0,1,14,17,-3,35,0,5
2,103,0,0,17,21,-4,35,0,5
3,900,0,1,28,17,11,35,0,5
1,900,0,0,0,0,0,35,0,5
1,335,0,0,2,0,2,25,0,5
2,354,0,1,0,9,-9,35,0,5
3,900,0,1,0,9,-9,35,0,5
3,218,0,1,0,24,-24,35,0,5
3,132,0,0,24,8,16,35,0,5
4,900,0,0,24,16,8,25,0,5
4,507,0,0,24,24,0,35,0,5
4,32,0,1,24,31,-7,35,0,5
1,900,0,1,0,0,0,35,0,5
1,608,0,0,0,7,-7,35,0,5
1,375,0,0,0,14,-14,35,0,5
1,366,0,1,14,7,7,35,0,5
2,328,0,1,20,14,6,35,0,5
2,206,0,1,20,21,-1,35,0,5
3,900,0,0,21,20,1,35,0,5
4,25,0,1,33,32,1,35,0,5
1,900,0,0,0,0,0,35,0,5
1,3,0,1,0,10,-10,35,0,5
3,508,0,0,10,12,-2,35,0,5
4,437,0,1,14,17,-3,25,0,5
4,249,0,1,16,17,-1,25,0,5
2,223,0,0,13,7,6,35,0,5
2,109,0,1,7,20,-13,35,0,5
3,900,0,0,20,10,10,35,0,5
3,187,0,1,13,30,-17,35,0,5
4,833,0,0,30,20,10,40,0,5
4,127,0,0,33,27,6,35,0,5
4,74,0,0,33,34,-1,40,0,5
1,526,0,0,0,3,-3,35,0,5
2,402,0,0,0,10,-10,35,0,5
2,150,0,0,3,17,-14,35,0,5
3,900,0,1,17,3,14,35,0,5
3,577,0,0,3,24,-21,35,0,5
3,310,0,0,3,27,-24,35,0,5
4,726,0,0,3,34,-31,35,0,5
4,174,0,0,3,41,-38,35,0,5
1,900,0,0,0,0,0,35,0,5
1,210,0,1,0,7,-7,35,0,5
2,583,0,0,7,7,0,35,0,5
2,254,0,0,7,14,-7,35,0,5
3,900,0,1,14,7,7,35,0,5
3,714,0,0,7,21,-14,35,0,5
3,244,0,0,7,31,-24,35,0,5
4,653,0,0,9,34,-25,25,0,5
1,900,0,0,0,0,0,35,0,5
1,343,0,0,0,7,-7,35,0,5
2,331,0,0,0,21,-21,35,0,5
2,157,0,0,0,28,-28,35,0,5
2,147,0,1,30,0,30,25,0,5
2,4,0,0,0,37,-37,35,0,5
3,900,0,1,37,0,37,35,0,5
1,900,0,1,0,0,0,35,0,5
3,900,0,0,1,7,-6,35,0,5
3,593,0,0,3,7,-4,25,0,5
1,900,0,1,0,0,0,35,0,5
1,477,0,0,0,3,-3,35,0,5
1,335,0,1,3,3,0,35,0,5
2,900,0,1,3,10,-7,35,0,5
2,677,0,0,10,6,4,35,0,5
3,900,0,0,10,6,4,35,0,5
4,862,0,1,6,20,-14,35,0,5
4,489,0,0,20,9,11,35,0,5
1,900,0,0,0,0,0,35,0,5
1,538,0,1,0,7,-7,35,0,5
1,376,0,1,0,14,-14,35,0,5
1,121,0,0,14,3,11,35,0,5
3,900,0,1,6,16,-10,35,0,5
3,579,0,1,7,23,-16,35,0,5
3,128,0,1,9,23,-14,25,0,5
4,429,0,0,26,23,3,35,0,5
4,85,0,1,23,33,-10,35,0,5
1,900,0,1,0,0,0,35,0,5
2,58,0,0,4,10,-6,35,0,5
2,25,0,0,4,13,-9,35,0,5
3,887,0,0,4,13,-9,35,0,5
3,879,0,1,13,11,2,35,0,5
4,448,0,1,13,24,-11,35,0,5
4,42,0,0,24,19,5,35,0,5
1,900,0,1,0,0,0,35,0,5
1,324,0,1,7,7,0,35,0,5
3,900,0,0,13,7,6,35,0,5
3,684,0,1,7,20,-13,35,0,5
3,114,0,0,23,10,13,35,0,5
4,732,0,0,23,17,6,35,0,5
1,900,0,1,0,0,0,35,0,5
1,198,0,1,1,3,-2,35,0,5
2,900,0,0,3,8,-5,35,0,5
2,476,0,1,8,10,-2,35,0,5
2,54,0,1,8,20,-12,35,0,5
2,6,0,0,20,15,5,20,0,5
3,900,0,0,20,15,5,35,0,5
3,490,0,1,15,27,-12,35,0,5
4,585,0,1,23,27,-4,25,0,5
4,383,0,0,27,30,-3,35,0,5
4,301,0,0,27,37,-10,35,0,5
1,900,0,0,0,0,0,35,0,5
1,824,0,1,2,0,2,25,0,5
2,900,0,0,0,15,-15,35,0,5
2,410,0,1,15,7,8,35,0,5
3,595,0,1,15,14,1,35,0,5
3,94,0,1,15,21,-6,35,0,5
4,296,0,0,21,25,-4,20,0,5
1,348,0,1,4,7,-3,35,0,5
2,440,0,0,7,7,0,35,0,5
2,183,0,0,7,14,-7,35,0,5
4,566,0,1,17,20,-3,35,0,5
4,232,0,1,17,28,-11,35,0,5
4,147,0,0,28,23,5,35,0,5
1,900,0,1,0,0,0,35,0,5
1,83,0,0,0,8,-8,35,0,5
2,663,0,1,8,7,1,35,0,5
2,471,0,0,7,15,-8,35,0,5
2,452,0,1,15,14,1,35,0,5
3,900,0,0,14,15,-1,35,0,5
3,405,0,0,17,22,-5,35,0,5
3,208,0,1,22,24,-2,35,0,5
4,249,0,1,25,34,-9,35,0,5
1,900,0,1,0,0,0,35,0,5
1,86,0,1,7,3,4,35,0,5
2,769,0,0,3,10,-7,35,0,5
3,900,0,0,3,10,-7,35,0,5
3,624,0,1,10,9,1,35,0,5
4,419,0,1,11,12,-1,35,0,5
4,334,0,1,11,15,-4,35,0,5
4,196,0,1,11,18,-7,35,0,5
4,11,0,1,13,18,-5,25,0,5
1,900,0,0,0,0,0,35,0,5
1,679,0,0,0,3,-3,35,0,5
1,330,0,0,0,10,-10,35,0,5
1,87,0,1,10,3,7,35,0,5
2,598,0,0,3,17,-14,35,0,5
3,900,0,1,20,3,17,35,0,5
3,535,0,0,3,27,-24,35,0,5
4,533,0,0,3,37,-34,35,0,5
1,900,0,0,0,0,0,35,0,5
2,643,0,0,3,7,-4,35,0,5
2,9,0,1,7,11,-4,35,0,5
3,900,0,0,11,7,4,35,0,5
4,541,0,0,14,17,-3,35,0,5
1,900,0,0,0,0,0,35,0,5
1,596,0,0,0,7,-7,35,0,5
1,510,0,0,0,14,-14,35,0,5
1,900,0,0,0,0,0,35,0,5
1,671,0,1,0,3,-3,35,0,5
1,426,0,0,3,3,0,35,0,5
2,840,0,1,3,10,-7,35,0,5
2,533,0,0,10,6,4,35,0,5
2,138,0,1,6,17,-11,50,0,5
2,61,0,0,17,13,4,35,0,5
3,900,0,1,13,24,-11,35,0,5
3,362,0,0,24,16,8,35,0,5
1,900,0,1,0,0,0,35,0,5
2,550,0,0,0,11,-11,35,0,5
3,900,0,0,6,11,-5,35,0,5
4,728,0,0,6,21,-15,35,0,5
4,421,0,1,21,9,12,35,0,5
4,19,0,1,29,15,14,35,0,5
1,900,0,0,0,0,0,35,0,5
2,403,0,1,7,4,3,35,0,5
3,900,0,1,16,4,12,18,0,5
3,668,0,0,4,23,-19,35,0,5
4,173,0,1,24,17,7,35,0,5
1,900,0,0,0,0,0,35,0,5
2,330,0,0,0,8,-8,35,0,5
2,155,0,1,8,3,5,35,0,5
3,900,0,1,15,3,12,35,0,5
3,555,0,0,3,22,-19,35,0,5
3,99,0,0,3,36,-33,35,0,5
4,756,0,0,3,43,-40,35,0,5
4,636,0,0,3,50,-47,35,0,5
4,134,0,1,50,11,39,35,0,5
4,40,0,1,50,17,33,35,0,5
1,900,0,1,0,0,0,35,0,5
1,673,0,0,0,7,-7,35,0,5
2,789,0,0,1,14,-13,35,0,5
2,522,0,0,1,22,-21,35,0,5
2,106,0,1,22,4,18,35,0,5
2,40,0,0,4,29,-25,35,0,5
3,900,0,0,4,29,-25,35,0,5
3,606,0,0,4,36,-32,35,0,5
4,138,0,0,18,43,-25,35,0,5
1,900,0,0,0,0,0,35,0,5
1,304,0,0,0,7,-7,35,0,5
2,841,0,0,0,14,-14,50,0,5
2,81,0,1,17,7,10,35,0,5
3,900,0,1,17,7,10,35,0,5
1,900,0,1,0,0,0,35,0,5
2,483,0,0,0,10,-10,35,0,5
2,380,0,0,0,17,-17,35,0,5
2,44,0,1,17,7,10,35,0,5
3,900,0,1,17,7,10,35,0,5
1,900,0,0,0,0,0,35,0,5
1,427,0,1,0,7,-7,35,0,5
1,111,0,0,7,3,4,35,0,5
2,652,0,0,7,10,-3,35,0,5
2,269,0,1,10,14,-4,35,0,5
2,26,0,0,14,20,-6,35,0,5
3,900,0,0,14,20,-6,35,0,5
3,349,0,0,14,27,-13,35,0,5
3,41,0,1,27,17,10,35,0,5
4,596,0,1,27,24,3,35,0,5
4,224,0,0,24,37,-13,35,0,5
1,900,0,0,0,0,0,35,0,5
1,354,0,0,0,7,-7,35,0,5
2,286,0,0,0,13,-13,35,0,5
3,886,0,1,20,0,20,35,0,5
3,871,0,0,0,27,-27,35,0,5
3,524,0,0,0,34,-34,35,0,5
4,597,0,0,7,37,-30,35,0,5
1,900,0,1,0,0,0,35,0,5
1,325,0,0,0,6,-6,35,0,5
2,30,0,1,6,12,-6,35,0,5
3,900,0,0,13,6,7,35,0,5
3,429,0,1,7,20,-13,35,0,5
3,300,0,0,20,14,6,35,0,5
3,39,0,1,14,27,-13,35,0,5
4,520,0,1,14,34,-20,35,0,5
4,315,0,0,34,20,14,35,0,5
1,900,0,1,0,0,0,35,0,5
1,511,0,0,0,3,-3,35,0,5
1,273,0,1,3,3,0,35,0,5
2,861,0,0,3,6,-3,35,0,5
2,112,0,1,6,6,0,35,0,5
3,900,0,0,6,6,0,35,0,5
3,734,0,0,6,9,-3,35,0,5
4,663,0,0,6,20,-14,35,0,5
1,900,0,1,0,0,0,35,0,5
1,900,0,1,0,0,0,35,0,5
2,149,0,0,4,3,1,35,0,5
3,900,0,0,12,3,9,35,0,5
1,900,0,1,0,0,0,35,0,5
1,648,0,0,0,7,-7,35,0,5
1,421,0,1,7,3,4,35,0,5
2,640,0,1,7,10,-3,35,0,5
2,335,0,1,7,20,-13,35,0,5
2,73,0,0,22,7,15,25,0,5
3,657,0,1,7,30,-23,35,0,5
1,900,0,0,0,0,0,35,0,5
1,805,0,1,0,7,-7,35,0,5
1,512,0,0,7,7,0,50,0,5
1,289,0,1,7,10,-3,35,0,5
2,752,0,1,7,13,-6,35,0,5
2,345,0,1,7,20,-13,35,0,5
3,900,0,1,7,20,-13,35,0,5
4,815,0,0,23,13,10,35,0,5
4,688,0,1,13,26,-13,35,0,5
1,900,0,1,0,0,0,35,0,5
1,710,0,0,0,6,-6,35,0,5
2,832,0,0,3,13,-10,35,0,5
2,659,0,1,13,10,3,20,0,5
3,900,0,0,13,19,-6,35,0,5
3,127,0,0,16,27,-11,35,0,5
4,826,0,1,27,23,4,35,0,5
4,532,0,0,23,30,-7,35,0,5
4,36,0,1,30,37,-7,35,0,5
1,900,0,1,0,0,0,35,0,5
1,666,0,0,0,6,-6,35,0,5
2,565,0,0,5,6,-1,25,0,5
2,326,0,0,5,13,-8,35,0,5
3,900,0,0,5,13,-8,35,0,5
3,477,0,1,13,13,0,30,0,5
4,606,0,1,16,20,-4,35,0,5
1,596,0,1,0,7,-7,35,0,5
1,313,0,0,7,7,0,35,0,5
2,619,0,1,9,15,-6,25,0,5
3,900,0,0,18,10,8,35,0,5
3,388,0,0,18,18,0,35,0,5
1,900,0,1,0,0,0,35,0,5
1,764,0,1,2,0,2,35,0,5
1,12,0,1,3,7,-4,20,0,5
2,900,0,0,7,10,-3,35,0,5
3,900,0,0,10,10,0,35,0,5
3,377,0,0,10,16,-6,35,0,5
1,900,0,1,0,0,0,35,0,5
1,47,0,1,0,7,-7,35,0,5
2,802,0,0,7,7,0,35,0,5
2,88,0,0,15,14,1,35,0,5
3,831,0,0,15,22,-7,40,0,5
1,691,0,1,1,3,-2,35,0,5
1,381,0,0,3,7,-4,35,0,5
1,82,0,1,7,10,-3,35,0,5
2,900,0,1,7,17,-10,35,0,5
2,641,0,1,7,24,-17,35,0,5
2,242,0,1,7,38,-31,50,0,5
3,900,0,1,13,38,-25,35,0,5
3,487,0,1,15,41,-26,25,0,5
3,68,0,1,18,49,-31,20,0,5
4,710,0,0,49,26,23,35,0,5
1,261,0,0,0,7,-7,35,0,5
2,122,0,0,0,16,-16,35,0,5
3,900,0,1,16,0,16,35,0,5
3,423,0,0,0,22,-22,35,0,5
4,595,0,1,25,11,14,35,0,5
1,900,0,1,0,0,0,35,0,5
2,447,0,1,0,6,-6,35,0,5
2,233,0,0,6,7,-1,35,0,5
3,900,0,0,7,10,-3,35,0,5
3,196,0,1,13,16,-3,30,0,5
4,877,0,0,16,20,-4,35,0,5
1,900,0,0,0,0,0,35,0,5
1,254,0,0,3,3,0,35,0,5
2,828,0,1,3,10,-7,35,0,5
2,8,0,0,10,17,-7,40,0,5
3,900,0,1,17,10,7,35,0,5
4,566,0,1,21,18,3,35,0,5
4,6,0,1,28,28,0,35,0,5
1,900,0,0,0,0,0,35,0,5
1,436,0,0,0,7,-7,35,0,5
1,232,0,0,0,14,-14,35,0,5
2,878,0,0,0,20,-20,35,0,5
2,607,0,0,0,26,-26,35,0,5
2,186,0,1,29,8,21,35,0,5
2,113,0,0,8,36,-28,35,0,5
3,900,0,1,36,11,25,35,0,5
3,395,0,0,14,43,-29,35,0,5
1,900,0,1,0,0,0,35,0,5
2,263,0,1,12,10,2,35,0,5
2,17,0,0,10,19,-9,35,0,5
3,900,0,0,10,19,-9,35,0,5
4,830,0,1,22,20,2,35,0,5
1,331,0,1,0,7,-7,35,0,5
3,900,0,1,6,7,-1,35,0,5
3,298,0,1,9,15,-6,35,0,5
4,781,0,1,12,22,-10,35,0,5
4,378,0,0,22,18,4,35,0,5
4,141,0,1,18,29,-11,35,0,5
4,98,0,0,29,26,3,35,0,5
1,900,0,0,0,0,0,35,0,5
2,473,0,0,7,6,1,35,0,5
2,159,0,0,7,21,-14,35,0,5
2,93,0,1,21,14,7,25,0,5
3,900,0,1,22,14,8,35,0,5
2,650,0,1,4,7,-3,35,0,5
3,436,0,0,10,14,-4,35,0,5
4,312,0,0,13,17,-4,35,0,5
1,900,0,0,0,0,0,35,0,5
1,727,0,0,2,0,2,25,0,5
3,900,0,1,3,8,-5,35,0,5
4,678,0,0,11,12,-1,35,0,5
4,564,0,1,12,17,-5,35,0,5
1,900,0,1,0,0,0,35,0,5
1,488,0,1,0,7,-7,35,0,5
3,563,0,0,17,11,6,35,0,5
4,868,0,1,11,27,-16,50,0,5
4,36,0,0,27,24,3,35,0,5
1,620,0,1,0,8,-8,35,0,5
1,49,0,0,16,8,8,35,0,5
3,900,0,0,16,16,0,35,0,5
3,134,0,0,16,23,-7,35,0,5
4,900,0,1,23,22,1,35,0,5
1,900,0,1,0,0,0,35,0,5
1,493,0,1,0,8,-8,35,0,5
1,6,0,0,11,8,3,35,0,5
2,684,0,1,8,19,-11,35,0,5
3,900,0,0,19,17,2,35,0,5
4,475,0,0,23,26,-3,35,0,5
1,900,0,1,0,0,0,35,0,5
1,371,0,0,0,7,-7,35,0,5
1,184,0,0,0,14,-14,35,0,5
2,844,0,0,0,21,-21,35,0,5
2,627,0,1,21,7,14,35,0,5
3,900,0,0,7,21,-14,35,0,5
4,201,0,1,24,27,-3,35,0,5
1,900,0,1,0,0,0,35,0,5
1,83,0,1,1,3,-2,35,0,5
2,604,0,0,3,4,-1,35,0,5
3,900,0,0,3,4,-1,35,0,5
3,393,0,0,3,11,-8,35,0,5
3,120,0,0,3,18,-15,35,0,5
4,511,0,0,3,25,-22,35,0,5
4,278,0,0,3,32,-29,35,0,5
1,900,0,0,0,0,0,35,0,5
1,463,0,0,0,3,-3,35,0,5
2,13,0,0,14,14,0,35,0,5
3,900,0,1,14,14,0,35,0,5
3,661,0,0,14,21,-7,35,0,5
4,405,0,1,21,28,-7,35,0,5
1,900,0,1,0,0,0,35,0,5
1,463,0,1,7,3,4,35,0,5
2,120,0,1,7,13,-6,35,0,5
3,900,0,0,14,10,4,35,0,5
1,508,1,0,0,0,0,14,10,1
1,471,1,0,0,0,0,51,10,1
1,416,1,1,0,0,0,34,10,1
1,274,2,1,0,0,0,34,10,1
1,227,1,0,0,0,0,44,10,1
1,195,2,0,0,0,0,39,5,1
1,81,1,0,0,3,-3,33,10,1
1,63,2,0,0,3,-3,37,6,1
1,1,2,0,0,3,-3,55,5,1
2,900,1,1,3,0,3,47,10,1
2,869,1,1,3,0,3,30,10,1
2,778,1,1,3,7,-4,30,10,1
2,718,1,0,7,3,4,42,10,1
2,610,2,1,3,7,-4,7,11,1
2,540,2,1,3,7,-4,53,4,1
2,360,1,0,7,3,4,42,10,1
2,319,1,1,3,7,-4,53,10,1
2,154,2,0,7,3,4,55,10,1
2,97,1,1,3,7,-4,10,10,1
2,91,1,1,3,14,-11,43,10,1
2,42,2,0,14,3,11,27,6,1
2,24,1,0,14,3,11,43,10,1
2,9,2,0,14,3,11,54,10,1
2,1,3,1,3,14,-11,47,1,1
3,768,1,1,3,14,-11,44,10,1
3,468,1,1,3,17,-14,33,10,1
3,340,1,0,17,3,14,38,10,1
3,300,1,0,17,3,14,24,10,1
3,148,1,1,6,17,-11,50,10,1
3,68,1,1,6,17,-11,7,10,1
3,17,2,1,6,17,-11,5,5,1
4,776,1,0,24,6,18,30,10,1
4,421,1,1,6,24,-18,40,10,1
4,312,1,0,24,6,18,51,10,1
4,195,1,0,24,6,18,9,10,1
4,176,2,0,24,6,18,15,4,1
4,130,1,0,24,6,18,19,10,1
4,117,2,0,24,6,18,51,9,1
4,57,2,1,6,24,-18,44,10,1
4,1,3,1,6,24,-18,49,10,1
1,887,1,1,0,0,0,32,10,1
1,561,1,0,0,7,-7,30,10,1
1,525,1,0,0,7,-7,45,10,1
1,480,1,1,7,0,7,28,10,1
1,310,2,1,7,3,4,23,12,1
1,281,1,1,7,3,4,38,10,1
1,152,1,1,7,3,4,43,10,1
1,111,1,1,7,3,4,35,10,1
2,529,1,1,7,16,-9,33,10,1
2,443,1,0,16,7,9,43,10,1
2,329,2,1,7,16,-9,34,6,1
2,307,1,0,16,7,9,53,10,1
2,212,1,0,16,7,9,9,10,1
2,180,2,0,16,7,9,17,2,1
2,113,1,1,7,16,-9,41,10,1
2,106,1,0,16,7,9,53,10,1
2,82,2,0,16,7,9,30,10,1
2,70,1,0,16,10,6,35,10,1
2,15,2,1,10,16,-6,25,10,1
3,885,1,0,23,10,13,44,10,1
3,810,1,1,10,23,-13,43,10,1
3,800,2,1,10,23,-13,47,6,1
3,720,2,0,23,10,13,51,12,1
3,617,2,0,23,10,13,7,7,1
3,501,1,0,23,12,11,38,10,1
3,342,1,1,12,23,-11,45,10,1
3,164,1,0,26,12,14,23,10,1
4,858,1,1,12,26,-14,20,10,1
4,790,1,1,12,33,-21,31,10,1
4,722,2,1,12,33,-21,35,6,1
4,672,2,0,33,19,14,30,12,1
4,593,2,0,33,19,14,44,15,1
4,361,2,1,19,33,-14,53,10,1
4,266,1,0,33,19,14,20,10,1
4,134,2,0,33,26,7,29,10,1
4,106,2,0,33,26,7,51,5,1
4,44,2,1,26,33,-7,17,10,1
4,35,1,1,26,33,-7,31,10,1
4,19,2,1,26,33,-7,40,1,1
1,898,1,1,0,0,0,48,10,1
1,820,1,0,0,0,0,26,10,1
1,794,2,0,0,0,0,24,12,1
1,696,2,1,0,0,0,50,10,1
1,669,1,0,0,0,0,43,10,1
1,630,1,0,0,0,0,31,10,1
1,600,2,0,0,0,0,30,9,1
1,516,2,0,0,0,0,5,5,1
1,489,1,0,0,7,-7,55,10,1
1,292,1,1,7,0,7,26,15,1
1,188,2,0,0,7,-7,45,8,1
2,840,1,1,7,0,7,22,15,1
2,813,1,1,7,0,7,39,10,1
2,722,1,0,0,7,-7,24,10,1
2,691,2,0,0,7,-7,29,5,1
2,611,2,0,0,7,-7,46,6,1
2,562,1,1,7,0,7,30,10,1
2,498,1,1,7,0,7,14,10,1
2,443,1,1,7,7,0,30,10,1
2,423,1,0,7,14,-7,43,10,1
2,288,2,1,14,7,7,20,11,1
2,200,2,1,14,7,7,40,3,1
2,137,1,0,7,14,-7,11,15,1
2,130,1,0,7,14,-7,28,10,1
2,110,1,0,7,14,-7,41,10,1
3,893,1,0,9,14,-5,32,10,1
3,765,2,1,14,9,5,27,16,1
3,709,2,0,9,14,-5,27,10,1
3,640,2,0,9,14,-5,3,3,1
3,569,3,0,9,14,-5,2,2,1
3,536,1,0,9,21,-12,47,10,1
3,498,1,1,21,9,12,52,10,1
3,398,1,1,21,9,12,38,10,1
3,204,2,1,21,16,5,35,5,1
3,162,1,1,21,16,5,42,10,1
3,135,2,1,21,16,5,45,7,1
3,42,2,0,16,21,-5,52,4,1
4,900,2,0,16,21,-5,45,8,1
4,782,1,0,16,22,-6,37,10,1
4,687,2,1,22,16,6,49,10,1
4,571,1,1,22,19,3,50,10,1
4,507,2,0,19,22,-3,40,3,1
4,478,1,0,19,22,-3,30,10,1
4,434,1,0,19,22,-3,16,10,1
4,330,1,0,19,29,-10,40,10,1
4,295,2,0,19,29,-10,45,5,1
4,257,1,0,19,29,-10,53,10,1
4,188,1,0,19,29,-10,35,10,1
4,146,1,0,19,29,-10,25,10,1
4,139,1,0,19,29,-10,36,10,1
4,106,2,1,29,19,10,49,18,1
4,73,1,1,29,19,10,30,10,1
4,51,1,1,29,19,10,12,10,1
4,25,2,1,29,19,10,2,2,1
1,894,1,1,0,0,0,26,10,1
1,780,1,1,0,0,0,37,10,1
1,746,2,1,0,0,0,43,4,1
1,641,1,0,0,0,0,30,10,1
1,550,2,1,0,0,0,39,8,1
1,464,2,1,0,3,-3,25,16,1
1,419,1,0,3,0,3,43,10,1
1,333,2,1,0,3,-3,50,23,1
1,292,1,1,0,3,-3,15,10,1
1,1,2,1,7,10,-3,28,17,1
2,840,2,0,10,7,3,9,10,1
2,800,1,0,10,7,3,49,10,1
2,647,1,1,7,10,-3,38,10,1
2,465,2,0,11,7,4,38,7,1
2,168,1,1,7,11,-4,33,10,1
2,151,2,0,11,14,-3,49,9,1
2,134,1,1,14,11,3,49,10,1
2,105,1,1,14,11,3,21,10,1
2,74,1,0,11,14,-3,37,10,1
2,37,2,1,14,11,3,12,10,1
3,826,1,1,14,11,3,19,10,1
3,794,2,1,14,11,3,22,7,1
3,429,1,0,11,14,-3,35,10,1
3,365,2,1,14,11,3,23,8,1
3,288,1,1,14,14,0,25,10,1
3,195,2,1,14,14,0,35,10,1
3,1,2,0,14,21,-7,55,13,1
4,870,2,1,21,14,7,38,9,1
4,793,2,1,21,14,7,22,10,1
4,744,1,0,14,21,-7,52,10,1
4,715,1,1,21,14,7,47,10,1
4,535,1,0,17,21,-4,22,10,1
4,406,2,0,17,21,-4,35,9,1
4,353,1,1,21,17,4,38,10,1
4,335,1,1,21,17,4,52,10,1
4,182,1,0,17,24,-7,35,10,1
4,139,1,1,24,17,7,35,10,1
4,121,3,1,24,17,7,27,4,1
4,106,2,1,24,17,7,15,10,1
4,54,3,1,24,17,7,1,1,1
4,17,1,1,24,31,-7,44,10,1
4,8,2,0,31,24,7,53,10,1
1,840,2,0,0,0,0,13,13,1
1,628,2,0,0,0,0,28,15,1
1,553,2,1,0,0,0,36,14,1
1,497,1,0,0,0,0,38,10,1
1,476,1,0,0,0,0,48,10,1
1,279,1,1,0,2,-2,44,10,1
1,252,2,1,0,2,-2,48,6,1
1,221,1,0,2,0,2,52,10,1
1,191,1,0,2,0,2,42,10,1
1,157,1,0,2,0,2,30,10,1
1,1,1,0,2,7,-5,34,10,1
2,900,1,0,2,7,-5,53,10,1
2,702,1,1,7,3,4,51,10,1
2,586,1,1,7,10,-3,25,10,1
2,364,2,0,10,7,3,16,10,1
2,318,1,1,7,10,-3,52,10,1
2,222,2,1,7,10,-3,18,10,1
2,159,1,1,7,10,-3,45,10,1
2,109,2,1,7,17,-10,53,0,1
2,90,1,0,17,7,10,21,10,1
2,84,1,0,17,14,3,35,10,1
2,59,2,0,17,14,3,51,10,1
2,45,1,1,14,18,-4,35,10,1
3,859,2,1,14,18,-4,31,13,1
3,829,1,1,14,18,-4,49,10,1
3,794,2,1,14,18,-4,55,4,1
3,759,1,0,18,14,4,45,10,1
3,639,1,0,18,21,-3,25,10,1
3,607,2,0,18,21,-3,32,3,1
3,567,1,0,18,21,-3,40,10,1
3,177,2,1,24,18,6,18,10,1
3,126,2,1,24,18,6,34,6,1
3,60,1,1,24,18,6,42,10,1
4,802,1,0,18,24,-6,11,10,1
4,779,1,0,18,31,-13,33,10,1
4,740,1,1,31,18,13,53,10,1
4,652,1,1,31,25,6,35,10,1
4,345,2,0,25,31,-6,7,7,1
4,216,2,0,25,38,-13,22,9,1
4,127,2,0,25,41,-16,5,5,1
4,74,2,0,25,48,-23,39,10,1
1,693,1,0,0,0,0,20,10,1
1,434,1,0,0,0,0,37,10,1
1,277,1,1,3,0,3,50,10,1
1,173,2,1,3,0,3,14,10,1
1,118,1,1,3,0,3,35,10,1
1,12,2,1,3,0,3,14,0,1
2,892,1,1,3,7,-4,38,10,1
2,830,1,0,7,3,4,50,10,1
2,729,2,0,7,3,4,40,20,1
2,694,1,0,7,3,4,13,10,1
2,583,1,1,10,7,3,26,10,1
2,540,2,0,7,10,-3,51,8,1
2,451,2,0,7,10,-3,28,10,1
2,384,2,0,7,10,-3,38,10,1
2,91,1,0,7,10,-3,14,10,1
2,56,2,1,17,14,3,33,19,1
2,15,1,0,14,17,-3,44,10,1
3,888,1,0,17,17,0,41,10,1
3,792,2,1,17,17,0,21,10,1
3,636,2,1,17,17,0,13,7,1
3,587,1,1,17,17,0,48,10,1
3,522,1,1,17,17,0,3,10,1
3,24,2,1,17,23,-6,36,9,1
4,768,1,1,17,26,-9,36,10,1
4,680,1,0,26,17,9,20,10,1
4,457,1,0,26,20,6,42,10,1
4,260,2,0,26,20,6,39,10,1
4,172,1,0,26,27,-1,51,10,1
4,152,2,1,27,26,1,52,3,1
4,110,1,1,27,26,1,50,15,1
4,67,1,1,27,29,-2,42,10,1
1,828,2,1,0,0,0,37,7,1
1,770,2,0,0,0,0,50,12,1
1,555,2,0,0,7,-7,34,10,1
1,498,1,0,0,10,-10,35,10,1
1,369,1,1,10,0,10,29,10,1
1,171,2,0,0,10,-10,33,5,1
1,150,1,0,0,17,-17,26,10,1
1,63,2,1,17,0,17,30,7,1
2,567,1,1,17,0,17,20,10,1
2,484,2,1,17,0,17,37,9,1
2,383,2,1,17,0,17,13,10,1
2,111,1,1,17,7,10,29,10,1
2,49,1,0,7,17,-10,41,10,1
3,896,1,0,7,17,-10,15,10,1
3,708,2,0,7,20,-13,42,9,1
3,411,2,1,23,7,16,30,5,1
3,371,1,1,23,7,16,45,10,1
3,306,1,0,7,23,-16,42,10,1
3,117,1,1,30,7,23,43,10,1
4,900,2,0,7,30,-23,13,8,1
4,883,1,0,7,30,-23,25,10,1
4,838,2,0,7,30,-23,35,10,1
4,656,2,1,30,7,23,44,5,1
4,588,2,0,7,37,-30,28,11,1
4,547,1,1,37,7,30,49,10,1
4,316,1,1,37,13,24,29,10,1
4,263,1,1,37,13,24,18,10,1
4,189,2,1,37,20,17,33,10,1
4,137,1,1,37,27,10,7,7,1
4,127,2,1,37,34,3,27,10,1
4,50,3,0,34,37,-3,7,20,1
1,815,1,0,0,0,0,30,10,1
1,654,2,1,1,0,1,43,7,1
1,529,1,0,0,1,-1,3,10,1
1,497,1,0,0,1,-1,16,10,1
1,299,2,0,0,1,-1,34,10,1
1,257,2,0,0,8,-8,25,10,1
1,105,2,1,8,0,8,18,8,1
1,20,2,0,0,8,-8,45,7,1
2,676,1,1,8,3,5,29,10,1
2,523,1,0,3,8,-5,34,10,1
2,368,2,1,8,3,5,28,9,1
2,348,1,1,8,10,-2,6,10,1
2,217,2,1,8,10,-2,9,18,1
2,169,2,0,10,8,2,32,10,1
2,82,1,1,8,17,-9,17,10,1
2,59,1,0,17,8,9,43,10,1
3,825,1,0,17,8,9,46,10,1
3,705,1,1,8,17,-9,30,10,1
3,669,2,1,8,17,-9,38,2,1
3,586,2,0,17,8,9,36,10,1
3,374,1,0,17,8,9,30,10,1
3,264,1,1,8,17,-9,14,10,1
3,242,1,1,8,17,-9,31,10,1
3,219,2,1,8,17,-9,35,6,1
3,182,1,1,8,17,-9,47,10,1
3,116,2,0,17,8,9,39,13,1
3,70,1,0,17,8,9,23,10,1
3,5,1,0,17,8,9,18,10,1
4,670,1,1,8,20,-12,43,10,1
4,585,1,0,20,9,11,30,15,1
4,496,2,0,20,9,11,46,9,1
4,444,1,1,9,20,-11,16,10,1
4,393,2,1,9,20,-11,30,7,1
4,352,1,1,9,20,-11,38,10,1
4,236,1,0,20,9,11,26,20,1
4,204,2,0,20,9,11,30,16,1
4,180,1,0,20,9,11,52,10,1
1,786,1,0,0,0,0,30,10,1
1,634,2,0,0,0,0,13,10,1
1,313,2,1,2,0,2,46,5,1
1,205,1,0,0,2,-2,20,10,1
1,166,1,0,0,2,-2,48,10,1
1,122,1,1,2,0,2,45,10,1
1,25,2,1,2,0,2,32,10,1
2,763,1,0,7,2,5,42,10,1
2,743,1,0,7,2,5,26,10,1
2,681,2,0,7,2,5,15,10,1
2,487,1,1,9,7,2,24,10,1
2,214,2,1,9,10,-1,46,11,1
2,75,1,1,9,10,-1,20,10,1
2,52,1,0,10,9,1,34,10,1
3,889,1,1,9,10,-1,27,10,1
3,797,2,0,10,9,1,43,11,1
3,749,1,0,10,10,0,35,10,1
3,737,2,0,10,10,0,45,0,1
3,659,2,0,10,10,0,52,4,1
3,539,2,1,10,10,0,47,20,1
3,250,1,0,17,10,7,10,10,1
3,102,1,1,17,17,0,29,10,1
4,852,2,0,17,17,0,31,7,1
4,749,1,1,17,17,0,44,10,1
4,515,1,0,17,17,0,22,10,1
4,477,1,0,17,17,0,42,10,1
4,423,2,0,17,17,0,53,10,1
4,290,1,1,17,20,-3,35,10,1
4,212,1,0,20,17,3,43,10,1
4,151,2,0,20,17,3,29,10,1
4,144,1,0,20,24,-4,31,10,1
1,800,1,0,0,0,0,50,10,1
1,677,1,1,0,0,0,11,10,1
1,591,1,0,7,0,7,54,10,1
1,500,1,0,7,0,7,24,15,1
1,311,2,0,7,0,7,52,4,1
2,834,2,1,0,7,-7,27,19,1
2,796,1,0,7,0,7,23,10,1
2,707,2,1,0,7,-7,55,5,1
2,536,1,0,7,1,6,27,10,1
2,375,1,1,8,7,1,42,10,1
2,295,1,1,8,10,-2,35,10,1
2,212,1,0,10,8,2,25,10,1
2,162,2,0,10,8,2,33,10,1
2,138,2,0,10,8,2,18,9,1
2,108,1,0,10,9,1,35,10,1
2,68,1,1,9,10,-1,43,10,1
3,670,2,0,10,9,1,43,10,1
3,640,1,0,10,9,1,55,10,1
3,589,2,1,9,10,-1,51,6,1
3,513,2,1,9,10,-1,39,20,1
3,430,1,1,9,13,-4,35,10,1
3,380,2,1,9,13,-4,55,8,1
3,214,1,0,13,9,4,33,10,1
3,155,2,0,13,9,4,46,10,1
3,120,1,1,9,13,-4,53,10,1
3,50,1,1,9,13,-4,53,25,1
4,843,2,1,9,16,-7,39,6,1
4,782,2,1,9,16,-7,45,10,1
4,699,2,0,16,9,7,39,11,1
4,520,1,1,12,16,-4,54,10,1
4,314,2,1,12,19,-7,28,17,1
4,155,2,1,12,19,-7,43,19,1
4,104,1,1,12,22,-10,35,10,1
1,896,1,0,0,0,0,41,10,1
1,796,1,0,0,0,0,53,10,1
1,758,2,0,0,0,0,48,5,1
1,690,1,0,0,0,0,43,10,1
1,457,1,1,3,0,3,33,10,1
1,425,1,1,3,0,3,46,10,1
1,319,2,1,3,0,3,48,5,1
1,191,1,1,3,0,3,7,10,1
1,64,2,1,3,2,1,20,10,1
1,49,1,1,3,2,1,8,8,1
2,854,1,1,3,5,-2,35,10,1
2,820,1,1,3,5,-2,50,10,1
2,792,2,0,5,3,2,52,2,1
2,723,1,0,5,3,2,37,10,1
2,645,1,1,10,5,5,50,10,1
2,566,1,0,5,10,-5,18,10,1
2,495,1,1,10,5,5,54,10,1
2,481,1,0,5,10,-5,25,10,1
2,391,2,0,5,10,-5,7,7,1
2,353,2,0,5,17,-12,32,8,1
2,329,1,0,5,17,-12,47,10,1
2,186,1,1,17,5,12,9,10,1
2,117,1,0,5,17,-12,52,10,1
2,33,1,1,17,5,12,16,10,1
3,893,1,1,17,8,9,40,10,1
3,861,1,0,8,17,-9,54,10,1
3,826,1,0,8,17,-9,43,10,1
3,760,1,0,8,17,-9,32,10,1
3,690,1,0,8,24,-16,23,10,1
3,601,2,0,8,31,-23,47,10,1
3,575,1,0,8,31,-23,35,10,1
3,452,2,0,8,34,-26,35,7,1
3,245,1,1,34,8,26,20,10,1
3,180,1,0,8,34,-26,55,10,1
3,51,1,1,34,8,26,31,10,1
3,16,2,1,34,8,26,25,4,1
4,742,2,1,34,15,19,43,10,1
4,673,2,1,34,15,19,21,10,1
4,644,1,1,34,15,19,10,10,1
4,552,2,1,34,15,19,5,5,1
4,529,1,1,34,22,12,27,10,1
4,503,2,1,34,22,12,31,6,1
4,214,2,0,22,37,-15,38,7,1
4,149,3,0,22,37,-15,51,10,1
4,141,1,1,37,22,15,42,10,1
4,117,1,1,37,22,15,15,10,1
4,10,1,0,29,37,-8,33,10,1
1,869,2,0,0,0,0,38,10,1
1,784,1,1,7,0,7,50,15,1
1,745,2,1,7,0,7,46,11,1
1,466,2,1,7,1,6,50,10,1
1,325,2,0,1,7,-6,33,7,1
1,258,1,0,1,7,-6,18,10,1
1,180,1,0,1,10,-9,36,10,1
1,43,2,1,10,1,9,46,10,1
2,900,1,1,10,2,8,39,10,1
2,879,1,0,2,10,-8,38,10,1
2,738,2,0,2,13,-11,35,10,1
2,326,2,0,2,13,-11,25,5,1
2,283,1,0,2,13,-11,39,10,1
2,180,2,1,13,2,11,43,10,1
2,164,1,1,13,2,11,32,10,1
2,147,1,1,13,2,11,18,10,1
2,36,2,0,5,13,-8,29,16,1
3,895,1,0,5,16,-11,27,10,1
3,744,1,1,16,5,11,46,10,1
3,726,2,1,16,5,11,38,2,1
3,396,1,0,8,23,-15,42,10,1
3,365,2,0,8,23,-15,49,3,1
3,306,1,1,23,15,8,34,10,1
3,141,1,0,21,23,-2,53,10,1
3,89,2,1,23,21,2,54,7,1
3,51,2,1,23,28,-5,32,10,1
3,22,1,1,23,28,-5,43,10,1
4,889,1,0,28,23,5,45,10,1
4,869,1,0,28,30,-2,46,10,1
4,838,2,0,28,30,-2,50,6,1
4,682,2,0,28,30,-2,52,10,1
4,538,1,0,29,30,-1,48,10,1
4,511,1,1,30,29,1,50,10,1
4,485,2,1,30,29,1,43,3,1
4,457,1,1,30,29,1,24,10,1
4,266,1,1,30,30,0,45,10,1
4,190,2,1,30,30,0,30,5,1
4,77,2,1,30,30,0,5,4,1
4,71,1,1,30,37,-7,41,10,1
4,51,1,0,37,30,7,13,10,1
1,892,1,0,0,0,0,27,10,1
1,869,1,0,0,0,0,39,10,1
1,784,1,1,0,0,0,26,10,1
1,694,1,0,0,0,0,18,10,1
1,603,1,0,0,0,0,38,10,1
1,251,2,1,7,0,7,55,14,1
1,197,1,0,0,7,-7,10,10,1
1,163,2,0,0,7,-7,16,4,1
1,134,1,0,0,7,-7,22,10,1
1,102,2,0,0,7,-7,28,4,1
2,863,2,0,0,14,-14,25,11,1
2,779,2,1,14,0,14,51,15,1
2,674,1,0,0,14,-14,30,10,1
2,616,2,0,0,14,-14,45,10,1
2,546,1,1,14,0,14,50,15,1
2,340,1,0,0,14,-14,45,10,1
2,319,1,0,0,14,-14,33,10,1
2,279,2,0,0,14,-14,26,3,1
2,237,2,0,0,14,-14,18,10,1
2,185,1,0,0,14,-14,5,5,1
2,111,2,1,21,0,21,24,10,1
2,105,1,1,21,0,21,36,10,1
2,72,1,1,21,0,21,52,10,1
2,59,1,1,28,0,28,40,10,1
2,40,1,1,28,0,28,28,10,1
2,36,2,1,28,0,28,25,7,1
3,890,1,1,35,0,35,48,10,1
3,821,1,0,0,35,-35,36,10,1
3,725,1,0,0,35,-35,42,10,1
3,699,1,0,0,35,-35,31,10,1
3,584,2,0,0,38,-38,35,10,1
3,501,2,1,38,0,38,26,4,1
3,465,1,1,38,0,38,54,10,1
3,391,2,0,0,38,-38,40,7,1
3,281,1,0,0,41,-41,18,10,1
3,93,1,1,44,0,44,44,10,1
4,810,1,1,44,0,44,21,10,1
4,774,2,1,44,0,44,14,3,1
4,465,2,1,44,0,44,53,10,1
4,275,1,0,0,51,-51,45,10,1
4,200,2,0,0,51,-51,26,6,1
4,153,1,0,0,52,-52,35,10,1
1,649,2,1,0,0,0,26,12,1
1,489,1,0,3,7,-4,33,10,1
1,199,1,1,7,3,4,40,10,1
1,1,2,1,7,3,4,8,8,1
2,868,1,1,7,6,1,25,20,1
2,432,2,1,7,9,-2,27,15,1
2,148,2,0,9,10,-1,39,6,1
2,143,1,0,9,10,-1,45,10,1
2,125,2,0,9,10,-1,48,7,1
2,104,1,1,10,9,1,49,10,1
2,84,2,1,10,9,1,43,4,1
3,374,2,0,13,17,-4,43,12,1
3,262,1,1,17,13,4,35,10,1
3,225,2,1,17,13,4,41,4,1
3,79,1,1,17,13,4,48,10,1
4,861,2,0,13,17,-4,31,8,1
4,546,1,1,24,13,11,33,10,1
4,496,1,0,13,24,-11,32,10,1
4,438,1,0,13,25,-12,35,10,1
4,400,1,0,13,25,-12,46,10,1
4,105,2,0,13,25,-12,45,22,1
4,31,3,1,25,13,12,50,34,1
1,881,1,0,0,0,0,37,10,1
1,815,2,0,0,0,0,19,5,1
1,622,1,1,7,0,7,26,10,1
1,590,1,1,7,0,7,37,10,1
1,499,1,0,0,7,-7,28,10,1
1,430,2,0,0,7,-7,52,5,1
1,274,2,1,7,3,4,47,10,1
1,130,1,1,7,3,4,20,10,1
1,77,2,1,7,10,-3,33,7,1
1,14,2,1,7,10,-3,42,10,1
2,578,2,0,10,7,3,42,10,1
2,408,2,0,11,7,4,28,5,1
2,152,2,1,7,11,-4,36,10,1
2,94,2,0,14,7,7,41,10,1
2,85,1,0,14,7,7,51,10,1
2,55,1,1,7,14,-7,18,10,1
3,900,1,1,7,14,-7,39,10,1
3,830,2,1,7,14,-7,52,10,1
3,679,1,1,9,14,-5,55,10,1
3,625,2,0,14,9,5,36,10,1
3,547,2,0,14,9,5,20,5,1
3,472,1,0,14,16,-2,22,10,1
3,388,1,1,16,14,2,47,10,1
3,272,1,0,14,16,-2,4,4,1
3,252,1,0,14,23,-9,35,10,1
3,107,1,1,23,14,9,34,10,1
3,62,2,1,23,14,9,20,10,1
3,31,1,1,23,14,9,8,8,1
4,836,1,1,23,21,2,37,10,1
4,512,1,1,23,21,2,41,10,1
4,429,1,0,21,23,-2,27,10,1
4,181,2,1,23,21,2,34,15,1
4,111,1,0,24,23,1,43,10,1
4,107,2,0,24,23,1,48,5,1
1,870,2,0,0,0,0,31,10,1
1,820,1,1,0,0,0,51,10,1
1,784,1,1,0,0,0,37,10,1
1,559,2,0,7,0,7,17,10,1
1,501,1,0,7,3,4,11,10,1
1,351,1,1,3,8,-5,53,10,1
1,321,2,0,8,3,5,50,3,1
1,68,1,0,8,6,2,35,10,1
2,559,2,1,6,8,-2,30,10,1
2,540,1,0,8,13,-5,27,10,1
2,328,1,1,13,8,5,36,10,1
2,189,1,0,8,13,-5,23,10,1
2,165,2,0,8,13,-5,27,6,1
2,153,1,0,8,13,-5,38,10,1
2,110,1,0,8,13,-5,54,5,1
2,103,1,1,13,8,5,39,10,1
2,76,2,1,13,8,5,23,8,1
2,17,2,1,13,8,5,6,4,1
3,893,1,1,13,15,-2,25,10,1
3,665,1,0,15,13,2,53,10,1
3,616,2,1,13,15,-2,44,10,1
3,566,1,1,13,15,-2,26,10,1
3,421,2,1,13,22,-9,29,5,1
3,389,3,1,13,22,-9,26,8,1
3,366,1,0,22,13,9,53,10,1
3,327,2,0,22,13,9,44,11,1
3,203,1,1,16,22,-6,25,10,1
3,110,2,1,16,22,-6,48,9,1
3,1,1,0,22,16,6,28,10,1
4,783,2,0,22,19,3,34,11,1
4,690,2,1,19,22,-3,30,14,1
4,649,1,0,22,19,3,49,10,1
4,570,2,1,19,22,-3,42,5,1
4,544,1,1,19,22,-3,35,10,1
4,407,2,1,19,22,-3,9,10,1
4,337,1,0,22,19,3,46,10,1
4,181,2,1,19,22,-3,25,10,1
4,152,1,1,19,22,-3,38,10,1
4,127,3,1,19,22,-3,42,6,1
4,118,1,0,22,19,3,36,10,1
4,78,1,0,22,19,3,15,10,1
4,58,2,0,22,26,-4,21,17,1
4,52,3,0,22,26,-4,30,8,1
4,40,2,0,22,26,-4,47,5,1
4,24,2,0,22,26,-4,52,15,1
4,12,3,1,26,22,4,45,2,1
1,869,2,0,0,0,0,36,9,1
1,806,1,1,0,0,0,29,10,1
1,739,2,1,0,0,0,40,10,1
1,703,1,0,0,0,0,34,10,1
1,605,2,0,0,0,0,23,10,1
1,417,2,0,0,8,-8,37,8,1
1,333,1,0,0,8,-8,50,10,1
1,83,1,1,8,7,1,27,10,1
1,43,1,1,8,7,1,42,10,1
2,824,2,0,7,8,-1,21,6,1
2,797,1,0,7,8,-1,31,10,1
2,707,1,0,7,8,-1,43,10,1
2,602,2,1,8,7,1,50,11,1
2,407,1,1,8,14,-6,53,10,1
2,374,2,1,8,14,-6,47,4,1
2,255,1,1,8,14,-6,25,10,1
2,195,2,1,8,14,-6,33,13,1
2,65,1,1,8,14,-6,52,10,1
3,872,1,1,8,17,-9,50,10,1
3,839,2,1,8,17,-9,55,5,1
3,775,2,1,8,17,-9,55,20,1
3,686,2,0,17,8,9,29,5,1
3,565,2,0,17,8,9,15,6,1
3,515,1,0,17,8,9,3,3,1
3,492,1,0,17,15,2,41,10,1
3,465,2,0,17,15,2,46,5,1
3,432,1,0,17,15,2,51,10,1
3,291,1,1,15,20,-5,47,10,1
3,15,2,0,20,15,5,44,9,1
4,849,2,1,15,20,-5,27,10,1
4,723,1,0,20,15,5,41,10,1
4,693,1,1,15,27,-12,31,10,1
4,595,2,1,15,27,-12,51,5,1
4,542,2,0,27,22,5,35,4,1
4,425,1,1,22,27,-5,51,10,1
4,346,2,0,27,22,5,42,4,1
4,200,2,0,27,22,5,7,7,1
4,77,1,1,22,27,-5,27,10,1
4,52,2,1,22,27,-5,46,10,1
4,45,1,0,27,22,5,44,10,1
4,30,3,0,27,22,5,38,4,1
4,18,2,0,27,22,5,31,10,1
1,891,1,1,0,0,0,27,10,1
1,726,1,1,0,0,0,51,10,1
1,702,2,0,0,0,0,32,6,1
1,640,1,0,0,0,0,25,10,1
1,566,1,0,0,0,0,8,8,1
1,546,1,0,0,7,-7,23,10,1
1,201,1,1,10,0,10,51,10,1
1,93,1,0,0,10,-10,16,10,1
2,862,1,1,17,0,17,35,10,1
2,737,1,0,0,17,-17,37,10,1
2,425,2,0,0,17,-17,43,8,1
2,180,2,1,17,0,17,41,5,1
2,114,1,1,17,3,14,35,10,1
2,58,1,0,3,17,-14,25,10,1
2,50,2,0,3,24,-21,18,18,1
2,24,1,1,24,3,21,46,10,1
3,893,1,0,3,24,-21,27,10,1
3,845,2,0,3,24,-21,31,6,1
3,695,2,1,24,3,21,16,9,1
3,629,1,0,3,24,-21,44,10,1
3,578,1,1,24,3,21,42,10,1
3,535,2,1,24,3,21,38,6,1
3,375,1,0,3,24,-21,36,10,1
3,251,2,1,24,3,21,42,7,1
3,145,1,1,24,4,20,35,10,1
3,55,1,1,24,4,20,46,10,1
3,7,2,1,24,4,20,54,2,1
4,755,1,0,4,25,-21,35,10,1
4,721,1,0,4,25,-21,48,10,1
4,651,1,1,25,4,21,15,10,1
4,495,1,0,7,25,-18,30,10,1
4,464,1,0,7,25,-18,47,10,1
4,270,1,1,25,7,18,37,10,1
4,179,1,1,25,7,18,26,10,1
1,777,1,1,0,0,0,29,10,1
1,684,1,1,0,7,-7,31,10,1
1,584,1,1,0,14,-14,32,10,1
1,505,2,0,14,0,14,37,15,1
1,448,1,0,14,3,11,31,10,1
1,428,1,0,14,3,11,44,10,1
1,269,2,1,3,14,-11,24,12,1
2,733,1,1,11,14,-3,44,10,1
2,542,1,1,11,17,-6,34,10,1
2,472,1,1,11,20,-9,22,10,1
2,435,2,1,11,20,-9,28,4,1
2,402,1,1,11,20,-9,34,10,1
2,310,1,0,20,11,9,9,10,1
2,172,1,0,20,13,7,23,10,1
2,139,2,0,20,13,7,46,8,1
2,88,2,1,13,20,-7,46,5,1
2,56,2,1,13,20,-7,28,6,1
2,18,2,1,13,20,-7,25,13,1
3,888,1,1,13,23,-10,37,10,1
3,829,1,0,23,13,10,8,10,1
3,686,1,0,23,27,-4,35,10,1
3,618,1,1,27,23,4,54,10,1
3,589,1,0,23,27,-4,39,10,1
3,560,2,0,23,27,-4,32,3,1
3,458,1,0,23,30,-7,35,10,1
3,427,1,1,30,23,7,48,10,1
3,317,1,1,30,24,6,30,15,1
3,220,2,1,30,24,6,49,7,1
3,105,1,0,24,33,-9,35,10,1
3,50,1,0,24,33,-9,50,10,1
4,628,2,1,33,24,9,42,10,1
4,611,1,1,33,31,2,33,10,1
4,547,2,1,33,31,2,29,14,1
4,389,2,1,33,31,2,40,8,1
4,364,1,1,33,31,2,32,10,1
4,238,2,1,33,34,-1,40,5,1
4,137,2,1,33,34,-1,45,9,1
4,98,2,1,33,37,-4,35,10,1
1,886,1,0,0,0,0,30,10,1
1,833,2,0,0,0,0,44,8,1
1,516,2,0,8,0,8,37,25,1
1,326,2,1,0,11,-11,44,11,1
1,298,1,0,11,0,11,52,10,1
1,100,2,0,11,0,11,42,10,1
2,772,1,0,11,3,8,25,10,1
2,572,2,1,3,11,-8,47,10,1
2,527,1,0,11,3,8,49,10,1
2,442,1,0,11,3,8,38,10,1
2,358,2,0,11,3,8,31,3,1
2,317,1,0,11,10,1,23,10,1
2,287,2,0,11,10,1,20,7,1
2,144,2,0,11,13,-2,47,10,1
2,137,1,0,11,20,-9,38,10,1
2,111,2,0,11,20,-9,51,10,1
2,84,2,1,20,12,8,35,10,1
3,887,1,1,20,12,8,40,10,1
3,746,2,1,20,12,8,22,10,1
3,712,1,1,20,12,8,52,10,1
3,642,2,0,12,20,-8,10,4,1
3,396,1,1,23,12,11,36,10,1
3,340,1,1,23,12,11,36,20,1
3,307,2,1,23,12,11,40,16,1
3,177,1,0,12,23,-11,8,10,1
3,157,2,0,12,23,-11,15,3,1
3,129,1,0,12,23,-11,31,10,1
3,99,1,0,12,23,-11,50,10,1
4,744,2,1,23,15,8,49,10,1
4,710,1,1,23,15,8,30,10,1
4,651,1,1,23,15,8,15,10,1
4,579,1,0,23,23,0,54,10,1
4,460,1,1,23,30,-7,34,10,1
4,430,2,1,23,30,-7,41,3,1
4,308,1,0,30,23,7,22,10,1
4,284,2,0,30,23,7,25,3,1
4,53,1,1,23,31,-8,35,10,1
4,48,1,1,23,31,-8,45,10,1
4,14,2,0,31,23,8,17,7,1
1,820,1,0,0,0,0,25,10,1
1,741,2,0,0,0,0,8,8,1
1,670,1,1,7,7,0,25,10,1
1,651,1,0,7,7,0,52,10,1
1,589,1,0,7,7,0,42,10,1
1,513,1,0,7,8,-1,40,10,1
1,485,2,0,7,8,-1,48,2,1
1,274,2,1,8,7,1,9,9,1
1,173,1,0,14,8,6,32,10,1
1,141,2,0,14,8,6,38,4,1
1,72,1,0,14,8,6,46,10,1
1,36,1,1,8,21,-13,36,10,1
2,798,2,0,21,15,6,50,5,1
2,654,2,1,15,21,-6,35,10,1
2,493,1,1,15,24,-9,37,10,1
2,443,2,0,24,22,2,29,10,1
2,380,1,1,22,24,-2,38,10,1
2,350,1,1,22,24,-2,53,10,1
2,161,2,0,24,25,-1,26,8,1
2,146,1,0,24,25,-1,40,10,1
2,93,2,1,25,24,1,29,5,1
2,77,1,1,25,24,1,6,6,1
2,58,1,1,25,31,-6,38,15,1
3,864,2,0,31,25,6,48,10,1
3,733,1,1,25,34,-9,35,10,1
3,666,2,0,34,25,9,25,10,1
3,600,3,0,34,25,9,20,5,1
3,495,1,0,34,32,2,48,10,1
3,453,1,1,32,34,-2,51,10,1
3,283,1,1,32,34,-2,25,10,1
3,246,2,1,32,34,-2,25,10,1
3,216,1,1,32,34,-2,39,10,1
3,81,1,0,34,32,2,19,10,1
3,50,1,0,34,32,2,30,10,1
3,5,2,0,34,32,2,37,3,1
4,881,2,0,34,32,2,43,10,1
4,842,1,1,32,34,-2,53,10,1
4,661,2,1,32,34,-2,51,9,1
4,603,1,0,34,32,2,29,10,1
4,480,1,1,32,34,-2,39,10,1
4,457,1,0,34,32,2,39,10,1
4,400,2,0,34,32,2,19,4,1
4,311,2,0,34,32,2,10,10,1
4,166,1,1,39,34,5,15,10,1
4,132,2,1,39,34,5,33,5,1
4,30,1,0,34,39,-5,44,10,1
4,23,1,1,39,34,5,44,10,1
1,891,1,0,0,0,0,47,10,1
1,706,2,0,0,2,-2,51,4,1
1,659,1,0,0,2,-2,27,10,1
1,593,2,0,0,2,-2,16,10,1
1,326,1,1,5,0,5,29,10,1
2,900,2,1,5,0,5,5,12,1
2,851,1,1,5,0,5,18,10,1
2,768,2,1,5,0,5,35,6,1
2,748,1,1,5,0,5,45,10,1
2,711,2,1,5,0,5,50,5,1
2,670,1,0,0,5,-5,50,10,1
2,646,1,0,0,5,-5,39,10,1
2,361,1,1,8,0,8,25,10,1
2,337,2,1,8,0,8,25,10,1
2,266,2,1,8,0,8,38,8,1
2,187,1,0,0,8,-8,14,10,1
2,160,1,0,0,15,-15,29,10,1
2,153,2,0,0,15,-15,27,12,1
2,123,1,0,0,15,-15,55,10,1
2,88,1,1,15,0,15,13,10,1
2,63,1,0,0,15,-15,23,10,1
2,45,1,0,0,15,-15,45,10,1
2,17,2,0,0,15,-15,32,6,1
3,893,1,0,0,15,-15,27,10,1
3,714,1,0,0,15,-15,16,10,1
3,650,1,0,0,15,-15,27,10,1
3,610,2,0,0,15,-15,33,4,1
3,489,1,1,15,0,15,36,10,1
3,372,2,1,15,0,15,26,10,1
3,330,1,1,15,0,15,13,10,1
3,193,2,1,15,0,15,2,2,1
3,82,1,0,7,15,-8,36,10,1
4,874,1,0,7,22,-15,28,15,1
4,732,2,0,7,22,-15,1,13,1
4,641,2,0,7,22,-15,15,10,1
4,499,1,0,7,29,-22,53,10,1
4,459,2,1,29,7,22,50,3,1
4,423,1,1,29,7,22,35,10,1
4,354,2,1,29,14,15,50,6,1
4,274,2,0,14,29,-15,43,8,1
4,232,1,0,14,29,-15,25,10,1
4,146,1,0,14,36,-22,45,10,1
4,128,2,1,36,14,22,50,10,1
4,117,2,1,36,14,22,44,16,1
4,70,1,0,14,36,-22,50,10,1
1,801,2,1,0,0,0,49,10,1
1,703,1,0,0,0,0,27,10,1
1,584,2,0,0,0,0,12,11,1
1,358,1,0,0,7,-7,18,10,1
1,279,1,0,0,7,-7,32,10,1
1,214,2,0,0,7,-7,12,10,1
1,95,1,0,0,16,-16,53,10,1
2,838,1,0,0,16,-16,32,10,1
2,749,1,0,0,16,-16,49,10,1
2,608,1,1,16,0,16,53,10,1
2,530,1,1,16,6,10,52,10,1
2,430,1,0,6,16,-10,11,10,1
2,325,2,0,6,23,-17,17,10,1
2,230,2,1,23,6,17,48,13,1
2,100,1,0,6,24,-18,14,10,1
2,92,1,0,6,31,-25,20,10,1
3,893,1,0,6,31,-25,28,10,1
3,850,2,0,6,31,-25,35,3,1
3,830,1,0,6,31,-25,46,10,1
3,766,2,1,31,6,25,53,10,1
3,644,2,1,31,6,25,17,10,1
3,535,2,1,31,21,10,38,7,1
3,479,1,0,21,31,-10,29,10,1
3,380,1,1,31,21,10,26,10,1
3,277,2,1,31,21,10,44,4,1
3,219,2,0,21,31,-10,25,3,1
3,109,1,0,21,38,-17,36,10,1
4,803,1,1,38,21,17,43,10,1
4,760,2,1,38,21,17,40,7,1
4,607,2,1,38,24,14,45,10,1
4,560,1,0,24,38,-14,52,10,1
4,247,2,0,24,41,-17,43,6,1
4,80,2,1,44,24,20,52,10,1
4,54,2,1,44,24,20,40,10,1
4,29,2,1,44,24,20,35,20,1
4,23,3,1,44,24,20,18,3,1
4,1,1,1,44,24,20,7,7,1
1,894,1,1,0,0,0,32,10,1
1,801,1,1,0,0,0,42,10,1
1,778,1,0,0,0,0,46,10,1
1,700,2,0,0,0,0,35,10,1
1,655,1,0,0,0,0,23,10,1
1,566,1,0,0,7,-7,37,10,1
1,464,2,0,0,7,-7,43,15,1
1,347,2,1,7,0,7,30,15,1
1,233,1,0,0,7,-7,20,10,1
1,170,2,0,0,7,-7,12,2,1
1,66,1,0,0,14,-14,52,10,1
2,883,1,0,0,17,-17,35,10,1
2,689,2,0,0,17,-17,33,10,1
2,636,1,0,0,20,-20,35,10,1
2,589,2,0,0,20,-20,49,10,1
2,525,1,1,20,0,20,30,10,1
2,324,1,0,3,20,-17,48,10,1
2,254,2,1,20,3,17,48,9,1
2,183,1,1,20,3,17,15,10,1
2,143,2,1,20,4,16,35,10,1
2,108,1,0,4,20,-16,32,10,1
2,55,1,1,20,4,16,25,10,1
2,23,1,1,20,4,16,12,10,1
3,851,1,0,11,27,-16,37,10,1
3,796,2,0,11,27,-16,33,14,1
3,653,1,0,11,27,-16,35,10,1
3,591,1,0,11,27,-16,47,10,1
3,490,1,1,27,11,16,13,10,1
3,415,2,1,27,11,16,39,2,1
3,388,1,0,11,27,-16,45,10,1
3,235,1,0,11,27,-16,34,10,1
3,189,2,1,27,11,16,34,10,1
4,782,1,1,27,17,10,44,10,1
4,750,1,1,27,17,10,25,10,1
4,666,1,1,27,17,10,14,10,1
4,579,1,0,17,27,-10,50,10,1
4,539,1,1,27,17,10,50,10,1
4,509,2,1,27,17,10,49,9,1
4,448,1,1,27,17,10,38,10,1
4,227,2,0,24,27,-3,40,5,1
4,143,1,0,24,27,-3,1,10,1
4,139,2,0,24,27,-3,8,3,1
4,50,1,1,27,24,3,40,10,1
1,868,2,0,0,0,0,36,10,1
1,790,2,0,0,0,0,54,3,1
1,561,2,1,0,7,-7,23,7,1
1,492,2,1,0,7,-7,35,9,1
1,378,1,0,7,0,7,16,10,1
1,190,1,1,0,7,-7,20,10,1
1,65,2,1,0,7,-7,13,13,1
1,15,2,1,0,14,-14,18,7,1
2,765,2,1,0,14,-14,19,10,1
2,680,1,1,0,14,-14,51,10,1
2,617,1,1,0,15,-15,35,10,1
2,461,1,0,15,1,14,35,10,1
2,345,1,1,1,15,-14,35,10,1
2,117,1,1,1,15,-14,25,10,1
2,72,1,0,15,1,14,45,10,1
2,53,2,1,1,15,-14,53,10,1
3,893,1,1,1,22,-21,10,10,1
3,781,2,1,1,22,-21,48,5,1
3,736,1,1,1,22,-21,10,10,1
3,668,2,1,1,22,-21,3,3,1
3,603,1,1,1,29,-28,4,4,1
3,523,2,1,1,36,-35,36,6,1
3,430,2,0,36,4,32,24,7,1
3,325,1,0,36,4,32,50,10,1
3,13,2,1,6,36,-30,37,10,1
4,776,2,1,6,39,-33,27,18,1
4,695,2,0,39,6,33,27,10,1
4,528,2,1,6,39,-33,44,10,1
4,500,1,0,39,6,33,31,10,1
4,475,2,0,39,6,33,25,4,1
4,396,2,0,39,6,33,19,10,1
4,350,1,0,39,12,27,34,10,1
4,330,2,0,39,12,27,28,4,1
4,144,1,1,12,39,-27,42,10,1
4,136,1,1,12,39,-27,54,10,1
4,126,2,0,39,12,27,51,5,1
4,51,1,1,15,39,-24,44,10,1
4,34,3,0,39,15,24,48,7,1
4,28,0,1,15,39,-24,32,0,1
1,657,1,0,0,0,0,20,10,1
1,474,1,0,0,3,-3,46,10,1
1,428,1,1,3,0,3,37,10,1
1,360,1,1,3,0,3,25,10,1
1,124,2,0,0,3,-3,6,9,1
1,73,1,0,0,3,-3,43,10,1
1,44,2,0,0,3,-3,48,5,1
1,1,1,1,3,0,3,30,10,1
2,749,1,1,3,7,-4,29,10,1
2,641,2,0,7,3,4,44,10,1
2,600,1,1,3,7,-4,52,10,1
2,420,1,1,3,8,-5,35,10,1
2,378,2,1,3,8,-5,31,14,1
2,205,2,1,3,8,-5,47,5,1
2,135,2,0,8,3,5,45,14,1
2,55,2,0,8,3,5,18,14,1
3,840,2,1,3,8,-5,22,19,1
3,634,2,1,3,8,-5,45,16,1
3,395,2,0,8,3,5,34,7,1
3,159,1,0,8,3,5,43,10,1
3,75,2,0,8,4,4,25,20,1
3,13,1,1,4,8,-4,39,10,1
4,855,1,0,8,4,4,47,10,1
4,832,2,0,8,4,4,51,6,1
4,763,2,1,4,8,-4,47,10,1
4,460,2,0,9,4,5,48,12,1
4,425,2,1,4,9,-5,15,10,1
4,338,1,1,4,16,-12,40,10,1
4,260,1,0,16,4,12,41,10,1
4,175,1,1,4,16,-12,50,10,1
4,158,2,0,16,4,12,53,3,1
4,154,1,0,16,4,12,38,10,1
4,70,1,0,16,4,12,17,10,1
1,894,1,0,0,0,0,36,10,1
1,815,1,1,0,0,0,30,10,1
1,766,2,1,0,0,0,45,10,1
1,632,2,0,0,0,0,6,8,1
1,590,1,0,0,0,0,15,10,1
1,547,2,0,0,0,0,15,10,1
1,447,2,0,0,0,0,51,4,1
1,369,2,0,0,0,0,6,6,1
1,328,2,0,0,7,-7,37,6,1
1,278,1,1,7,0,7,21,10,1
1,207,2,1,7,0,7,40,4,1
1,187,1,1,7,0,7,47,10,1
1,42,2,0,0,7,-7,25,10,1
2,856,1,0,0,10,-10,17,10,1
2,683,1,1,10,0,10,38,10,1
2,542,1,0,0,13,-13,35,10,1
2,510,2,0,0,13,-13,41,4,1
2,422,2,1,13,0,13,45,5,1
2,379,1,1,13,0,13,38,10,1
2,191,2,1,13,3,10,40,10,1
2,122,2,0,3,13,-10,33,10,1
2,84,1,0,3,14,-11,35,10,1
2,24,1,0,3,14,-11,54,10,1
3,792,1,0,3,14,-11,38,20,1
3,659,1,1,14,3,11,50,10,1
3,617,2,1,14,3,11,53,7,1
3,578,1,0,3,14,-11,45,10,1
3,532,2,0,3,14,-11,38,3,1
3,317,1,0,3,17,-14,35,10,1
3,274,1,0,3,17,-14,49,10,1
3,173,1,1,17,3,14,20,10,1
3,89,3,1,17,3,14,13,3,1
3,2,1,1,17,6,11,33,10,1
4,880,2,1,17,6,11,30,13,1
4,839,1,1,17,6,11,38,10,1
4,511,1,0,9,17,-8,47,10,1
4,449,1,0,9,17,-8,41,10,1
4,251,1,0,9,24,-15,41,10,1
4,142,2,0,9,24,-15,19,10,1
4,135,1,0,9,24,-15,29,10,1
4,130,2,0,9,24,-15,31,8,1
4,120,1,1,24,9,15,54,10,1
4,105,2,1,24,9,15,44,10,1
1,891,1,0,0,0,0,17,10,1
1,802,2,0,0,0,0,31,6,1
1,779,1,1,0,0,0,15,10,1
1,662,2,1,0,7,-7,42,4,1
1,596,2,0,7,0,7,51,6,1
1,519,2,0,7,0,7,41,8,1
1,437,1,0,7,0,7,12,10,1
1,373,1,0,7,3,4,35,10,1
1,165,2,0,7,3,4,50,19,1
1,129,1,1,3,7,-4,36,10,1
1,41,1,1,3,7,-4,25,10,1
2,876,1,1,3,7,-4,8,8,1
2,845,1,1,3,14,-11,41,10,1
2,776,2,1,3,14,-11,55,9,1
2,724,1,0,14,3,11,6,10,1
2,625,1,0,14,3,11,35,10,1
2,564,2,0,14,3,11,28,3,1
2,534,1,0,14,11,3,21,10,1
2,499,2,0,14,11,3,28,3,1
2,314,2,1,11,14,-3,23,6,1
2,192,1,1,11,14,-3,40,10,1
2,174,1,0,14,11,3,38,10,1
2,105,1,0,14,14,0,35,10,1
2,98,2,0,14,14,0,40,5,1
2,76,1,0,14,14,0,53,10,1
2,49,1,1,14,14,0,44,10,1
2,26,2,1,14,14,0,26,10,1
2,14,1,1,14,14,0,16,10,1
3,894,1,1,14,21,-7,41,10,1
3,610,1,1,17,21,-4,40,10,1
3,582,2,1,17,21,-4,44,6,1
3,505,2,0,21,17,4,49,1,1
3,325,1,0,21,20,1,35,10,1
3,169,1,1,20,21,-1,27,10,1
3,142,2,1,20,21,-1,32,5,1
3,60,2,1,20,21,-1,45,7,1
3,25,1,0,21,20,1,52,10,1
4,682,1,1,28,21,7,45,10,1
4,651,2,1,28,21,7,49,6,1
4,557,2,1,28,21,7,54,14,1
4,329,2,0,21,28,-7,15,19,1
4,46,1,0,21,36,-15,35,10,1
4,39,2,0,21,36,-15,43,2,1
4,32,1,1,36,21,15,54,10,1
4,24,2,1,36,21,15,47,3,1
1,880,1,0,0,0,0,40,10,1
1,829,2,0,0,0,0,40,10,1
1,767,1,0,0,0,0,18,10,1
1,401,2,1,0,9,-9,11,5,1
1,370,1,0,16,0,16,38,10,1
1,45,1,0,16,7,9,11,10,1
2,821,2,0,16,7,9,43,8,1
2,726,2,1,7,16,-9,22,10,1
2,581,2,1,7,16,-9,51,4,1
2,543,1,0,16,7,9,48,10,1
2,137,1,0,16,10,6,49,10,1
2,128,1,0,16,10,6,26,10,1
3,890,1,1,13,16,-3,34,10,1
3,675,2,1,13,16,-3,48,10,1
3,536,2,1,13,16,-3,29,12,1
3,467,1,1,13,16,-3,13,8,1
3,448,1,1,13,23,-10,16,10,1
3,343,1,0,23,13,10,34,10,1
3,240,1,1,13,23,-10,16,10,1
4,886,1,0,23,13,10,27,10,1
4,859,1,0,23,13,10,46,10,1
4,754,2,1,13,23,-10,38,10,1
4,724,1,1,13,23,-10,20,10,1
4,547,2,1,13,30,-17,30,10,1
4,397,1,0,30,13,17,40,10,1
4,345,2,0,30,20,10,50,10,1
4,229,2,1,20,30,-10,44,5,1
4,159,3,0,30,20,10,43,2,1
4,90,1,1,20,30,-10,12,10,1
4,85,1,1,20,30,-10,26,10,1
4,78,2,1,20,30,-10,31,5,1
1,828,2,0,0,0,0,28,20,1
1,768,1,1,0,0,0,24,10,1
1,748,1,1,0,0,0,36,10,1
1,586,1,1,0,0,0,46,10,1
1,537,2,1,0,0,0,41,15,1
1,442,1,0,0,0,0,18,10,1
1,318,2,0,0,3,-3,34,6,1
1,287,1,0,0,3,-3,45,10,1
1,243,1,1,3,0,3,51,10,1
1,205,2,1,3,0,3,46,5,1
1,84,2,1,3,0,3,33,7,1
2,881,3,0,7,3,4,10,4,1
2,854,1,0,7,10,-3,32,10,1
2,743,2,1,10,7,3,51,20,1
2,662,1,0,7,10,-3,4,10,1
2,473,2,0,7,10,-3,49,9,1
2,386,1,1,10,7,3,35,10,1
2,290,1,1,10,7,3,36,10,1
2,55,2,0,10,10,0,26,19,1
2,17,1,1,10,10,0,52,10,1
3,894,1,0,10,13,-3,41,10,1
3,865,1,1,13,10,3,38,10,1
3,795,1,1,13,10,3,25,10,1
3,505,1,0,16,13,3,36,10,1
3,471,1,0,16,13,3,47,10,1
3,383,1,1,13,16,-3,53,10,1
3,318,1,1,13,16,-3,42,10,1
3,177,1,1,13,19,-6,35,10,1
4,869,1,1,15,19,-4,45,10,1
4,611,1,0,19,22,-3,22,15,1
4,499,2,0,19,22,-3,44,6,1
4,276,2,1,25,19,6,47,10,1
4,189,2,0,19,25,-6,53,10,1
4,88,1,0,19,28,-9,45,10,1
4,79,2,0,19,28,-9,48,7,1
4,72,1,0,19,28,-9,55,10,1
4,64,1,1,28,19,9,44,10,1
4,55,2,1,28,19,9,40,6,1
4,28,2,1,28,19,9,27,3,1
1,890,1,1,0,0,0,24,10,1
1,805,1,0,0,0,0,54,10,1
1,772,2,0,0,0,0,47,3,1
1,704,2,0,0,0,0,39,5,1
1,511,2,1,3,0,3,30,5,1
1,483,1,1,3,0,3,52,10,1
1,362,1,0,0,4,-4,39,10,1
1,290,2,0,0,4,-4,51,9,1
1,160,2,1,4,0,4,11,6,1
1,136,1,1,4,7,-3,29,10,1
1,94,1,1,4,7,-3,42,10,1
1,21,1,0,7,4,3,14,10,1
1,0,2,0,7,4,3,10,6,1
2,750,2,1,11,7,4,37,5,1
2,629,1,1,11,7,4,54,10,1
2,405,2,1,11,14,-3,22,10,1
2,310,2,0,14,11,3,47,7,1
2,225,2,1,11,14,-3,51,16,1
2,50,1,0,14,11,3,49,10,1
2,41,1,1,11,21,-10,29,10,1
2,31,2,1,11,21,-10,38,1,1
2,21,1,1,11,21,-10,46,10,1
2,11,1,0,21,11,10,53,10,1
3,738,1,1,14,21,-7,48,10,1
3,669,1,1,14,22,-8,35,10,1
3,489,1,0,22,14,8,40,10,1
3,420,2,1,14,29,-15,30,11,1
3,382,1,1,14,29,-15,44,10,1
3,181,2,0,29,14,15,20,5,1
3,143,1,0,29,14,15,26,10,1
4,766,1,1,14,32,-18,35,10,1
4,659,1,0,32,14,18,54,10,1
4,606,2,0,32,14,18,48,4,1
4,437,1,0,32,21,11,46,10,1
4,261,1,1,21,32,-11,19,10,1
4,232,1,1,21,32,-11,37,10,1
4,132,1,1,21,39,-18,8,10,1
4,99,2,1,21,39,-18,22,10,1
4,83,2,1,21,39,-18,49,18,1
4,40,1,0,39,21,18,23,10,1
4,35,2,0,39,21,18,16,3,1
4,1,3,1,28,39,-11,45,17,1
1,678,2,1,0,0,0,4,4,1
1,617,1,1,0,7,-7,51,10,1
1,556,1,0,7,0,7,48,10,1
1,471,1,0,7,3,4,35,10,1
1,420,2,0,7,3,4,27,10,1
1,315,2,0,7,3,4,11,7,1
1,259,2,0,7,10,-3,33,4,1
1,3,1,0,7,11,-4,45,10,1
2,840,2,1,11,8,3,35,10,1
2,757,1,0,8,11,-3,28,10,1
2,614,2,0,8,11,-3,6,6,1
2,509,2,0,8,18,-10,45,10,1
2,428,2,1,18,8,10,43,4,1
2,395,1,1,18,8,10,31,10,1
2,349,1,1,18,8,10,2,2,1
2,296,2,1,18,15,3,10,7,1
2,231,1,1,18,15,3,48,10,1
2,154,1,0,15,18,-3,2,10,1
2,148,1,0,15,18,-3,28,10,1
2,128,1,0,15,18,-3,40,10,1
2,123,2,0,15,18,-3,47,3,1
2,115,1,1,18,15,3,51,10,1
3,891,1,1,18,15,3,54,10,1
3,867,2,0,15,18,-3,52,6,1
3,774,1,0,15,18,-3,17,10,1
3,730,2,0,15,25,-10,28,10,1
3,633,1,1,25,15,10,28,10,1
3,583,2,0,22,25,-3,34,5,1
3,466,1,0,22,25,-3,25,10,1
3,417,2,0,22,25,-3,44,3,1
3,328,1,1,25,22,3,40,10,1
3,136,1,1,25,25,0,52,10,1
3,8,2,1,25,25,0,44,30,1
4,847,2,0,25,25,0,8,7,1
4,823,1,0,25,25,0,22,10,1
4,633,1,0,25,25,0,40,10,1
4,602,2,0,25,25,0,41,9,1
4,553,1,1,25,25,0,34,10,1
4,483,2,1,25,25,0,34,10,1
4,430,2,1,25,32,-7,38,10,1
4,363,1,0,32,25,7,44,10,1
4,273,1,0,32,26,6,35,10,1
4,210,1,1,26,32,-6,24,10,1
4,185,2,1,26,32,-6,27,7,1
4,166,2,1,26,32,-6,37,10,1
4,26,1,1,26,33,-7,35,10,1
4,11,1,1,26,33,-7,40,15,1
4,2,1,0,33,26,7,45,5,1
1,826,1,1,0,0,0,29,10,1
1,805,2,1,0,0,0,33,6,1
1,766,1,1,0,0,0,39,10,1
1,639,1,0,0,0,0,46,15,1
1,619,2,0,0,0,0,40,9,1
1,497,2,0,0,0,0,30,10,1
1,430,1,0,0,0,0,19,10,1
1,220,1,1,7,0,7,42,10,1
1,159,1,1,7,0,7,30,10,1
1,98,2,1,7,0,7,17,10,1
1,10,2,1,7,3,4,38,7,1
2,818,1,0,3,7,-4,41,10,1
2,778,1,1,7,3,4,47,10,1
2,696,2,1,7,3,4,36,10,1
2,650,2,1,7,3,4,22,10,1
2,444,1,1,7,6,1,48,15,1
2,418,2,1,7,6,1,43,10,1
2,378,1,1,7,6,1,32,10,1
2,236,1,1,7,6,1,9,9,1
2,216,1,1,7,13,-6,30,10,1
2,195,1,1,7,13,-6,42,10,1
2,134,1,1,7,13,-6,53,10,1
2,109,1,0,13,7,6,46,10,1
2,25,1,1,7,13,-6,33,10,1
3,810,1,0,13,7,6,32,10,1
3,783,2,0,13,7,6,38,4,1
3,708,2,0,13,7,6,52,10,1
3,657,2,1,7,13,-6,20,14,1
3,490,1,1,7,16,-9,46,10,1
3,420,2,0,16,7,9,52,10,1
3,300,2,0,16,7,9,49,11,1
3,233,2,1,7,16,-9,51,14,1
3,140,2,1,7,16,-9,33,7,1
3,72,2,1,7,19,-12,35,10,1
3,28,1,1,7,19,-12,46,10,1
4,771,1,0,19,7,12,53,10,1
4,672,1,1,7,19,-12,3,10,1
4,652,1,1,7,19,-12,26,10,1
4,614,1,0,19,7,12,51,10,1
4,503,2,0,19,7,12,40,13,1
4,357,1,1,7,19,-12,29,10,1
4,206,1,0,19,14,5,32,10,1
4,154,2,1,14,19,-5,30,15,1
1,778,1,0,7,0,7,22,10,1
1,723,2,0,7,0,7,13,1,1
1,706,1,0,7,7,0,37,10,1
1,564,1,1,7,7,0,35,10,1
1,461,1,1,7,7,0,25,10,1
1,440,1,1,7,15,-8,35,10,1
1,415,1,1,7,15,-8,45,10,1
2,866,2,0,15,7,8,17,7,1
2,827,1,0,15,7,8,35,10,1
2,730,1,1,7,15,-8,13,10,1
2,586,2,0,15,7,8,47,10,1
2,498,2,1,7,15,-8,8,10,1
2,195,2,1,7,25,-18,25,10,1
2,155,1,1,7,25,-18,51,10,1
2,109,1,1,7,33,-26,45,10,1
2,99,1,0,33,7,26,48,10,1
2,62,2,0,33,7,26,35,10,1
2,53,2,0,33,14,19,37,10,1
2,22,1,1,14,33,-19,27,10,1
2,1,2,1,14,33,-19,50,10,1
3,801,1,1,14,33,-19,28,10,1
3,705,2,1,14,33,-19,10,3,1
3,458,1,1,14,40,-26,20,10,1
3,378,1,1,14,40,-26,49,10,1
3,345,1,1,14,40,-26,36,10,1
3,304,2,1,14,40,-26,35,9,1
3,252,1,1,14,40,-26,26,10,1
3,126,2,1,14,40,-26,43,9,1
4,869,1,1,14,47,-33,48,10,1
4,844,2,1,14,47,-33,41,3,1
4,683,1,1,14,47,-33,12,10,1
4,458,1,1,14,50,-36,49,10,1
4,350,1,0,50,17,33,35,10,1
4,87,1,1,17,53,-36,35,10,1
4,69,3,1,17,53,-36,36,9,1
1,894,1,1,0,0,0,37,10,1
1,767,1,1,0,0,0,49,10,1
1,460,2,0,0,7,-7,26,10,1
1,370,2,0,0,7,-7,35,12,1
1,300,1,1,7,0,7,44,10,1
1,220,2,0,0,7,-7,46,4,1
1,112,1,0,0,8,-8,37,10,1
2,900,2,1,8,0,8,51,24,1
2,788,1,1,9,6,3,38,10,1
2,546,2,0,6,9,-3,40,19,1
2,419,1,1,9,6,3,25,10,1
2,380,1,1,9,6,3,44,10,1
2,286,1,1,9,6,3,48,10,1
2,230,2,1,9,6,3,47,9,1
2,210,1,1,9,6,3,37,10,1
2,129,1,1,9,13,-4,45,10,1
2,113,2,1,9,13,-4,51,4,1
2,105,1,0,13,9,4,39,10,1
2,68,2,0,13,9,4,18,10,1
2,44,1,0,13,12,1,35,10,1
2,40,2,0,13,12,1,44,1,1
2,30,1,0,13,12,1,52,10,1
3,563,1,0,13,14,-1,19,10,1
3,493,1,0,13,14,-1,52,10,1
3,406,2,0,13,14,-1,24,10,1
3,260,1,1,17,13,4,43,10,1
3,131,2,0,13,17,-4,21,8,1
3,54,1,1,17,13,4,33,10,1
3,2,2,1,17,13,4,50,6,1
4,900,1,0,13,17,-4,49,10,1
4,880,1,0,13,17,-4,39,10,1
4,800,2,0,13,17,-4,30,14,1
4,610,2,0,13,18,-5,45,13,1
4,555,2,0,13,18,-5,24,2,1
4,305,2,0,13,25,-12,51,7,1
4,260,1,1,25,13,12,36,10,1
4,214,1,1,25,13,12,26,10,1
4,160,1,1,25,20,5,45,10,1
4,50,2,1,25,20,5,49,6,1
1,609,2,0,0,0,0,39,15,1
1,529,1,0,0,0,0,52,10,1
1,476,2,0,0,0,0,50,8,1
1,286,2,0,0,0,0,26,6,1
1,234,1,0,0,3,-3,14,10,1
1,137,1,0,0,3,-3,51,10,1
2,724,1,1,3,0,3,16,10,1
2,686,2,1,3,0,3,15,11,1
2,434,2,1,3,0,3,41,10,1
2,146,2,0,0,3,-3,50,7,1
3,890,1,0,1,3,-2,30,10,1
3,817,1,0,1,3,-2,46,10,1
3,740,1,1,3,1,2,47,10,1
3,625,2,1,3,1,2,12,3,1
3,609,1,1,3,8,-5,45,10,1
3,249,2,1,3,8,-5,16,1,1
3,32,1,0,15,3,12,33,20,1
3,1,2,0,15,3,12,30,23,1
4,710,2,1,3,15,-12,23,10,1
4,620,2,1,3,15,-12,46,6,1
4,533,2,0,15,3,12,32,7,1
4,179,1,0,17,3,14,50,10,1
4,50,2,1,3,17,-14,42,13,1
1,894,1,1,0,0,0,36,10,1
1,710,1,0,0,0,0,42,10,1
1,575,1,1,0,0,0,23,10,1
1,518,2,1,0,0,0,37,7,1
1,400,1,0,0,0,0,45,10,1
1,246,1,0,0,1,-1,30,15,1
1,149,1,0,0,1,-1,49,5,1
2,844,1,1,1,0,1,52,10,1
2,752,1,1,1,7,-6,42,10,1
2,711,1,1,1,14,-13,24,10,1
2,677,2,1,1,14,-13,30,4,1
2,652,1,1,1,14,-13,38,10,1
2,516,1,0,14,1,13,30,10,1
2,459,1,0,14,1,13,41,10,1
2,252,2,1,1,14,-13,35,9,1
2,202,1,0,14,1,13,29,10,1
2,130,2,1,1,14,-13,39,10,1
2,101,1,1,1,17,-16,35,10,1
2,94,1,0,17,1,16,42,10,1
2,77,2,0,17,1,16,33,1,1
2,59,1,0,17,1,16,26,10,1
3,789,2,1,4,17,-13,47,10,1
3,719,1,0,17,4,13,53,10,1
3,608,2,1,4,17,-13,43,10,1
3,491,1,0,20,4,16,51,10,1
3,375,2,1,4,20,-16,38,9,1
3,293,2,1,4,20,-16,23,8,1
3,179,1,1,4,27,-23,46,10,1
3,159,2,1,4,27,-23,46,10,1
3,103,2,0,27,4,23,54,10,1
3,86,1,0,27,4,23,40,10,1
3,36,1,0,27,4,23,27,10,1
4,894,1,0,27,11,16,33,10,1
4,801,1,1,11,27,-16,35,10,1
4,775,1,1,11,34,-23,30,10,1
4,660,2,0,34,11,23,21,10,1
4,560,2,0,34,11,23,51,20,1
4,501,1,1,11,35,-24,35,10,1
4,414,2,0,35,11,24,44,10,1
4,1,3,0,35,11,24,28,1,1
1,895,1,1,0,0,0,24,10,1
1,835,2,1,0,0,0,38,10,1
1,804,2,0,0,0,0,32,8,1
1,706,1,0,0,3,-3,37,15,1
1,670,2,0,0,3,-3,47,5,1
1,652,1,1,3,0,3,54,10,1
1,535,2,1,3,0,3,42,8,1
1,500,1,1,3,0,3,34,10,1
1,412,1,1,3,0,3,15,10,1
1,356,2,1,3,7,-4,33,12,1
1,255,1,0,7,3,4,44,10,1
1,182,1,1,3,7,-4,26,10,1
1,115,2,0,7,3,4,44,9,1
1,3,2,0,7,3,4,26,15,1
2,883,1,0,7,6,1,33,10,1
2,694,1,0,7,6,1,24,10,1
2,560,1,1,6,7,-1,25,10,1
2,528,2,1,6,7,-1,32,3,1
2,438,1,1,6,7,-1,30,10,1
2,355,1,0,14,6,8,40,10,1
2,224,2,1,6,14,-8,22,9,1
2,162,1,0,14,6,8,47,10,1
2,153,1,1,6,14,-8,27,10,1
2,148,1,1,6,14,-8,13,10,1
2,124,2,1,6,14,-8,9,6,1
3,874,1,0,21,6,15,50,10,1
3,741,2,1,6,21,-15,47,8,1
3,579,2,1,6,28,-22,37,12,1
3,555,1,0,28,6,22,43,10,1
3,440,2,0,28,6,22,34,7,1
3,370,2,1,6,28,-22,28,10,1
3,210,2,1,6,31,-25,32,13,1
4,867,2,0,31,9,22,35,10,1
4,675,2,1,9,32,-23,35,8,1
4,571,2,1,9,32,-23,7,7,1
4,481,2,1,9,32,-23,26,9,1
4,280,2,1,9,35,-26,35,10,1
4,226,1,1,9,35,-26,46,10,1
4,195,2,1,9,35,-26,52,4,1
4,149,2,0,35,9,26,12,11,1
4,87,1,1,11,35,-24,47,10,1
4,61,1,0,35,11,24,37,10,1
1,696,1,1,0,0,0,22,10,1
1,623,2,0,0,0,0,42,10,1
1,556,2,0,0,0,0,25,5,1
1,493,2,0,0,0,0,25,10,1
1,423,2,0,0,0,0,43,9,1
1,356,2,0,0,0,0,53,10,1
1,296,1,1,0,1,-1,35,10,1
1,230,2,1,0,1,-1,47,10,1
1,102,1,0,1,1,0,35,10,1
2,802,1,0,3,1,2,42,10,1
2,789,1,0,3,1,2,52,10,1
2,478,2,0,3,1,2,20,30,1
2,440,1,1,1,3,-2,8,10,1
2,265,2,1,1,3,-2,44,3,1
2,141,1,0,3,1,2,29,10,1
2,122,1,1,1,3,-2,32,10,1
2,113,1,1,1,3,-2,51,10,1
2,28,1,1,1,3,-2,48,10,1
2,21,1,0,3,1,2,33,10,1
3,894,1,0,3,4,-1,40,10,1
3,859,2,0,3,4,-1,45,5,1
3,834,1,0,3,4,-1,53,10,1
3,723,1,0,4,4,0,53,10,1
3,701,2,0,4,4,0,52,9,1
3,621,2,0,4,4,0,6,10,1
3,577,1,0,4,4,0,16,10,1
3,364,2,0,4,4,0,28,7,1
3,316,1,0,4,4,0,40,10,1
3,187,1,1,4,4,0,50,10,1
3,108,1,0,4,4,0,45,10,1
4,846,1,0,4,11,-7,25,10,1
4,831,1,0,4,11,-7,42,10,1
4,797,1,1,11,4,7,50,10,1
4,715,2,1,11,4,7,24,10,1
4,688,1,0,11,11,0,52,10,1
4,643,2,0,11,11,0,48,6,1
4,580,2,0,11,11,0,39,9,1
4,481,2,0,11,14,-3,52,10,1
4,208,1,1,14,12,2,49,10,1
4,188,2,1,14,12,2,50,9,1
4,130,2,0,12,17,-5,33,12,1
4,97,2,1,17,12,5,37,10,1
4,68,1,0,12,17,-5,32,10,1
4,62,2,0,12,17,-5,33,9,1
4,56,1,0,12,17,-5,45,10,1
1,736,1,0,0,0,0,28,10,1
1,720,2,0,0,0,0,34,4,1
1,643,2,0,0,0,0,53,3,1
1,577,2,1,0,0,0,29,3,1
1,363,1,1,0,10,-10,35,10,1
1,339,2,1,0,10,-10,38,7,1
1,277,1,0,10,0,10,31,10,1
1,201,2,0,10,0,10,52,10,1
1,140,2,1,0,17,-17,8,22,1
2,892,1,1,0,24,-24,39,10,1
2,797,2,1,0,24,-24,50,10,1
2,691,1,0,24,0,24,34,10,1
2,386,1,0,24,3,21,29,10,1
2,363,1,0,24,3,21,17,10,1
2,331,2,0,24,3,21,13,6,1
2,242,1,0,24,3,21,1,1,1
2,184,2,0,24,10,14,12,6,1
2,153,2,0,24,10,14,26,6,1
2,113,1,0,24,10,14,51,10,1
2,108,1,0,24,10,14,40,10,1
2,88,2,0,24,13,11,27,18,1
2,38,1,1,13,24,-11,52,10,1
2,32,2,0,24,13,11,51,3,1
2,27,1,0,24,13,11,43,10,1
2,2,2,0,24,13,11,10,10,1
3,765,2,0,24,19,5,28,4,1
3,696,1,0,24,19,5,20,10,1
3,617,1,0,24,22,2,35,10,1
3,436,1,1,22,24,-2,21,10,1
3,376,2,0,24,22,2,44,10,1
3,297,1,0,24,22,2,11,10,1
3,234,1,1,28,24,4,54,10,1
3,25,1,0,24,35,-11,15,15,1
4,840,2,1,35,24,11,40,10,1
4,572,2,1,35,27,8,35,10,1
4,484,2,1,35,27,8,53,7,1
4,138,2,0,27,38,-11,28,10,1
4,55,1,0,27,38,-11,47,10,1
4,42,2,0,27,38,-11,55,2,1
4,30,2,1,38,27,11,50,14,1
4,12,3,1,38,27,11,41,5,1
4,1,1,1,38,27,11,15,10,1
1,893,1,1,0,0,0,27,10,1
1,788,2,1,0,0,0,55,9,1
1,718,1,0,0,0,0,45,10,1
1,686,2,0,0,0,0,39,4,1
1,558,2,0,0,0,0,16,5,1
1,484,2,0,0,0,0,27,5,1
1,434,1,0,0,0,0,32,10,1
1,144,1,1,0,3,-3,23,10,1
1,41,2,1,0,3,-3,35,10,1
2,696,1,1,3,3,0,37,10,1
2,647,2,1,3,3,0,51,9,1
2,455,2,0,3,10,-7,42,7,1
2,368,2,1,10,3,7,34,4,1
2,327,1,1,10,3,7,27,10,1
2,185,1,1,10,10,0,28,10,1
2,159,1,1,10,10,0,39,10,1
2,138,1,0,10,10,0,53,10,1
3,894,1,0,10,10,0,26,10,1
3,777,2,0,10,10,0,40,7,1
3,688,1,1,10,10,0,33,10,1
3,522,2,1,17,10,7,50,11,1
3,478,1,0,10,17,-7,38,10,1
3,436,2,0,10,17,-7,32,4,1
3,394,1,0,10,17,-7,25,10,1
3,259,2,0,10,24,-14,33,7,1
3,129,2,0,10,24,-14,40,15,1
3,75,2,1,24,10,14,28,10,1
3,30,1,1,24,10,14,15,10,1
4,879,1,1,24,13,11,34,10,1
4,834,2,1,24,13,11,40,4,1
4,592,2,0,13,24,-11,55,10,1
4,113,1,0,14,31,-17,34,10,1
4,107,1,0,14,31,-17,46,10,1
4,92,1,1,31,14,17,27,10,1
4,69,2,1,31,14,17,12,10,1
1,841,1,1,0,0,0,46,10,1
1,813,1,1,0,0,0,30,10,1
1,774,2,1,0,0,0,24,4,1
1,745,1,1,0,0,0,19,10,1
1,716,1,1,0,0,0,3,3,1
1,627,1,1,0,3,-3,35,10,1
1,441,2,1,0,3,-3,43,10,1
1,384,2,1,0,3,-3,55,10,1
1,301,2,0,3,0,3,49,15,1
1,188,2,0,3,0,3,51,10,1
2,805,1,1,1,3,-2,47,10,1
2,725,2,0,3,1,2,52,10,1
2,675,1,0,3,1,2,13,15,1
2,665,2,0,3,1,2,25,3,1
2,605,1,1,1,3,-2,45,10,1
2,524,2,0,3,1,2,50,10,1
2,605,1,1,1,3,-2,45,10,1
2,424,1,0,3,2,1,46,10,1
2,184,1,1,2,6,-4,35,10,1
2,162,2,1,2,6,-4,40,5,1
2,145,1,1,2,6,-4,49,10,1
2,128,1,0,6,2,4,47,10,1
2,61,1,0,6,2,4,25,10,1
2,30,1,0,6,2,4,51,10,1
2,2,2,0,6,2,4,37,10,1
3,840,1,1,9,6,3,53,10,1
3,809,2,0,6,9,-3,50,3,1
3,774,1,0,6,9,-3,45,10,1
3,705,2,0,6,9,-3,33,9,1
3,578,2,0,6,9,-3,7,7,1
3,473,2,0,6,12,-6,12,12,1
3,441,1,0,6,12,-6,30,10,1
3,375,2,0,6,12,-6,45,5,1
3,344,1,1,12,6,6,43,10,1
3,312,1,1,12,13,-1,37,10,1
3,195,1,1,12,13,-1,20,10,1
3,167,1,1,12,21,-9,35,10,1
3,140,2,1,12,21,-9,39,6,1
3,60,1,0,21,12,9,13,10,1
4,900,1,0,21,12,9,38,10,1
4,880,2,0,21,12,9,35,7,1
4,761,1,1,12,21,-9,48,10,1
4,720,1,0,21,12,9,48,10,1
4,566,1,0,21,15,6,54,10,1
4,452,2,1,15,21,-6,23,3,1
4,426,1,1,15,21,-6,26,10,1
4,245,1,1,15,21,-6,37,10,1
4,170,1,0,21,15,6,35,10,1
4,97,1,1,15,21,-6,31,10,1
4,91,2,1,15,21,-6,35,6,1
4,52,1,0,21,15,6,40,10,1
4,38,1,0,21,15,6,8,8,1
4,31,1,0,21,22,-1,44,10,1
4,17,3,1,22,21,1,50,10,1
1,891,1,0,0,0,0,7,10,1
1,647,1,0,0,0,0,34,10,1
1,534,2,0,0,0,0,26,10,1
1,449,2,1,0,0,0,26,5,1
1,337,1,0,0,0,0,46,10,1
1,300,2,0,0,0,0,51,5,1
1,188,2,1,0,0,0,48,12,1
1,150,1,0,0,0,0,46,10,1
1,91,1,0,0,0,0,35,10,1
1,65,1,0,0,0,0,21,10,1
2,870,1,0,0,3,-3,35,10,1
2,825,1,0,0,3,-3,45,10,1
2,671,1,1,3,0,3,25,10,1
2,552,1,0,0,3,-3,48,10,1
2,346,1,1,6,0,6,33,10,1
2,326,1,0,0,6,-6,45,10,1
2,303,1,0,0,6,-6,33,10,1
2,233,2,0,0,6,-6,28,5,1
2,189,1,0,0,13,-13,16,15,1
2,106,1,0,0,13,-13,18,10,1
2,74,2,0,0,13,-13,29,10,1
2,56,1,0,0,13,-13,35,10,1
2,28,2,0,0,13,-13,15,10,1
3,829,2,0,0,16,-16,22,11,1
3,518,1,0,0,16,-16,42,10,1
3,493,2,0,0,16,-16,45,7,1
3,410,2,0,0,16,-16,55,9,1
3,218,2,1,16,0,16,25,10,1
3,73,2,0,0,16,-16,52,16,1
3,50,1,0,0,16,-16,20,10,1
3,0,1,0,0,16,-16,8,8,1
4,773,1,1,23,0,23,50,10,1
4,721,2,0,0,30,-30,25,10,1
4,471,2,0,0,30,-30,39,9,1
4,309,2,0,0,37,-37,25,10,1
4,288,1,0,0,37,-37,40,10,1
4,252,2,0,0,37,-37,44,6,1
1,873,2,1,0,0,0,43,10,1
1,806,1,0,0,0,0,18,10,1
1,651,2,0,0,0,0,32,12,1
1,580,2,0,0,3,-3,36,9,1
1,556,1,0,0,3,-3,47,10,1
1,466,1,1,3,3,0,35,10,1
1,219,2,0,3,3,0,26,18,1
1,73,2,0,3,3,0,6,6,1
1,35,2,0,3,10,-7,32,10,1
2,853,1,1,10,3,7,18,10,1
2,823,2,1,10,3,7,24,4,1
2,801,1,1,10,3,7,37,10,1
2,639,2,0,3,10,-7,30,18,1
2,470,2,0,3,13,-10,47,10,1
2,230,2,0,6,13,-7,19,11,1
2,110,2,0,6,13,-7,45,6,1
2,87,1,0,6,13,-7,29,10,1
2,35,2,0,6,20,-14,32,10,1
3,868,2,0,6,20,-14,41,10,1
3,832,1,0,6,20,-14,52,10,1
3,720,1,1,20,6,14,28,10,1
3,679,2,1,20,6,14,25,13,1
3,130,1,1,23,13,10,41,10,1
3,98,1,1,23,13,10,54,10,1
3,59,2,0,13,23,-10,51,5,1
4,900,2,0,13,23,-10,24,3,1
4,754,1,1,26,13,13,19,10,1
4,683,1,1,26,20,6,24,10,1
4,555,2,1,26,27,-1,49,15,1
4,423,2,0,27,26,1,4,8,1
4,60,1,0,27,32,-5,35,10,1
4,53,2,0,27,32,-5,42,3,1
4,48,1,1,32,27,5,50,10,1
4,39,1,1,32,27,5,31,10,1
1,896,1,1,0,0,0,35,10,1
1,775,1,0,0,0,0,19,10,1
1,749,1,0,0,0,0,30,10,1
1,657,1,0,0,0,0,45,10,1
1,551,2,1,0,0,0,52,9,1
1,340,2,0,1,0,1,20,5,1
1,250,2,0,1,0,1,24,12,1
1,157,2,1,0,1,-1,27,6,1
1,104,2,1,0,8,-8,41,6,1
1,0,2,0,8,0,8,5,4,1
2,791,1,0,8,7,1,44,10,1
2,764,2,0,8,7,1,41,7,1
2,722,1,0,8,7,1,18,10,1
2,682,1,0,8,7,1,7,7,1
2,666,1,0,8,14,-6,38,10,1
2,525,1,0,8,14,-6,42,10,1
2,505,1,1,14,8,6,30,10,1
2,422,2,1,14,11,3,35,10,1
2,250,1,0,11,14,-3,49,10,1
2,217,2,0,11,14,-3,54,5,1
2,180,1,1,14,11,3,38,10,1
2,41,2,0,14,14,0,44,10,1
2,35,1,1,14,14,0,53,10,1
2,24,1,1,14,14,0,41,10,1
3,856,1,0,17,14,3,42,10,1
3,822,2,0,17,14,3,44,8,1
3,685,1,1,14,17,-3,25,10,1
3,584,1,1,14,17,-3,15,10,1
3,450,2,1,14,24,-10,50,10,1
3,416,2,0,24,14,10,44,10,1
3,273,1,1,14,24,-10,45,10,1
3,237,1,1,14,24,-10,34,10,1
3,73,2,0,27,14,13,50,10,1
4,875,1,1,17,27,-10,37,10,1
4,838,1,1,17,27,-10,17,10,1
4,771,2,1,17,27,-10,10,3,1
4,748,1,1,17,34,-17,37,10,1
4,729,2,1,17,34,-17,40,7,1
4,561,1,0,34,17,17,31,15,1
4,539,2,0,34,17,17,38,8,1
4,461,2,1,17,34,-17,46,9,1
4,370,2,1,17,34,-17,35,11,1
4,220,2,1,17,37,-20,35,10,1
4,162,2,1,17,37,-20,49,10,1
4,143,2,0,37,17,20,41,10,1
4,136,1,0,37,17,20,25,10,1
4,116,2,0,37,17,20,9,5,1
1,827,2,1,0,0,0,44,10,1
1,738,2,0,0,0,0,14,9,1
1,553,1,0,0,3,-3,47,10,1
1,494,1,0,0,3,-3,17,10,1
1,465,1,0,0,10,-10,38,10,1
1,250,2,1,10,0,10,47,15,1
2,730,1,1,10,5,5,54,10,1
2,688,1,1,10,5,5,30,10,1
2,630,2,1,10,12,-2,17,5,1
2,562,1,1,10,12,-2,45,10,1
2,452,1,0,12,10,2,39,10,1
2,425,1,0,12,17,-5,34,10,1
2,388,2,0,12,17,-5,38,6,1
2,276,1,1,17,12,5,18,10,1
2,161,2,0,19,17,2,51,10,1
2,128,2,1,17,19,-2,24,10,1
2,116,2,1,17,26,-9,29,10,1
2,1,1,0,26,17,9,54,10,1
3,683,1,1,17,29,-12,35,10,1
3,450,2,0,29,17,12,42,10,1
3,364,1,1,17,29,-12,17,10,1
3,347,2,1,17,29,-12,24,3,1
3,140,1,1,17,32,-15,35,10,1
3,81,1,1,17,32,-15,48,10,1
3,38,1,0,32,17,15,37,10,1
3,1,2,0,32,17,15,40,13,1
4,807,1,1,20,32,-12,55,10,1
4,772,1,0,32,20,12,38,10,1
4,758,1,0,32,20,12,25,10,1
4,720,2,0,32,20,12,21,6,1
4,659,2,0,32,20,12,10,10,1
4,580,1,0,32,20,12,1,10,1
4,499,2,0,32,20,12,45,11,1
4,219,1,1,20,32,-12,15,10,1
4,197,1,1,20,32,-12,31,10,1
4,165,3,1,20,32,-12,39,2,1
4,143,1,0,32,20,12,52,10,1
4,121,3,0,32,20,12,38,16,1
1,872,2,0,0,0,0,39,10,1
1,710,2,1,0,0,0,30,5,1
1,555,2,1,0,0,0,39,7,1
1,554,1,1,0,0,0,3,3,1
1,409,2,0,3,0,3,41,10,1
1,296,1,0,3,0,3,27,10,1
1,133,2,1,0,3,-3,16,24,1
2,900,1,0,3,0,3,33,10,1
2,790,1,0,3,0,3,22,10,1
2,736,1,1,7,3,4,46,10,1
2,630,2,1,7,3,4,28,6,1
2,561,2,1,7,3,4,17,10,1
2,480,2,1,7,6,1,55,10,1
2,408,2,0,6,7,-1,33,3,1
2,370,1,0,6,7,-1,16,10,1
2,326,1,0,6,7,-1,5,5,1
2,252,2,0,6,7,-1,1,1,1
2,195,1,0,6,14,-8,50,10,1
2,168,2,0,6,14,-8,52,8,1
2,79,2,1,14,6,8,27,7,1
3,776,2,0,6,14,-8,48,5,1
3,673,2,1,14,6,8,51,10,1
3,628,1,1,14,6,8,25,10,1
3,465,1,1,14,9,5,25,20,1
3,418,1,0,9,14,-5,36,10,1
3,315,1,0,9,14,-5,23,10,1
3,298,1,0,9,21,-12,21,10,1
3,216,1,0,9,21,-12,32,10,1
3,175,1,0,9,21,-12,45,10,1
3,105,2,1,21,9,12,20,5,1
3,38,2,1,21,9,12,9,9,1
4,885,1,1,21,12,9,38,10,1
4,865,2,1,21,12,9,41,7,1
4,826,1,0,12,21,-9,51,10,1
4,778,1,0,12,21,-9,35,10,1
4,748,2,0,12,21,-9,31,6,1
4,716,1,0,12,21,-9,18,10,1
4,629,1,0,12,24,-12,35,10,1
4,606,1,0,12,24,-12,50,10,1
4,545,1,1,24,12,12,43,10,1
4,507,1,1,24,12,12,31,10,1
4,359,2,1,24,12,12,36,11,1
4,45,1,0,12,38,-26,43,10,1
1,818,1,1,0,0,0,24,10,1
1,778,1,1,0,0,0,38,10,1
1,740,2,1,0,0,0,45,3,1
1,502,1,1,1,0,1,52,10,1
1,350,2,1,1,0,1,46,5,1
1,215,2,1,1,1,0,45,1,1
1,185,1,1,1,1,0,50,10,1
1,18,1,0,1,1,0,17,10,1
2,900,1,1,8,1,7,27,10,1
2,567,1,0,1,8,-7,26,10,1
2,470,2,0,1,8,-7,6,6,1
2,396,1,0,1,15,-14,48,10,1
2,354,2,1,15,1,14,51,10,1
2,109,2,0,1,15,-14,40,11,1
2,73,1,0,1,15,-14,26,10,1
2,68,2,0,1,15,-14,31,5,1
2,35,1,0,1,15,-14,46,10,1
3,715,1,1,15,1,14,9,10,1
3,680,1,1,15,1,14,21,10,1
3,640,1,0,1,15,-14,51,10,1
3,595,1,0,1,15,-14,16,10,1
3,449,2,1,22,1,21,51,4,1
3,184,2,0,4,22,-18,15,8,1
4,884,1,0,11,22,-11,30,10,1
4,860,2,0,11,22,-11,36,4,1
4,740,1,1,22,11,11,35,10,1
4,647,1,1,22,11,11,10,10,1
4,617,1,1,22,19,3,30,10,1
4,503,1,1,22,19,3,48,10,1
4,395,1,1,22,19,3,23,10,1
4,85,2,1,22,27,-5,26,10,1
4,81,1,1,22,27,-5,45,10,1
4,71,2,1,22,27,-5,51,4,1
1,611,2,0,0,0,0,43,10,1
1,491,2,0,0,3,-3,47,6,1
1,431,2,1,3,0,3,41,4,1
1,391,1,1,3,0,3,26,10,1
1,309,1,1,3,0,3,14,10,1
1,181,2,1,3,3,0,29,16,1
1,81,2,0,3,3,0,28,5,1
2,792,2,0,3,3,0,49,10,1
2,665,1,0,3,6,-3,34,10,1
2,513,2,1,6,3,3,43,7,1
2,484,1,1,6,3,3,19,10,1
2,272,2,0,10,6,4,27,10,1
2,167,1,1,6,10,-4,33,20,1
2,93,2,1,6,10,-4,17,15,1
2,82,2,1,6,17,-11,12,10,1
2,74,1,1,6,17,-11,32,10,1
2,53,1,1,6,17,-11,45,10,1
2,38,2,1,6,17,-11,50,5,1
2,23,2,0,17,6,11,52,10,1
3,852,2,1,6,17,-11,34,8,1
3,677,1,0,17,6,11,5,20,1
3,532,1,0,17,8,9,32,10,1
3,458,2,0,17,8,9,45,7,1
3,316,1,1,8,20,-12,35,10,1
3,238,1,1,8,20,-12,45,10,1
3,196,1,1,8,20,-12,51,10,1
3,155,1,0,20,8,12,22,10,1
3,54,1,0,20,15,5,42,10,1
4,847,1,1,15,20,-5,35,10,1
4,810,1,1,15,20,-5,17,10,1
4,758,1,1,15,20,-5,17,10,1
4,610,2,0,27,15,12,36,7,1
4,475,1,1,15,27,-12,14,10,1
4,411,1,1,15,27,-12,44,10,1
4,390,2,1,15,27,-12,49,5,1
4,377,1,0,27,15,12,26,10,1
4,322,1,0,27,15,12,7,7,1
4,180,2,1,22,27,-5,46,13,1
4,115,1,1,22,30,-8,35,10,1
4,84,1,0,30,22,8,3,3,1
4,68,2,0,30,28,2,17,7,1
4,8,2,0,30,28,2,53,10,1
1,858,2,0,0,0,0,34,5,1
1,781,2,0,0,0,0,45,5,1
1,720,1,1,0,0,0,36,15,1
1,654,2,1,0,0,0,24,3,1
1,624,1,1,0,7,-7,53,10,1
1,440,2,0,7,0,7,23,3,1
1,324,2,0,7,0,7,33,6,1
1,217,1,1,0,8,-8,35,10,1
1,81,1,1,0,8,-8,34,10,1
1,20,2,0,8,0,8,36,10,1
2,843,2,0,8,3,5,49,4,1
2,691,1,0,8,3,5,55,10,1
2,623,1,1,3,8,-5,45,10,1
2,550,1,1,3,8,-5,32,10,1
2,435,2,1,3,15,-12,26,10,1
2,306,1,0,15,3,12,25,10,1
2,278,1,0,15,3,12,37,10,1
2,105,2,1,3,22,-19,37,10,1
2,97,1,1,3,22,-19,49,10,1
2,92,1,0,22,3,19,47,10,1
3,895,1,1,6,22,-16,28,10,1
3,854,2,1,6,22,-16,28,10,1
3,793,1,1,6,22,-16,55,10,1
3,750,1,0,22,6,16,41,10,1
3,661,2,0,22,6,16,5,5,1
3,300,2,0,22,16,6,44,10,1
3,263,1,1,16,22,-6,20,10,1
3,235,2,1,16,22,-6,17,13,1
3,170,2,1,16,22,-6,35,8,1
4,815,2,1,16,23,-7,20,10,1
4,775,2,1,16,23,-7,41,4,1
4,714,2,0,23,16,7,41,8,1
4,626,2,0,23,19,4,37,8,1
4,558,1,0,23,19,4,49,10,1
4,484,2,1,19,23,-4,52,14,1
4,412,1,1,19,23,-4,15,10,1
4,378,1,1,19,30,-11,23,10,1
4,204,1,0,30,19,11,46,15,1
4,76,1,1,19,33,-14,35,10,1
1,893,1,0,0,0,0,32,10,1
1,871,2,0,0,0,0,26,4,1
1,828,1,0,0,0,0,22,10,1
1,785,2,0,0,0,0,23,11,1
1,585,1,1,3,0,3,25,10,1
1,494,1,0,0,3,-3,35,10,1
1,384,2,0,0,3,-3,48,7,1
1,330,1,1,3,0,3,49,10,1
1,118,2,1,3,1,2,24,10,1
2,815,1,0,8,3,5,43,10,1
2,724,1,0,8,3,5,55,10,1
2,684,2,1,3,8,-5,51,6,1
2,632,1,1,3,9,-6,35,10,1
2,552,1,1,3,9,-6,50,10,1
2,495,1,0,9,3,6,40,10,1
2,443,1,0,9,3,6,20,10,1
2,319,1,0,9,10,-1,25,10,1
2,141,2,1,17,9,8,21,10,1
2,105,1,1,17,16,1,39,10,1
2,94,2,1,17,16,1,50,15,1
2,55,2,0,16,17,-1,26,7,1
2,22,1,1,17,16,1,36,10,1
2,20,1,1,17,16,1,47,10,1
3,895,1,1,17,16,1,41,10,1
3,771,2,0,16,17,-1,27,9,1
3,282,2,1,17,17,0,38,7,1
3,262,1,1,17,17,0,50,10,1
3,246,2,0,17,17,0,54,4,1
3,198,1,0,17,17,0,38,10,1
4,854,2,0,17,17,0,3,13,1
4,773,2,0,17,17,0,53,10,1
4,630,1,1,19,17,2,47,10,1
4,586,1,0,17,19,-2,52,10,1
4,546,2,0,17,19,-2,39,10,1
4,462,2,0,17,19,-2,15,4,1
4,379,2,0,17,19,-2,11,10,1
4,205,1,1,26,20,6,50,10,1
4,179,1,0,20,26,-6,49,10,1
4,47,1,0,20,27,-7,46,10,1
4,40,2,0,20,27,-7,53,3,1
1,855,2,0,0,0,0,38,6,1
1,764,2,0,0,0,0,48,8,1
1,672,2,1,0,0,0,53,7,1
1,609,1,0,0,0,0,22,10,1
1,533,1,1,0,0,0,55,10,1
1,477,1,0,0,0,0,48,20,1
1,455,2,0,0,0,0,40,12,1
1,309,1,0,0,3,-3,43,5,1
1,154,1,1,3,0,3,41,10,1
2,729,1,1,3,0,3,7,7,1
2,678,2,1,3,0,3,6,6,1
2,621,2,1,3,7,-4,36,9,1
2,570,1,0,7,3,4,47,10,1
2,509,1,0,7,3,4,23,10,1
2,440,2,0,7,3,4,36,6,1
2,416,1,1,3,7,-4,29,10,1
2,303,2,1,3,7,-4,8,6,1
2,157,2,1,3,15,-12,30,7,1
2,104,1,1,3,15,-12,49,10,1
2,48,1,0,15,3,12,25,10,1
2,29,2,0,15,3,12,45,10,1
2,14,2,1,3,15,-12,40,10,1
3,736,1,1,10,16,-6,46,10,1
3,693,1,1,10,16,-6,21,10,1
3,572,2,1,10,23,-13,27,9,1
3,416,2,0,23,10,13,25,9,1
3,215,1,1,10,23,-13,48,10,1
4,738,2,0,25,10,15,27,21,1
4,676,1,1,10,25,-15,33,10,1
4,635,1,0,25,10,15,36,10,1
4,616,1,0,25,10,15,16,10,1
4,501,1,0,25,10,15,50,10,1
4,387,1,1,10,28,-18,35,10,1
4,350,2,1,10,28,-18,42,3,1
4,290,2,1,10,28,-18,55,10,1
4,260,1,0,28,10,18,43,10,1
4,180,2,0,28,10,18,23,10,1
4,133,3,0,28,10,18,15,15,1
4,19,1,1,17,31,-14,48,10,1
1,822,1,1,0,0,0,11,10,1
1,805,1,1,0,7,-7,34,10,1
1,626,1,1,0,7,-7,46,15,1
1,614,2,1,0,7,-7,50,19,1
1,533,2,1,0,7,-7,18,8,1
1,450,1,1,0,7,-7,24,10,1
1,403,2,1,0,7,-7,19,5,1
1,159,2,0,21,0,21,47,8,1
1,85,2,1,0,21,-21,43,10,1
2,900,1,1,0,21,-21,14,10,1
2,841,1,1,0,21,-21,25,10,1
2,787,2,1,0,21,-21,47,5,1
2,750,1,0,21,0,21,7,10,1
2,655,2,0,21,0,21,28,10,1
2,412,1,1,0,21,-21,53,10,1
2,393,1,1,0,21,-21,40,10,1
2,356,2,1,0,21,-21,35,5,1
2,291,2,1,0,21,-21,26,10,1
2,227,1,1,0,21,-21,14,10,1
2,146,2,0,28,0,28,50,10,1
2,101,1,1,0,28,-28,39,10,1
2,80,2,1,0,28,-28,38,9,1
2,32,1,1,0,31,-31,35,10,1
2,21,2,0,31,0,31,52,10,1
3,822,2,0,31,3,28,27,14,1
3,691,2,0,31,3,28,39,7,1
3,390,1,1,3,31,-28,49,10,1
3,18,1,1,3,32,-29,30,10,1
4,866,2,0,32,3,29,48,10,1
4,821,2,0,32,10,22,20,12,1
4,765,1,1,10,32,-22,52,10,1
4,693,1,0,32,10,22,47,10,1
4,618,2,0,32,10,22,31,10,1
4,193,2,1,13,35,-22,26,19,1
4,31,1,1,13,38,-25,35,10,1
4,23,1,1,13,38,-25,53,10,1
1,638,1,1,7,0,7,50,10,1
1,316,1,0,0,13,-13,26,10,1
1,276,2,0,0,13,-13,33,3,1
1,110,2,1,13,0,13,55,7,1
2,783,2,0,0,16,-16,30,15,1
2,596,1,1,16,0,16,20,10,1
2,577,1,1,16,7,9,32,10,1
2,513,2,0,7,16,-9,52,7,1
2,441,2,0,7,16,-9,13,4,1
2,346,1,1,16,7,9,27,10,1
2,267,1,1,16,7,9,45,10,1
2,180,1,0,7,16,-9,44,10,1
2,166,2,0,7,16,-9,38,4,1
2,96,1,1,23,7,16,29,10,1
2,75,2,1,23,7,16,46,5,1
2,16,2,0,7,23,-16,47,10,1
2,10,3,0,7,23,-16,42,5,1
3,831,2,1,26,7,19,35,6,1
3,792,1,1,26,7,19,25,10,1
3,640,1,0,10,26,-16,35,10,1
3,605,1,0,10,26,-16,49,10,1
3,561,2,1,26,10,16,12,5,1
3,496,1,1,26,10,16,3,3,1
3,481,1,1,26,17,9,29,10,1
3,461,1,1,26,17,9,41,10,1
3,278,1,1,26,17,9,19,10,1
3,92,1,1,26,17,9,11,10,1
3,42,1,1,26,20,6,35,10,1
4,615,1,1,28,20,8,55,10,1
4,574,1,0,20,28,-8,40,10,1
4,510,1,0,20,28,-8,25,10,1
4,475,1,0,20,35,-15,35,10,1
4,407,1,0,20,35,-15,51,10,1
4,311,1,1,35,20,15,23,10,1
4,148,1,0,27,42,-15,40,10,1
4,123,1,1,42,27,15,45,10,1
4,112,2,1,42,27,15,40,5,1
1,875,1,1,0,0,0,42,5,1
1,792,2,0,0,0,0,53,20,1
1,731,1,0,0,0,0,22,10,1
1,632,2,1,0,0,0,18,10,1
1,566,1,1,0,0,0,6,6,1
1,543,1,1,0,7,-7,19,20,1
1,540,2,1,0,7,-7,25,14,1
1,445,2,1,0,7,-7,54,5,1
1,409,1,0,7,0,7,40,10,1
1,384,2,0,7,0,7,34,4,1
1,274,1,0,7,0,7,17,10,1
1,190,2,1,0,7,-7,22,1,1
1,176,1,1,0,14,-14,28,10,1
1,130,1,0,14,0,14,37,10,1
2,601,1,1,3,21,-18,24,10,1
2,566,1,1,3,21,-18,35,10,1
2,487,1,0,21,3,18,30,10,1
2,413,1,1,3,21,-18,40,10,1
2,185,2,1,3,24,-21,41,4,1
2,110,1,1,3,24,-21,12,10,1
2,82,2,1,3,24,-21,6,4,1
2,54,2,0,31,3,28,28,7,1
3,778,2,1,3,31,-28,37,10,1
3,760,1,1,3,31,-28,50,10,1
3,700,1,0,31,3,28,25,10,1
3,672,2,0,31,3,28,27,8,1
3,602,1,1,3,31,-28,42,10,1
3,575,1,0,31,3,28,54,10,1
3,557,1,0,31,3,28,43,10,1
3,443,2,0,31,3,28,32,8,1
3,244,2,1,3,32,-29,32,13,1
3,130,2,0,32,3,29,50,5,1
4,865,2,1,3,32,-29,21,10,1
4,791,1,0,39,3,36,48,10,1
4,633,1,1,3,40,-37,30,15,1
4,608,2,1,3,40,-37,51,10,1
4,538,2,0,40,3,37,31,5,1
4,319,1,0,40,10,30,41,10,1
4,270,1,0,40,10,30,6,10,1
4,180,3,0,40,17,23,7,7,1
4,64,2,1,24,47,-23,48,3,1
1,896,1,0,0,0,0,30,10,1
1,843,2,0,0,0,0,42,8,1
1,801,1,1,0,0,0,54,10,1
1,685,1,1,0,3,-3,35,10,1
1,535,1,0,3,0,3,9,10,1
1,501,1,0,3,0,3,21,10,1
1,467,2,0,3,0,3,30,1,1
1,409,1,1,0,3,-3,38,10,1
1,385,1,1,0,3,-3,28,10,1
1,271,1,1,0,3,-3,1,1,1
1,248,1,1,0,10,-10,49,10,1
1,213,2,1,0,10,-10,54,5,1
1,98,1,0,10,0,10,29,10,1
1,41,1,0,10,0,10,40,15,1
2,828,2,1,0,10,-10,9,8,1
2,764,1,1,0,10,-10,48,10,1
2,678,2,0,10,0,10,47,6,1
2,507,1,0,10,0,10,6,6,1
2,494,1,0,10,7,3,25,10,1
2,455,2,0,10,7,3,30,5,1
2,200,2,0,10,7,3,45,13,1
2,158,1,1,7,10,-3,25,10,1
2,152,1,1,7,17,-10,17,10,1
2,147,1,1,7,17,-10,35,10,1
2,96,1,0,17,7,10,54,10,1
2,46,2,0,17,7,10,49,10,1
2,29,2,1,7,17,-10,54,15,1
3,894,1,1,7,17,-10,9,10,1
3,803,1,1,7,17,-10,31,10,1
3,693,1,1,7,17,-10,51,10,1
3,339,1,1,7,17,-10,13,10,1
3,310,2,1,7,17,-10,13,10,1
3,138,2,1,7,17,-10,8,5,1
4,819,1,1,8,24,-16,39,10,1
4,684,2,0,24,11,13,31,10,1
4,630,1,0,24,11,13,46,10,1
4,577,2,1,11,24,-13,46,6,1
4,417,2,1,11,27,-16,40,10,1
4,302,2,1,11,34,-23,35,10,1
4,247,2,0,34,11,23,51,12,1
4,204,3,0,34,11,23,46,7,1
4,108,1,1,18,34,-16,16,10,1
1,889,1,1,0,0,0,38,10,1
1,738,1,0,0,0,0,40,10,1
1,565,1,0,0,3,-3,30,15,1
1,496,1,1,3,0,3,36,10,1
1,468,1,1,3,0,3,54,10,1
1,273,1,1,10,3,7,33,10,1
1,190,2,0,3,10,-7,38,5,1
1,145,1,0,3,10,-7,32,10,1
1,53,2,0,3,17,-14,20,10,1
1,25,1,0,3,17,-14,36,10,1
2,900,2,0,3,17,-14,41,5,1
2,778,1,1,17,3,14,18,15,1
2,770,1,1,17,3,14,38,10,1
2,747,2,1,17,3,14,44,4,1
2,628,1,0,3,18,-15,35,10,1
2,531,1,1,18,3,15,20,10,1
2,374,2,0,3,18,-15,10,10,1
2,293,1,0,3,18,-15,48,10,1
2,269,2,0,3,18,-15,48,10,1
2,179,1,1,18,4,14,35,10,1
2,122,1,0,4,18,-14,36,10,1
2,79,1,0,4,18,-14,24,10,1
2,52,1,1,25,4,21,35,10,1
3,805,2,0,4,25,-21,44,14,1
3,537,1,0,4,28,-24,40,10,1
3,503,2,0,4,28,-24,46,4,1
3,340,1,1,28,4,24,3,10,1
3,270,1,1,28,4,24,39,5,1
3,185,2,0,4,28,-24,36,10,1
3,86,2,1,35,11,24,22,11,1
4,812,2,0,11,35,-24,43,10,1
4,710,2,0,11,38,-27,35,10,1
4,496,2,1,38,11,27,33,10,1
4,437,1,0,11,38,-27,28,10,1
4,349,2,0,11,38,-27,41,10,1
4,280,1,1,38,11,27,37,10,1
4,230,1,1,38,11,27,47,10,1
4,26,2,0,11,38,-27,8,7,1
1,863,2,0,0,0,0,35,7,1
1,772,2,1,0,0,0,40,5,1
1,669,1,0,0,0,0,22,10,1
1,660,2,0,0,0,0,28,4,1
1,531,1,1,0,3,-3,51,10,1
1,389,2,0,3,0,3,21,10,1
1,367,1,0,3,7,-4,40,10,1
1,190,2,1,7,3,4,40,10,1
2,812,1,0,4,7,-3,28,10,1
2,743,1,1,7,4,3,42,10,1
2,504,1,1,8,4,4,17,10,1
2,267,2,1,8,7,1,45,10,1
2,106,1,1,8,7,1,41,10,1
2,60,1,0,7,8,-1,44,10,1
2,34,1,0,7,8,-1,41,10,1
3,878,1,1,8,7,1,35,10,1
3,677,2,0,10,8,2,54,10,1
3,450,2,0,10,9,1,29,9,1
3,416,1,0,10,9,1,51,10,1
3,112,2,1,11,11,0,45,5,1
3,81,1,1,11,11,0,52,10,1
4,815,2,0,11,14,-3,37,2,1
4,750,2,1,14,11,3,44,8,1
4,602,2,1,14,14,0,36,9,1
4,576,1,1,14,14,0,47,10,1
4,525,2,1,14,14,0,51,6,1
4,344,2,0,14,14,0,41,10,1
4,280,2,1,14,14,0,54,14,1
4,179,2,1,14,14,0,18,25,1
4,99,1,1,14,21,-7,26,10,1
4,91,1,1,14,21,-7,41,10,1
4,62,2,1,14,21,-7,45,6,1
1,890,1,0,0,0,0,37,10,1
1,830,2,0,0,0,0,19,6,1
1,356,2,0,0,3,-3,40,7,1
1,128,1,0,0,10,-10,39,10,1
1,39,1,0,0,13,-13,35,10,1
1,3,2,0,0,13,-13,34,11,1
2,777,1,1,13,3,10,50,10,1
2,663,1,0,3,16,-13,34,10,1
2,641,1,1,16,3,13,48,10,1
2,538,1,1,16,4,12,35,10,1
2,482,1,1,16,4,12,46,10,1
2,445,2,1,16,4,12,48,8,1
2,355,2,0,4,16,-12,50,8,1
2,292,2,0,4,16,-12,39,10,1
2,263,1,0,4,16,-12,14,10,1
2,159,2,0,4,19,-15,41,10,1
2,154,1,0,4,19,-15,52,10,1
2,134,1,1,19,4,15,47,10,1
2,119,2,1,19,4,15,41,4,1
2,105,1,1,19,4,15,27,10,1
2,96,1,1,19,11,8,43,10,1
2,91,1,1,19,11,8,53,10,1
2,74,2,0,11,19,-8,44,10,1
3,810,2,1,19,11,8,52,6,1
3,696,2,0,11,19,-8,9,4,1
3,588,2,0,11,19,-8,20,10,1
3,471,2,0,11,26,-15,50,10,1
3,389,2,1,26,11,15,21,10,1
3,259,2,1,26,18,8,15,10,1
3,29,1,0,18,26,-8,40,10,1
4,900,1,1,26,18,8,24,10,1
4,821,1,0,18,26,-8,49,10,1
4,713,1,0,18,26,-8,45,10,1
4,698,2,0,18,26,-8,50,5,1
4,640,2,1,26,18,8,31,8,1
4,601,1,1,26,18,8,18,10,1
4,493,1,1,26,18,8,6,6,1
4,471,1,1,26,26,0,50,10,1
4,336,2,0,26,26,0,6,6,1
4,192,1,1,33,26,7,19,10,1
4,95,2,0,26,33,-7,45,10,1
4,61,1,0,26,40,-14,41,10,1
4,19,1,1,40,26,14,46,10,1
1,894,1,1,0,0,0,32,10,1
1,832,2,1,0,0,0,49,6,1
1,817,1,0,0,0,0,52,10,1
1,752,1,0,0,0,0,40,10,1
1,736,1,0,0,7,-7,33,10,1
1,673,1,0,0,7,-7,50,10,1
1,465,2,0,0,7,-7,28,16,1
1,347,1,1,7,0,7,51,10,1
1,308,1,1,7,0,7,31,10,1
1,259,1,1,7,0,7,17,15,1
1,215,2,1,7,0,7,12,10,1
1,28,1,0,7,14,-7,45,10,1
2,803,1,1,14,7,7,14,10,1
2,730,2,1,14,7,7,9,15,1
2,685,2,0,7,14,-7,47,10,1
2,418,1,1,14,9,5,14,10,1
2,398,1,1,14,16,-2,28,10,1
2,236,1,0,16,14,2,16,10,1
2,77,1,0,16,21,-5,7,10,1
2,16,1,1,21,16,5,47,10,1
3,603,1,1,21,16,5,16,10,1
3,572,2,1,21,16,5,22,4,1
3,323,1,1,21,16,5,29,10,1
3,213,1,1,21,19,2,29,10,1
3,166,2,1,21,19,2,49,10,1
3,94,2,0,19,21,-2,25,10,1
3,30,1,1,21,19,2,39,10,1
4,880,2,1,21,19,2,55,7,1
4,513,1,0,19,24,-5,35,10,1
4,474,2,0,19,24,-5,38,7,1
4,372,3,0,19,24,-5,52,6,1
4,318,1,1,24,19,5,36,10,1
4,235,1,1,24,22,2,35,10,1
4,71,1,0,22,26,-4,37,10,1
4,66,1,0,22,26,-4,52,10,1
4,50,1,1,26,22,4,45,10,1
4,33,2,1,26,22,4,40,5,1
1,778,2,1,0,0,0,34,3,1
1,635,2,0,0,0,0,30,5,1
1,530,2,0,0,0,0,54,5,1
1,274,1,1,0,3,-3,30,10,1
1,239,2,1,0,3,-3,35,5,1
1,176,2,1,0,3,-3,43,7,1
1,117,2,0,3,0,3,54,10,1
1,50,1,0,3,0,3,40,10,1
2,865,2,0,3,0,3,20,3,1
2,840,1,0,3,7,-4,41,10,1
2,764,1,1,7,3,4,55,10,1
2,712,1,0,3,7,-4,29,10,1
2,531,2,0,3,14,-11,25,10,1
2,287,2,1,14,3,11,41,7,1
2,145,2,0,3,14,-11,19,6,1
2,121,2,0,3,14,-11,26,10,1
2,12,2,1,14,3,11,24,10,1
3,865,2,0,3,14,-11,38,4,1
3,562,2,1,14,4,10,24,5,1
3,48,2,0,9,14,-5,40,12,1
4,900,2,1,14,9,5,16,6,1
4,847,2,1,14,9,5,42,4,1
4,689,2,0,9,14,-5,25,8,1
4,645,1,0,9,14,-5,16,10,1
4,531,2,0,9,14,-5,3,13,1
4,499,1,0,9,14,-5,25,10,1
4,418,1,0,9,14,-5,24,15,1
4,392,1,0,9,14,-5,43,10,1
4,165,1,1,14,9,5,53,10,1
4,142,3,1,14,9,5,48,5,1
4,93,2,1,14,9,5,8,10,1
1,892,1,1,0,0,0,31,10,1
1,856,1,1,0,0,0,45,10,1
1,822,1,0,0,0,0,54,10,1
1,708,3,0,0,0,0,45,1,1
1,690,1,0,0,7,-7,44,10,1
1,663,1,1,7,0,7,51,10,1
1,646,1,1,7,0,7,20,10,1
1,599,2,1,7,0,7,9,9,1
1,477,1,1,7,3,4,43,10,1
1,400,2,0,3,7,-4,50,6,1
1,330,2,0,3,7,-4,11,10,1
1,311,1,0,3,7,-4,23,10,1
1,225,2,0,3,7,-4,55,15,1
1,150,2,1,7,3,4,37,9,1
1,110,1,1,7,6,1,35,10,1
1,2,2,0,6,7,-1,45,7,1
2,797,1,1,7,9,-2,49,10,1
2,718,1,0,9,7,2,27,10,1
2,630,1,0,9,7,2,8,8,1
2,572,1,0,9,14,-5,44,10,1
2,548,2,0,9,14,-5,50,4,1
2,386,1,1,14,9,5,27,10,1
2,370,2,1,14,9,5,34,3,1
2,293,2,1,14,9,5,35,18,1
2,192,2,0,9,14,-5,7,8,1
2,154,1,0,9,14,-5,45,10,1
2,102,1,1,14,9,5,4,4,1
2,95,1,1,14,16,-2,31,10,1
2,88,1,1,14,16,-2,55,10,1
2,74,1,0,16,14,2,34,10,1
2,66,2,0,16,14,2,25,1,1
2,43,1,0,16,14,2,15,15,1
3,893,1,0,16,17,-1,41,10,1
3,796,1,1,17,16,1,20,10,1
3,727,1,1,17,16,1,46,10,1
3,691,2,1,17,16,1,52,4,1
3,635,1,0,16,17,-1,31,10,1
3,621,1,0,16,24,-8,10,10,1
3,509,1,0,16,24,-8,54,10,1
3,289,1,1,26,16,10,46,10,1
3,271,1,0,16,26,-10,26,10,1
3,111,2,0,16,33,-17,53,12,1
3,50,1,1,33,16,17,36,10,1
4,900,2,0,16,33,-17,51,5,1
4,776,1,0,16,33,-17,15,20,1
4,737,1,1,33,16,17,44,10,1
4,541,1,0,17,33,-16,41,10,1
4,512,1,0,17,33,-16,55,10,1
4,455,3,1,33,17,16,47,2,1
4,426,1,1,33,17,16,30,10,1
4,357,2,1,33,17,16,22,2,1
4,301,2,1,33,23,10,24,9,1
4,186,1,1,33,23,10,45,10,1
4,171,1,1,33,23,10,30,10,1
4,158,2,1,33,23,10,28,8,1
4,130,1,1,33,26,7,35,10,1
4,123,2,1,33,26,7,37,8,1
4,65,1,0,26,36,-10,35,10,1
4,52,1,0,26,36,-10,52,10,1
4,43,1,1,36,26,10,42,10,1
4,32,2,1,36,26,10,37,5,1
4,1,2,1,36,26,10,34,20,1
1,894,1,0,0,0,0,39,10,1
1,415,1,1,0,3,-3,26,10,1
1,359,2,1,0,3,-3,40,9,1
1,279,2,0,3,0,3,45,10,1
1,28,1,1,0,3,-3,17,10,1
2,890,1,1,0,10,-10,50,10,1
2,830,1,0,10,0,10,39,10,1
2,747,2,0,10,0,10,26,11,1
2,668,2,1,0,10,-10,55,5,1
2,543,2,0,10,0,10,28,3,1
2,437,2,0,10,0,10,12,10,1
2,411,1,0,10,7,3,44,10,1
2,313,1,0,10,7,3,36,10,1
2,282,2,0,10,7,3,39,7,1
2,226,1,1,7,10,-3,55,10,1
2,169,1,0,10,7,3,42,10,1
2,140,1,0,10,7,3,41,20,1
2,83,1,0,10,17,-7,33,10,1
2,75,1,1,17,10,7,54,10,1
2,55,2,1,17,10,7,47,3,1
2,9,2,1,17,10,7,40,10,1
3,840,2,0,17,17,0,51,9,1
3,782,1,0,17,17,0,40,10,1
3,684,1,0,17,17,0,8,9,1
3,612,1,0,17,20,-3,32,10,1
3,525,2,0,17,20,-3,45,10,1
3,428,2,1,20,17,3,35,14,1
3,319,1,1,20,24,-4,43,10,1
3,257,2,1,20,24,-4,55,10,1
3,187,2,0,24,20,4,41,8,1
3,107,1,0,24,23,1,39,10,1
4,472,1,1,26,31,-5,42,10,1
4,375,2,0,31,26,5,33,10,1
4,308,1,1,26,31,-5,49,10,1
4,276,2,1,26,31,-5,55,4,1
4,241,1,0,31,26,5,38,10,1
4,152,2,0,31,27,4,38,7,1
1,672,2,0,0,0,0,42,19,1
1,610,1,1,0,0,0,46,10,1
1,478,2,1,0,3,-3,40,5,1
1,385,2,0,5,0,5,49,4,1
1,305,1,1,0,5,-5,29,10,1
1,260,1,1,0,5,-5,10,10,1
1,64,1,1,0,12,-12,16,10,1
2,842,2,0,12,0,12,44,20,1
2,816,3,1,0,12,-12,53,7,1
2,712,1,1,0,12,-12,30,10,1
2,483,2,1,0,12,-12,35,12,1
2,397,1,1,0,15,-15,33,10,1
2,370,1,0,15,0,15,25,10,1
2,296,2,0,15,0,15,7,7,1
2,218,3,0,15,0,15,3,3,1
2,116,1,1,7,15,-8,27,10,1
3,673,1,1,14,28,-14,19,20,1
3,518,1,0,28,21,7,44,10,1
3,155,1,0,28,24,4,32,10,1
3,57,2,1,24,28,-4,37,10,1
4,900,2,0,28,24,4,38,10,1
4,753,2,0,28,27,1,15,12,1
4,724,1,0,28,27,1,31,10,1
4,637,2,0,28,27,1,51,15,1
4,462,1,1,27,31,-4,29,10,1
4,361,2,0,38,33,5,26,19,1
4,48,1,1,36,38,-2,5,10,1
4,33,3,1,36,38,-2,10,5,1
4,22,2,1,36,38,-2,31,10,1
4,9,2,1,36,38,-2,46,10,1
1,865,1,1,0,0,0,45,10,1
1,830,1,0,0,0,0,54,10,1
1,760,1,0,0,0,0,43,10,1
1,703,1,0,0,0,0,32,10,1
1,590,1,0,0,0,0,19,10,1
1,513,2,0,0,7,-7,44,6,1
1,170,1,0,4,7,-3,52,10,1
1,49,2,1,7,4,3,25,10,1
2,779,1,1,7,7,0,15,10,1
2,739,1,1,7,7,0,25,10,1
2,684,2,1,7,7,0,17,18,1
2,651,1,0,7,7,0,42,10,1
2,592,2,1,7,7,0,54,9,1
2,453,1,1,7,7,0,20,10,1
2,421,1,1,7,14,-7,37,10,1
2,265,2,0,14,7,7,14,20,1
2,220,1,1,7,14,-7,40,10,1
2,190,1,0,14,7,7,31,10,1
2,147,2,0,14,7,7,7,3,1
2,104,1,0,14,14,0,48,10,1
2,76,2,1,14,14,0,30,10,1
2,69,1,1,14,21,-7,28,10,1
2,49,2,1,14,21,-7,42,10,1
3,629,1,0,21,14,7,13,10,1
3,582,1,0,21,14,7,24,10,1
3,403,1,1,14,21,-7,27,10,1
3,380,1,1,14,21,-7,38,10,1
3,134,2,0,21,14,7,49,10,1
3,18,2,1,14,21,-7,44,6,1
3,2,1,1,14,21,-7,35,10,1
4,763,1,1,14,22,-8,21,10,1
4,634,1,1,14,29,-15,31,10,1
4,600,2,1,14,29,-15,35,6,1
4,516,2,0,29,14,15,41,11,1
4,459,1,1,14,29,-15,21,10,1
4,391,2,1,14,29,-15,36,15,1
4,295,2,0,29,14,15,50,5,1
1,790,1,0,0,0,0,41,10,1
1,732,1,1,0,0,0,32,10,1
1,693,2,1,0,0,0,39,3,1
1,629,2,1,0,0,0,51,7,1
1,565,1,0,0,0,0,55,10,1
1,525,1,1,0,0,0,29,10,1
1,447,2,1,0,1,-1,35,10,1
1,361,1,0,1,0,1,47,10,1
1,99,2,0,1,2,-1,28,15,1
2,900,2,0,1,9,-8,31,22,1
2,847,1,1,9,1,8,16,10,1
2,820,1,1,9,1,8,28,10,1
2,675,1,1,9,1,8,41,10,1
2,647,2,1,9,1,8,47,4,1
2,580,1,1,9,1,8,52,10,1
2,561,2,1,9,1,8,55,7,1
2,528,1,0,1,9,-8,11,10,1
2,429,1,0,1,16,-15,34,10,1
2,306,2,0,1,16,-15,52,16,1
2,172,1,0,1,16,-15,31,10,1
2,159,2,0,1,16,-15,30,11,1
2,122,1,1,16,1,15,41,10,1
2,79,1,1,16,1,15,32,25,1
2,53,1,1,16,8,8,43,10,1
3,891,1,1,16,8,8,46,10,1
3,868,2,1,16,8,8,51,5,1
3,800,1,0,8,16,-8,45,10,1
3,768,2,0,8,16,-8,39,4,1
3,748,1,0,8,16,-8,25,10,1
3,688,2,0,8,16,-8,21,6,1
3,633,1,0,8,23,-15,33,10,1
3,506,2,1,23,8,15,34,7,1
3,397,1,0,8,23,-15,52,10,1
3,360,2,0,8,23,-15,48,6,1
3,251,1,0,8,24,-16,35,10,1
3,200,1,1,24,8,16,43,10,1
3,123,2,1,24,8,16,33,10,1
3,99,1,1,24,8,16,10,10,1
3,8,1,1,24,11,13,26,10,1
4,860,1,1,24,11,13,37,10,1
4,713,1,0,11,24,-13,38,5,1
4,700,2,0,11,24,-13,40,3,1
4,677,1,0,11,24,-13,44,10,1
4,497,2,1,24,11,13,12,10,1
4,472,1,1,24,18,6,26,10,1
4,452,2,1,24,18,6,33,3,1
4,242,1,0,18,24,-6,4,10,1
4,176,1,0,18,24,-6,19,10,1
4,160,2,0,18,24,-6,22,7,1
4,148,1,0,18,24,-6,35,10,1
4,130,1,0,18,24,-6,45,10,1
4,112,1,1,24,18,6,51,10,1
1,893,1,0,0,0,0,32,10,1
1,814,1,1,0,0,0,45,10,1
1,792,1,0,0,0,0,52,10,1
1,704,1,0,0,0,0,29,10,1
1,585,2,1,7,0,7,27,10,1
1,540,1,1,7,0,7,38,10,1
1,438,1,0,0,7,-7,40,10,1
1,383,2,0,0,7,-7,35,5,1
1,294,1,1,10,0,10,31,10,1
1,250,2,1,10,0,10,48,10,1
1,199,1,0,0,10,-10,40,10,1
1,114,1,0,0,10,-10,29,10,1
1,0,2,0,0,10,-10,10,8,1
2,794,1,1,17,0,17,2,12,1
2,747,2,1,17,0,17,37,10,1
2,648,2,0,0,17,-17,41,3,1
2,507,1,0,0,17,-17,25,10,1
2,340,1,1,24,0,24,23,10,1
2,321,2,1,24,0,24,23,10,1
2,238,1,1,24,0,24,50,10,1
2,168,1,1,24,0,24,23,10,1
2,95,1,1,24,3,21,40,10,1
2,75,1,1,24,3,21,27,10,1
2,45,1,1,24,3,21,13,10,1
3,819,2,0,6,24,-18,54,6,1
3,667,1,1,24,7,17,47,10,1
3,585,1,0,7,24,-17,52,10,1
3,451,1,0,7,24,-17,16,10,1
3,443,2,0,7,24,-17,23,3,1
3,235,2,0,7,24,-17,35,15,1
3,196,1,1,24,7,17,24,10,1
3,68,1,0,7,24,-17,22,10,1
4,900,2,0,7,24,-17,10,10,1
4,836,2,0,7,27,-20,40,10,1
4,773,1,1,27,7,20,9,10,1
4,644,2,1,27,14,13,42,7,1
4,551,1,0,14,27,-13,26,10,1
4,336,1,1,27,14,13,40,10,1
4,278,2,1,27,14,13,55,6,1
4,240,1,0,14,27,-13,33,10,1
4,161,2,0,14,27,-13,15,10,1
4,123,1,0,14,34,-20,27,10,1
4,117,2,0,14,34,-20,34,3,1
4,33,2,0,14,37,-23,37,8,1
1,871,2,1,0,0,0,27,10,1
1,733,1,0,0,3,-3,35,10,1
1,702,2,0,0,3,-3,44,1,1
1,486,1,0,3,3,0,26,10,1
1,373,2,1,3,3,0,28,8,1
1,285,2,0,3,3,0,33,4,1
1,231,1,1,3,3,0,34,10,1
1,144,1,0,3,3,0,33,10,1
1,70,1,1,3,3,0,54,10,1
1,49,1,1,3,3,0,42,10,1
2,900,2,1,3,3,0,38,19,1
2,820,2,1,3,6,-3,37,8,1
2,747,1,0,6,3,3,35,10,1
2,698,2,0,6,3,3,33,8,1
2,467,2,1,10,6,4,32,10,1
2,345,2,0,6,10,-4,36,14,1
2,290,2,1,10,6,4,38,5,1
2,149,2,1,10,9,1,35,10,1
2,112,1,0,9,10,-1,41,10,1
2,103,1,1,10,9,1,35,10,1
2,96,2,1,10,9,1,28,3,1
2,67,2,1,10,9,1,23,10,1
3,791,1,0,12,10,2,50,10,1
3,647,1,1,10,15,-5,35,10,1
3,552,2,0,15,10,5,50,3,1
3,535,1,0,15,10,5,45,10,1
3,419,2,0,15,10,5,21,17,1
3,374,2,0,15,17,-2,38,8,1
3,330,1,0,15,17,-2,50,10,1
3,299,1,1,17,15,2,49,10,1
3,138,2,1,17,22,-5,34,8,1
3,93,1,0,22,17,5,35,10,1
3,55,1,0,22,17,5,13,10,1
3,30,1,0,22,24,-2,34,10,1
4,755,1,0,22,24,-2,47,10,1
4,643,1,0,22,27,-5,35,10,1
4,608,1,0,22,27,-5,51,10,1
4,588,1,1,27,22,5,45,10,1
4,444,2,1,27,29,-2,49,10,1
4,425,1,0,29,27,2,37,10,1
4,331,2,0,29,27,2,25,10,1
4,293,1,0,29,27,2,49,10,1
1,894,1,0,0,0,0,35,10,1
1,817,2,1,0,0,0,49,10,1
1,692,1,1,0,0,0,14,10,1
1,525,2,0,0,0,0,37,14,1
1,268,1,1,0,0,0,37,10,1
1,230,2,1,0,0,0,27,12,1
1,93,1,0,3,0,3,17,10,1
2,846,2,1,0,3,-3,18,19,1
2,805,1,0,3,0,3,44,10,1
2,670,1,0,3,3,0,51,10,1
2,583,2,1,3,3,0,29,5,1
2,247,1,1,3,13,-10,35,10,1
2,180,1,1,3,13,-10,47,10,1
2,86,1,1,3,20,-17,13,10,1
2,60,1,1,3,20,-17,24,10,1
2,50,1,1,3,20,-17,39,10,1
2,41,1,0,20,3,17,54,10,1
2,36,2,0,20,3,17,52,8,1
2,24,1,0,20,3,17,8,8,1
2,3,2,0,20,3,17,7,7,1
3,816,2,1,10,20,-10,34,10,1
3,611,1,1,10,20,-10,49,15,1
3,510,2,0,20,10,10,13,10,1
3,406,2,0,20,10,10,27,8,1
3,379,1,0,20,10,10,38,10,1
3,229,2,1,10,20,-10,35,4,1
3,1,1,1,10,20,-10,53,10,1
4,877,2,1,10,20,-10,37,10,1
4,758,1,1,10,23,-13,35,10,1
4,690,1,1,10,23,-13,47,10,1
4,427,2,0,23,13,10,44,4,1
4,250,2,1,13,23,-10,52,26,1
4,180,1,1,13,24,-11,46,10,1
4,156,1,0,24,13,11,34,10,1
4,39,2,1,13,27,-14,35,10,1
1,827,2,0,0,0,0,46,5,1
1,765,1,0,0,0,0,7,7,1
1,693,1,0,0,3,-3,46,10,1
1,543,1,1,3,3,0,34,10,1
1,346,2,0,3,3,0,49,6,1
1,296,2,1,3,3,0,47,7,1
1,249,1,1,3,3,0,6,10,1
1,217,1,1,3,3,0,25,10,1
1,121,1,1,3,3,0,31,10,1
1,63,2,1,3,3,0,26,5,1
1,46,1,1,3,10,-7,31,10,1
2,840,2,0,10,3,7,48,11,1
2,809,1,1,3,10,-7,48,10,1
2,719,1,1,3,10,-7,1,1,1
2,664,2,1,3,17,-14,30,9,1
2,420,2,0,17,3,14,50,10,1
2,314,1,1,3,17,-14,28,10,1
2,209,1,1,3,20,-17,35,10,1
2,182,2,1,3,20,-17,42,3,1
2,98,1,0,20,3,17,19,10,1
2,55,2,0,20,3,17,34,6,1
2,22,2,0,20,3,17,55,10,1
3,873,2,1,3,23,-20,44,10,1
3,814,1,1,3,23,-20,54,10,1
3,778,2,1,3,23,-20,52,8,1
3,718,1,1,3,23,-20,36,10,1
3,683,2,1,3,23,-20,42,4,1
3,640,1,0,23,3,20,37,10,1
3,545,1,0,23,10,13,36,10,1
3,504,1,0,23,10,13,47,10,1
3,336,1,0,23,10,13,29,10,1
3,200,2,1,10,23,-13,47,3,1
3,160,1,1,10,23,-13,51,10,1
3,56,2,0,23,10,13,15,10,1
4,861,1,1,10,23,-13,16,10,1
4,784,2,1,10,23,-13,33,10,1
4,670,2,1,10,23,-13,43,11,1
4,598,2,0,23,10,13,27,10,1
4,579,1,1,17,23,-6,49,10,1
4,540,2,1,17,23,-6,52,7,1
4,443,1,0,23,17,6,14,10,1
4,342,2,1,17,23,-6,35,10,1
4,282,2,1,17,23,-6,50,10,1
4,257,1,0,23,17,6,47,10,1
4,167,1,0,23,17,6,26,10,1
4,66,1,1,20,26,-6,35,10,1
4,61,2,1,20,26,-6,43,2,1
4,36,2,1,20,26,-6,54,10,1
1,879,1,0,0,0,0,37,10,1
1,722,2,0,0,0,0,32,5,1
1,613,1,1,0,0,0,25,10,1
1,523,1,1,0,0,0,11,10,1
1,303,2,0,7,0,7,42,5,1
1,231,2,0,7,0,7,27,9,1
2,900,2,0,7,10,-3,8,8,1
2,712,2,0,7,13,-6,20,10,1
2,598,2,0,7,20,-13,45,10,1
2,429,2,0,7,27,-20,31,9,1
2,56,1,0,7,28,-21,53,10,1
3,886,1,0,7,31,-24,32,10,1
3,793,2,1,31,7,24,38,8,1
3,571,2,1,31,7,24,29,10,1
3,511,1,1,31,7,24,7,7,1
3,193,2,1,31,14,17,32,10,1
3,165,1,1,31,14,17,45,10,1
3,1,1,0,14,31,-17,26,10,1
4,566,1,0,14,32,-18,32,10,1
4,417,2,1,32,14,18,46,8,1
4,334,2,1,32,14,18,45,20,1
4,196,2,0,14,32,-18,10,15,1
4,157,2,0,14,32,-18,27,10,1
1,849,2,0,0,0,0,35,15,1
1,596,1,0,0,0,0,12,10,1
1,578,1,0,0,0,0,23,10,1
1,554,2,0,0,0,0,28,5,1
1,480,2,1,0,0,0,34,10,1
1,416,1,1,0,0,0,46,10,1
1,195,2,0,0,7,-7,2,2,1
1,178,1,0,0,14,-14,39,10,1
2,900,1,0,0,14,-14,38,10,1
2,863,2,0,0,14,-14,51,10,1
2,746,2,1,14,3,11,40,5,1
2,676,2,1,14,3,11,49,10,1
2,451,1,1,21,3,18,13,10,1
2,432,1,1,21,3,18,28,10,1
2,397,2,1,21,3,18,33,5,1
2,284,1,0,3,21,-18,35,10,1
2,154,2,0,3,24,-21,35,10,1
2,134,1,1,24,3,21,38,10,1
2,127,2,1,24,3,21,43,5,1
2,83,2,1,24,3,21,52,10,1
2,32,1,0,3,24,-21,26,10,1
2,26,1,0,3,31,-28,50,10,1
3,851,2,1,31,3,28,47,13,1
3,466,1,0,3,34,-31,36,10,1
3,277,2,1,34,3,31,26,10,1
3,128,1,0,3,34,-31,30,10,1
4,836,1,0,5,34,-29,45,10,1
4,741,2,0,5,34,-29,55,18,1
4,659,1,1,34,5,29,46,10,1
4,582,1,0,5,34,-29,12,10,1
4,505,2,1,36,5,31,37,8,1
4,467,1,1,36,5,31,48,10,1
4,330,1,0,5,36,-31,37,10,1
4,314,2,0,5,36,-31,40,7,1
4,231,1,0,5,36,-31,48,10,1
4,180,1,1,36,5,31,46,10,1
4,163,1,1,36,5,31,36,10,1
4,63,1,1,36,5,31,47,10,1
1,895,1,1,0,0,0,30,10,1
1,817,2,1,0,0,0,45,10,1
1,770,1,0,0,0,0,19,10,1
1,680,1,1,0,0,0,11,10,1
1,666,1,1,0,0,0,22,10,1
1,610,1,1,0,0,0,47,10,1
1,563,1,0,0,0,0,31,10,1
1,454,1,1,7,0,7,49,10,1
1,431,2,1,7,0,7,55,4,1
1,376,2,0,0,7,-7,38,10,1
1,302,1,0,0,10,-10,35,10,1
1,59,2,1,10,0,10,5,5,1
1,13,1,0,7,10,-3,54,10,1
2,851,1,0,7,10,-3,40,10,1
2,837,2,0,7,10,-3,38,8,1
2,788,1,0,7,13,-6,21,10,1
2,763,1,0,7,13,-6,32,10,1
2,522,1,1,13,10,3,35,10,1
2,473,1,0,10,13,-3,50,10,1
2,394,1,0,10,13,-3,37,10,1
2,281,1,0,10,13,-3,4,4,1
2,255,1,0,10,21,-11,35,10,1
2,148,1,1,21,10,11,30,10,1
2,96,2,1,21,10,11,36,14,1
2,27,2,1,21,10,11,7,7,1
2,16,1,1,21,17,4,54,10,1
2,9,2,0,17,21,-4,50,4,1
3,892,1,0,17,21,-4,49,10,1
3,805,1,1,21,17,4,35,10,1
3,753,1,0,17,21,-4,43,10,1
3,718,1,0,17,21,-4,20,10,1
3,659,1,0,17,21,-4,4,10,1
3,559,1,1,21,17,4,39,10,1
3,470,1,1,21,17,4,52,10,1
3,434,2,0,17,21,-4,52,4,1
3,409,1,0,17,21,-4,41,10,1
3,272,1,1,24,17,7,52,10,1
3,241,2,0,17,24,-7,52,4,1
3,135,1,0,17,27,-10,35,10,1
3,1,1,1,27,20,7,35,10,1
4,900,2,1,27,20,7,36,9,1
4,826,2,1,27,20,7,47,11,1
4,744,2,0,20,27,-7,10,7,1
4,675,2,0,20,27,-7,22,6,1
4,603,1,0,20,27,-7,43,10,1
4,563,1,1,27,20,7,46,10,1
4,425,1,1,27,21,6,35,10,1
4,404,1,1,27,21,6,50,10,1
4,349,2,0,21,27,-6,50,10,1
4,164,2,1,29,21,8,41,9,1
4,158,1,0,21,36,-15,25,10,1
4,150,1,0,21,36,-15,36,10,1
1,863,1,0,0,0,0,39,10,1
1,794,1,0,7,0,7,36,10,1
1,629,1,0,7,0,7,45,10,1
1,614,1,1,0,7,-7,45,10,1
1,571,2,1,0,7,-7,30,10,1
1,345,2,0,10,0,10,20,10,1
1,269,1,1,0,10,-10,45,10,1
1,166,1,0,10,0,10,47,15,1
1,86,2,0,10,1,9,35,10,1
2,878,1,0,12,1,11,43,10,1
2,767,2,1,1,12,-11,29,10,1
2,622,2,1,1,12,-11,33,6,1
2,492,1,0,12,1,11,48,10,1
2,342,1,0,12,1,11,38,10,1
2,180,2,0,12,8,4,52,10,1
2,147,2,1,8,12,-4,12,9,1
2,89,1,1,8,15,-7,50,10,1
2,63,1,0,15,8,7,40,10,1
2,27,1,0,15,8,7,8,10,1
3,804,2,0,15,15,0,43,11,1
3,655,2,1,22,15,7,46,14,1
3,539,1,1,22,15,7,53,10,1
3,375,2,0,15,22,-7,2,2,1
3,359,1,0,15,29,-14,15,10,1
3,326,2,0,15,29,-14,21,4,1
3,164,2,0,15,29,-14,29,17,1
4,643,2,0,15,29,-14,22,8,1
4,502,2,0,15,36,-21,41,15,1
4,460,1,1,36,15,21,39,10,1
4,444,2,1,36,15,21,31,2,1
4,392,2,1,36,15,21,25,10,1
4,328,1,1,36,15,21,14,10,1
4,203,2,1,36,22,14,46,7,1
4,121,2,0,22,36,-14,3,3,1
4,112,1,0,22,43,-21,41,10,1
4,92,3,0,22,43,-21,46,5,1
4,80,2,1,43,22,21,30,10,1
4,75,3,1,43,22,21,23,3,1
1,871,2,1,0,0,0,39,10,1
1,812,2,0,0,0,0,36,10,1
1,653,1,0,0,0,0,40,10,1
1,522,2,1,0,0,0,14,9,1
1,497,1,1,0,7,-7,17,10,1
1,470,1,1,0,7,-7,31,10,1
1,163,1,0,14,0,14,34,10,1
2,885,2,1,0,14,-14,54,10,1
2,857,1,1,0,14,-14,41,10,1
2,820,2,1,0,14,-14,39,9,1
2,736,1,1,0,14,-14,15,10,1
2,580,2,1,0,16,-16,51,4,1
2,529,2,1,0,16,-16,30,8,1
2,314,1,0,16,0,16,22,10,1
2,255,2,0,16,0,16,38,10,1
2,128,1,0,16,0,16,50,5,1
2,107,1,0,16,0,16,40,10,1
2,98,1,0,16,0,16,24,10,1
2,62,2,0,16,3,13,40,5,1
2,28,2,1,3,16,-13,54,10,1
3,805,1,1,3,16,-13,38,10,1
3,777,1,0,16,3,13,50,10,1
3,551,1,0,16,3,13,12,10,1
3,520,1,0,16,10,6,31,10,1
3,385,2,0,16,10,6,47,5,1
3,328,2,1,10,23,-13,44,9,1
3,138,2,0,23,10,13,21,11,1
4,900,1,1,10,23,-13,38,10,1
4,880,2,1,10,23,-13,45,3,1
4,683,1,0,23,17,6,23,10,1
4,591,1,0,23,17,6,40,10,1
4,532,2,0,23,17,6,25,10,1
4,430,1,1,20,23,-3,47,10,1
4,376,2,1,20,23,-3,45,8,1
4,217,1,0,23,27,-4,48,10,1
4,181,1,1,27,23,4,46,10,1
4,131,2,1,27,24,3,38,7,1
1,894,1,1,0,0,0,35,10,1
1,815,2,1,0,0,0,39,7,1
1,764,2,1,0,0,0,24,15,1
1,596,1,0,3,0,3,33,10,1
1,488,1,0,3,0,3,36,10,1
1,424,1,1,0,3,-3,33,10,1
1,375,1,0,3,0,3,29,10,1
1,247,2,0,3,0,3,13,7,1
1,160,2,0,3,3,0,35,10,1
2,864,1,1,3,3,0,46,10,1
2,818,2,0,3,3,0,52,10,1
2,736,1,0,3,3,0,18,10,1
2,684,2,0,3,3,0,11,3,1
2,665,1,0,3,10,-7,37,10,1
2,449,1,1,10,6,4,35,10,1
2,358,1,0,6,10,-4,50,10,1
2,247,2,1,10,6,4,21,5,1
2,140,1,1,10,6,4,53,10,1
2,119,2,1,10,6,4,38,7,1
2,107,1,1,10,6,4,23,10,1
2,61,2,1,10,9,1,12,10,1
3,699,1,1,13,15,-2,10,10,1
3,672,1,1,13,15,-2,21,10,1
3,596,1,1,13,15,-2,31,10,1
3,559,2,1,13,15,-2,35,6,1
3,525,1,1,13,15,-2,46,10,1
3,430,1,0,15,19,-4,48,10,1
3,327,2,0,15,19,-4,53,17,1
3,265,1,1,19,15,4,39,10,1
4,814,2,0,18,19,-1,16,15,1
4,745,2,1,19,18,1,38,10,1
4,705,1,0,18,19,-1,42,10,1
4,508,1,1,22,18,4,27,10,1
4,460,1,0,18,22,-4,32,10,1
4,409,1,0,18,22,-4,47,10,1
4,305,1,1,22,18,4,28,10,1
4,166,1,0,25,22,3,43,10,1
4,152,2,0,25,22,3,40,7,1
1,614,1,0,0,7,-7,43,10,1
1,450,2,0,0,7,-7,34,10,1
1,429,1,0,0,7,-7,23,10,1
1,280,1,1,7,0,7,24,10,1
1,260,1,0,0,7,-7,52,10,1
1,242,2,0,0,7,-7,47,5,1
1,215,3,0,0,7,-7,43,1,1
1,7,2,1,10,0,10,37,7,1
2,773,2,0,0,10,-10,39,6,1
2,705,2,1,10,7,3,27,3,1
2,672,1,1,10,7,3,18,10,1
2,581,2,1,10,7,3,3,3,1
2,534,2,1,10,14,-4,32,12,1
2,497,1,0,14,10,4,38,10,1
2,253,2,1,11,14,-3,37,0,1
2,99,1,0,15,11,4,42,10,1
3,891,1,0,15,11,4,20,10,1
3,691,2,1,11,15,-4,46,10,1
3,555,1,0,15,11,4,24,10,1
3,462,2,0,15,11,4,11,10,1
3,413,2,0,15,17,-2,20,8,1
3,225,1,0,15,17,-2,17,10,1
3,33,2,0,15,17,-2,6,10,1
4,768,1,1,19,15,4,34,10,1
4,435,1,1,20,15,5,6,10,1
4,426,2,1,20,15,5,11,5,1
4,167,2,1,20,15,5,37,7,1
4,160,1,1,20,23,-3,43,10,1
1,719,1,1,0,0,0,50,10,1
1,680,2,1,0,0,0,44,4,1
1,520,1,0,3,0,3,38,10,1
1,338,1,0,3,0,3,39,10,1
1,255,2,0,3,0,3,23,8,1
1,171,2,0,3,0,3,10,5,1
1,61,1,0,3,7,-4,47,15,1
1,36,2,1,7,3,4,54,6,1
2,659,1,0,4,7,-3,50,10,1
2,509,1,0,4,10,-6,35,10,1
2,265,2,1,10,4,6,46,6,1
2,220,1,0,4,10,-6,37,10,1
2,158,1,0,4,17,-13,45,10,1
2,111,2,1,17,4,13,24,7,1
3,790,2,0,4,17,-13,40,10,1
3,615,1,0,4,17,-13,41,10,1
3,323,1,1,17,4,13,51,10,1
3,304,1,1,17,4,13,35,10,1
3,156,2,1,17,7,10,45,5,1
3,92,2,1,17,7,10,52,10,1
3,1,1,0,7,17,-10,30,15,1
4,847,2,1,17,7,10,44,10,1
4,639,1,0,7,20,-13,25,20,1
4,562,1,1,20,7,13,41,10,1
4,379,1,0,7,23,-16,35,10,1
1,820,1,0,0,0,0,38,10,1
1,785,1,0,0,0,0,51,10,1
1,714,1,1,0,0,0,53,10,1
1,614,2,0,0,0,0,8,10,1
1,574,1,0,0,0,0,34,10,1
1,446,2,1,3,0,3,37,10,1
1,253,2,0,0,3,-3,36,17,1
1,171,1,1,3,0,3,30,10,1
1,133,2,1,3,0,3,24,4,1
1,35,2,1,3,3,0,38,9,1
2,830,2,0,3,3,0,33,10,1
2,767,2,0,3,3,0,20,16,1
2,713,1,0,3,6,-3,37,10,1
2,590,1,1,6,3,3,44,10,1
2,432,1,1,6,3,3,7,7,1
2,368,2,1,6,3,3,8,8,1
2,352,1,1,6,10,-4,25,10,1
2,178,2,1,6,10,-4,1,10,1
2,125,1,1,6,10,-4,53,10,1
2,82,1,1,6,10,-4,14,10,1
2,23,2,1,6,17,-11,40,10,1
3,864,1,1,6,17,-11,33,10,1
3,800,2,1,6,17,-11,17,12,1
3,661,1,0,20,6,14,28,10,1
3,558,1,1,6,27,-21,24,10,1
3,404,1,0,27,6,21,26,10,1
3,328,1,1,6,27,-21,45,10,1
3,271,1,0,27,6,21,53,10,1
3,230,2,0,27,6,21,50,7,1
3,117,2,0,27,6,21,48,9,1
3,31,2,1,6,27,-21,45,10,1
3,1,1,1,6,27,-21,32,10,1
4,900,1,1,6,27,-21,18,10,1
4,811,1,1,6,30,-24,35,10,1
4,783,2,1,6,30,-24,41,4,1
4,613,1,1,7,30,-23,35,10,1
4,587,2,1,7,30,-23,41,4,1
4,545,1,0,30,7,23,45,10,1
4,519,2,0,30,7,23,42,7,1
4,488,1,0,30,7,23,24,10,1
4,407,1,0,30,7,23,7,10,1
4,314,1,0,30,7,23,53,10,1
1,654,2,1,0,0,0,14,10,1
1,345,2,1,0,10,-10,32,5,1
1,317,1,1,0,10,-10,49,10,1
1,278,2,1,0,10,-10,48,11,1
1,226,2,0,10,0,10,44,3,1
1,126,2,0,10,0,10,19,13,1
2,872,2,1,3,10,-7,23,8,1
2,759,1,0,10,3,7,22,10,1
2,573,2,0,10,3,7,54,6,1
2,492,1,1,3,10,-7,15,10,1
2,379,1,0,10,3,7,33,10,1
2,343,1,0,10,3,7,19,10,1
2,245,1,0,10,3,7,5,5,1
2,136,2,1,10,13,-3,35,10,1
2,112,2,0,13,10,3,19,8,1
2,55,1,1,10,13,-3,44,20,1
2,47,2,1,10,13,-3,50,14,1
3,825,1,1,10,13,-3,45,10,1
3,480,1,0,13,13,0,35,10,1
3,458,2,0,13,13,0,40,5,1
3,145,1,0,16,13,3,28,10,1
3,29,1,1,20,16,4,33,10,1
3,0,1,1,20,16,4,12,10,1
4,834,2,1,20,23,-3,53,8,1
4,790,1,0,23,20,3,49,10,1
4,757,1,0,23,20,3,32,10,1
4,719,1,0,23,20,3,20,10,1
4,618,1,0,23,23,0,29,10,1
4,492,1,1,23,23,0,52,10,1
4,204,1,0,23,26,-3,35,10,1
4,136,2,1,26,23,3,19,4,1
4,66,1,1,26,30,-4,27,10,1
4,56,1,1,26,30,-4,38,10,1
4,44,1,1,26,30,-4,49,10,1
4,35,1,0,30,26,4,50,10,1
4,22,2,0,30,26,4,45,5,1
4,7,2,0,30,26,4,43,17,1
1,760,2,0,0,0,0,55,15,1
1,729,1,1,0,0,0,7,10,1
1,567,1,1,0,0,0,34,10,1
1,472,2,1,0,1,-1,33,12,1
1,318,1,1,0,2,-2,35,10,1
1,240,1,1,0,2,-2,45,10,1
1,163,2,1,0,2,-2,27,6,1
1,50,1,1,0,2,-2,18,10,1
2,900,2,1,0,2,-2,29,10,1
2,827,2,1,0,2,-2,19,6,1
2,715,1,1,0,2,-2,35,10,1
2,696,2,1,0,2,-2,33,12,1
2,520,2,0,2,0,2,23,6,1
2,365,1,0,2,0,2,6,10,1
2,293,2,0,2,0,2,32,10,1
2,271,1,0,2,0,2,47,10,1
2,235,2,0,2,0,2,53,4,1
2,149,1,1,0,2,-2,21,10,1
2,134,1,1,0,2,-2,41,10,1
3,894,1,1,0,2,-2,49,10,1
3,417,1,0,2,6,-4,35,10,1
3,273,1,1,6,2,4,29,10,1
3,245,1,1,6,9,-3,49,10,1
3,222,2,1,6,9,-3,55,4,1
3,143,1,0,9,6,3,48,10,1
4,851,2,1,6,9,-3,45,8,1
4,332,1,1,6,10,-4,13,10,1
4,276,1,1,6,10,-4,26,10,1
4,234,1,1,6,10,-4,36,10,1
4,174,2,1,6,10,-4,54,10,1
4,153,2,0,10,6,4,46,10,1
4,147,1,0,10,6,4,34,10,1
4,110,1,0,10,6,4,22,10,1
4,64,2,0,10,6,4,17,5,1
5,0,1,1,13,13,0,35,10,1
5,0,2,1,13,13,0,30,5,1
5,0,1,0,16,13,3,35,10,1
5,0,1,0,16,13,3,24,10,1
1,866,2,1,0,0,0,38,4,1
1,830,1,1,0,0,0,44,10,1
1,625,1,0,0,0,0,38,10,1
1,500,2,0,0,0,0,24,11,1
1,426,1,0,0,0,0,50,10,1
1,398,2,0,0,0,0,52,8,1
1,320,2,1,0,0,0,37,5,1
1,274,1,0,0,0,0,20,10,1
1,170,1,0,0,3,-3,35,10,1
1,54,1,1,3,0,3,36,10,1
1,1,1,1,3,0,3,25,10,1
2,780,1,0,7,6,1,29,10,1
2,651,1,1,6,7,-1,48,10,1
2,604,2,1,6,7,-1,46,8,1
2,513,2,1,6,7,-1,33,8,1
2,259,1,1,6,14,-8,44,10,1
2,199,1,1,6,14,-8,45,20,1
2,161,1,0,14,6,8,4,4,1
2,111,1,1,13,14,-1,46,10,1
2,105,1,1,13,14,-1,28,10,1
2,97,2,1,13,14,-1,23,5,1
2,73,1,1,13,17,-4,35,10,1
2,65,2,1,13,17,-4,36,9,1
2,17,1,0,17,13,4,48,10,1
3,754,1,1,16,17,-1,34,10,1
3,572,2,1,16,24,-8,33,8,1
3,537,1,0,24,16,8,40,10,1
3,473,1,0,24,16,8,51,10,1
3,263,2,1,16,24,-8,23,16,1
3,215,2,1,16,24,-8,42,10,1
3,63,1,1,16,25,-9,35,10,1
4,795,2,0,25,16,9,10,10,1
4,698,1,0,25,23,2,50,10,1
4,601,1,1,23,25,-2,23,10,1
4,418,2,0,25,23,2,47,5,1
4,56,2,0,25,26,-1,24,8,1
4,28,1,0,25,29,-4,35,10,1
4,19,2,0,25,29,-4,43,2,1
4,1,0,1,29,25,4,45,0,1
1,702,1,1,0,0,0,43,10,1
1,597,2,0,0,0,0,28,9,1
1,375,1,0,0,3,-3,45,10,1
1,327,1,1,3,0,3,41,10,1
1,276,1,1,3,0,3,21,10,1
1,177,2,1,3,0,3,3,3,1
1,153,1,1,3,7,-4,35,10,1
1,66,2,0,7,3,4,33,15,1
2,900,2,0,7,6,1,40,5,1
2,697,2,1,6,7,-1,35,10,1
2,528,2,1,6,7,-1,7,7,1
2,440,2,0,14,6,8,18,8,1
2,230,1,1,6,15,-9,42,10,1
2,163,2,1,6,15,-9,37,5,1
2,151,2,1,6,22,-16,35,7,1
2,55,1,0,22,6,16,48,10,1
2,44,1,1,6,22,-16,47,10,1
2,30,1,1,6,22,-16,34,10,1
3,749,2,0,22,6,16,30,10,1
3,635,1,0,22,6,16,51,10,1
3,584,2,0,22,6,16,46,5,1
3,556,1,0,22,13,9,34,10,1
3,491,1,1,13,22,-9,40,10,1
3,231,1,0,22,13,9,29,10,1
3,181,2,0,22,13,9,32,7,1
3,87,2,1,13,22,-9,34,15,1
3,34,1,0,22,13,9,28,10,1
4,900,1,0,22,13,9,40,10,1
4,588,2,1,13,22,-9,17,2,1
4,508,2,1,13,22,-9,10,7,1
4,168,2,1,13,28,-15,40,5,1
4,70,1,1,13,35,-22,30,10,1
1,864,2,1,0,0,0,35,10,1
1,826,1,1,0,0,0,24,10,1
1,680,1,1,0,3,-3,46,10,1
1,655,1,0,3,0,3,41,10,1
1,625,1,0,3,0,3,30,10,1
1,593,2,0,3,0,3,31,11,1
1,563,1,0,3,0,3,15,10,1
1,482,2,0,3,0,3,8,3,1
1,378,1,1,7,3,4,41,10,1
1,274,2,0,3,7,-4,21,9,1
1,212,1,0,3,7,-4,30,10,1
1,49,1,1,7,3,4,7,10,1
1,21,1,1,7,10,-3,28,10,1
2,900,1,0,10,7,3,42,10,1
2,711,1,1,14,10,4,28,10,1
2,482,1,1,14,10,4,43,10,1
2,451,2,1,14,10,4,50,3,1
2,339,1,1,21,10,11,41,10,1
2,318,1,0,10,21,-11,53,10,1
2,267,1,0,10,21,-11,42,10,1
2,224,1,0,10,21,-11,26,10,1
2,153,2,0,10,24,-14,35,10,1
2,145,1,0,10,24,-14,53,10,1
2,131,1,1,24,10,14,38,10,1
2,85,1,1,24,10,14,24,10,1
2,24,2,1,24,10,14,4,4,1
3,847,2,0,17,24,-7,55,10,1
3,822,1,1,24,17,7,41,10,1
3,783,2,1,24,17,7,37,6,1
3,751,1,1,24,17,7,23,10,1
3,653,2,1,24,17,7,14,11,1
3,628,1,1,24,24,0,48,10,1
3,543,1,0,24,24,0,1,11,1
3,519,1,0,24,24,0,15,10,1
3,420,1,0,24,24,0,27,10,1
3,329,1,1,24,24,0,39,10,1
3,253,1,0,24,24,0,15,10,1
3,220,1,0,24,24,0,27,10,1
3,181,2,0,24,24,0,35,2,1
3,149,1,0,24,24,0,42,10,1
4,900,1,1,24,27,-3,35,10,1
4,711,1,0,27,24,3,19,15,1
4,633,1,0,27,24,3,38,10,1
4,586,1,0,27,24,3,53,10,1
4,503,1,1,24,27,-3,32,10,1
4,333,2,0,27,24,3,43,19,1
4,266,1,1,24,27,-3,46,15,1
4,174,2,1,24,27,-3,37,9,1
1,892,1,0,0,0,0,40,10,1
1,871,2,0,0,0,0,47,3,1
1,732,1,0,0,0,0,55,10,1
1,665,1,1,0,0,0,44,10,1
1,419,2,0,3,0,3,15,9,1
1,393,1,0,3,7,-4,25,10,1
1,361,1,0,3,7,-4,38,10,1
1,138,2,1,7,3,4,25,17,1
2,900,1,0,3,7,-4,49,10,1
2,870,2,0,3,7,-4,52,13,1
2,842,1,0,3,7,-4,14,10,1
2,738,2,0,3,10,-7,28,17,1
2,677,2,0,3,10,-7,50,10,1
2,657,1,0,3,10,-7,39,10,1
2,597,2,0,3,10,-7,29,10,1
2,421,1,0,3,17,-14,8,10,1
2,361,1,0,3,17,-14,30,10,1
2,260,2,1,24,3,21,40,10,1
2,116,1,0,6,24,-18,42,10,1
2,61,2,1,31,6,25,54,5,1
2,54,1,0,6,31,-25,51,10,1
3,857,2,0,6,31,-25,24,17,1
3,749,2,1,31,6,25,52,10,1
3,684,2,0,6,31,-25,22,10,1
3,544,2,1,31,6,25,34,12,1
3,451,2,0,6,31,-25,37,10,1
3,261,1,1,31,6,25,40,10,1
3,232,2,1,31,6,25,29,10,1
3,70,1,1,31,13,18,51,10,1
4,866,2,1,31,16,15,35,10,1
4,758,1,0,16,31,-15,39,10,1
4,412,2,0,16,31,-15,34,10,1
4,249,1,0,16,38,-22,26,10,1
4,219,1,0,16,45,-29,46,10,1
4,151,2,1,45,16,29,32,10,1
4,139,2,1,45,16,29,16,10,1
1,854,2,1,0,0,0,29,10,1
1,736,1,0,0,0,0,55,10,1
1,644,1,1,0,0,0,22,10,1
1,492,2,0,0,3,-3,32,3,1
1,425,2,0,0,3,-3,54,4,1
1,384,1,1,3,0,3,49,10,1
1,290,2,1,3,0,3,18,4,1
2,866,2,0,7,3,4,27,17,1
2,830,1,0,7,3,4,54,10,1
2,757,1,1,3,7,-4,21,10,1
2,658,2,1,3,14,-11,36,8,1
2,601,2,1,3,14,-11,49,10,1
2,497,1,0,14,3,11,18,10,1
2,402,1,0,14,3,11,6,6,1
2,362,2,0,14,10,4,24,10,1
2,324,1,0,14,10,4,38,10,1
2,203,2,0,14,10,4,50,11,1
2,124,1,1,13,14,-1,44,10,1
2,110,1,1,13,14,-1,55,10,1
2,60,2,0,14,13,1,33,10,1
3,893,1,0,14,13,1,37,10,1
3,870,1,0,14,13,1,52,10,1
3,726,1,0,14,13,1,29,10,1
3,446,1,0,14,13,1,48,10,1
3,383,2,1,13,14,-1,35,10,1
3,264,1,1,13,14,-1,52,10,1
4,719,2,1,13,17,-4,41,10,1
4,420,2,1,16,17,-1,15,5,1
4,378,1,1,16,24,-8,32,15,1
4,269,1,1,16,24,-8,25,10,1
4,210,2,0,24,16,8,37,10,1
4,142,1,0,24,16,8,7,7,1
4,114,2,0,24,22,2,30,7,1
1,872,2,0,0,0,0,35,10,1
1,795,2,0,0,0,0,47,15,1
1,703,1,1,0,0,0,9,10,1
1,677,2,1,0,0,0,15,4,1
1,621,2,1,0,0,0,19,10,1
1,578,1,0,0,0,0,41,10,1
1,513,1,1,0,0,0,28,10,1
1,446,2,1,0,0,0,46,9,1
1,403,1,0,0,0,0,49,10,1
1,345,1,0,0,0,0,33,10,1
1,267,1,0,0,7,-7,48,10,1
1,192,2,1,7,0,7,35,10,1
1,146,1,1,7,3,4,35,10,1
1,134,2,1,7,3,4,39,6,1
1,45,1,1,7,3,4,46,10,1
1,1,2,1,7,3,4,51,5,1
2,762,1,1,7,3,4,46,10,1
2,745,1,0,3,7,-4,54,10,1
2,558,1,0,3,7,-4,26,10,1
2,374,2,0,3,7,-4,54,10,1
2,231,2,1,7,4,3,35,10,1
2,168,2,0,4,7,-3,44,6,1
2,152,1,1,7,4,3,28,10,1
2,57,1,0,4,7,-3,25,10,1
3,894,1,1,10,4,6,34,10,1
3,850,2,1,10,4,6,40,4,1
3,742,1,0,4,10,-6,50,10,1
3,481,2,1,10,4,6,51,6,1
3,387,2,0,4,10,-6,30,10,1
3,342,1,0,4,11,-7,35,10,1
3,219,2,1,11,4,7,38,10,1
3,159,2,1,11,4,7,44,20,1
3,65,2,0,4,11,-7,35,20,1
4,678,1,0,4,11,-7,34,10,1
4,644,2,0,4,11,-7,40,4,1
4,513,2,1,11,4,7,31,4,1
4,294,1,0,4,11,-7,44,10,1
4,225,1,1,11,4,7,45,10,1
4,163,2,1,11,4,7,23,10,1
4,121,2,0,11,11,0,52,13,1
4,80,1,1,11,11,0,18,15,1
1,872,2,0,0,0,0,33,10,1
1,800,2,1,0,0,0,35,10,1
1,738,2,0,0,0,0,30,9,1
1,570,1,1,0,0,0,25,10,1
1,548,1,1,0,0,0,35,10,1
1,505,1,1,0,0,0,52,10,1
1,261,2,1,0,7,-7,21,21,1
2,655,1,1,7,7,0,25,10,1
2,553,1,0,7,7,0,32,10,1
2,515,1,0,7,7,0,44,10,1
2,405,2,1,7,7,0,53,9,1
2,370,1,1,7,7,0,43,10,1
2,144,1,0,10,7,3,51,10,1
2,137,1,1,7,10,-3,49,10,1
2,82,1,1,7,10,-3,9,9,1
2,70,1,0,17,7,10,43,5,1
2,66,1,0,17,7,10,37,10,1
3,892,1,1,7,17,-10,25,10,1
3,790,2,1,7,17,-10,34,10,1
3,652,1,0,20,7,13,23,10,1
3,508,2,0,20,7,13,6,6,1
3,462,1,0,20,14,6,33,5,1
3,334,1,1,14,20,-6,5,10,1
3,300,1,1,14,20,-6,44,10,1
3,148,1,0,20,14,6,20,10,1
3,94,2,0,20,21,-1,32,5,1
3,70,1,0,20,21,-1,45,10,1
3,12,1,0,20,21,-1,55,10,1
4,643,1,1,21,23,-2,47,10,1
4,394,1,0,23,21,2,36,10,1
4,334,1,0,23,21,2,16,10,1
4,309,1,0,23,28,-5,29,10,1
4,200,1,1,28,23,5,26,10,1
1,673,2,1,7,0,7,39,4,1
1,555,1,0,0,7,-7,27,10,1
1,455,1,1,7,0,7,30,10,1
1,399,1,1,7,0,7,53,10,1
1,371,2,0,0,7,-7,54,7,1
1,285,2,0,0,7,-7,39,6,1
1,178,2,0,0,10,-10,34,9,1
1,1,1,0,7,10,-3,41,10,1
2,795,2,0,7,10,-3,16,6,1
2,670,2,0,7,10,-3,55,4,1
2,643,1,1,10,7,3,49,10,1
2,553,1,1,10,7,3,18,10,1
2,446,1,0,14,10,4,55,10,1
2,353,1,1,10,14,-4,33,10,1
2,252,2,1,10,14,-4,52,6,1
2,145,1,1,10,14,-4,24,10,1
2,21,1,1,10,14,-4,36,10,1
2,1,2,1,10,14,-4,49,10,1
3,619,2,1,10,14,-4,4,4,1
3,588,2,1,10,21,-11,22,11,1
3,443,1,1,10,21,-11,46,10,1
3,366,1,1,10,21,-11,2,10,1
3,128,2,1,10,21,-11,50,10,1
3,75,2,0,21,17,4,40,6,1
4,755,2,1,17,21,-4,41,7,1
4,495,1,0,21,17,4,51,10,1
4,374,1,1,17,21,-4,5,10,1
4,325,1,1,17,21,-4,17,10,1
4,72,3,1,17,21,-4,20,18,1
4,66,1,1,17,21,-4,43,10,1
4,57,2,1,17,21,-4,47,6,1
1,850,2,0,0,0,0,48,6,1
1,737,1,0,0,7,-7,20,10,1
1,661,2,0,0,7,-7,36,10,1
1,377,1,0,0,7,-7,15,10,1
1,209,2,1,7,0,7,51,10,1
1,165,1,0,0,7,-7,48,10,1
1,124,2,0,0,7,-7,44,6,1
1,74,1,0,0,7,-7,29,10,1
2,893,2,0,0,14,-14,25,15,1
2,665,1,1,14,3,11,32,15,1
2,633,1,1,14,3,11,52,10,1
2,387,1,0,3,17,-14,33,10,1
2,359,2,0,3,17,-14,37,6,1
2,261,1,1,17,4,13,35,10,1
2,142,1,0,4,17,-13,45,10,1
2,119,1,1,17,4,13,53,10,1
2,98,2,1,17,4,13,45,2,1
2,77,1,1,17,4,13,40,10,1
2,18,1,0,7,17,-10,52,10,1
2,8,2,0,7,17,-10,43,1,1
3,858,2,0,7,17,-10,33,4,1
3,826,1,0,7,17,-10,40,10,1
3,748,2,1,17,7,10,30,10,1
3,703,2,1,17,7,10,12,4,1
3,385,1,0,10,17,-7,54,10,1
3,300,2,1,17,10,7,42,10,1
3,200,2,1,17,10,7,29,13,1
3,162,2,1,17,17,0,26,10,1
4,900,1,0,17,17,0,38,10,1
4,814,1,0,17,17,0,18,10,1
4,650,1,1,17,17,0,44,10,1
4,568,1,1,17,17,0,33,10,1
4,402,1,1,17,20,-3,25,10,1
4,183,2,0,20,17,3,35,7,1
4,125,1,1,17,20,-3,50,10,1
4,94,1,0,20,20,0,35,10,1
4,50,1,1,20,20,0,36,10,1
1,896,1,1,0,0,0,22,10,1
1,878,2,1,0,0,0,27,5,1
1,851,2,1,0,0,0,33,10,1
1,741,2,0,0,0,0,32,10,1
1,607,1,1,0,0,0,39,10,1
1,560,2,1,0,0,0,35,6,1
1,511,1,1,0,3,-3,35,10,1
1,488,2,0,3,0,3,51,10,1
1,441,1,0,3,0,3,39,10,1
1,381,1,0,3,0,3,27,10,1
1,281,1,1,7,3,4,55,10,1
1,256,2,0,3,7,-4,53,8,1
1,160,1,0,3,14,-11,34,15,1
1,120,1,1,14,3,11,39,10,1
1,88,1,1,14,3,11,23,10,1
2,847,2,1,14,6,8,40,5,1
2,759,2,0,6,14,-8,52,10,1
2,676,2,0,6,14,-8,13,9,1
2,616,1,0,6,14,-8,2,2,1
2,462,1,0,6,21,-15,16,10,1
2,440,2,0,6,21,-15,19,7,1
2,300,2,1,21,6,15,42,10,1
2,177,2,0,6,21,-15,39,17,1
2,139,2,1,21,6,15,21,10,1
2,94,1,0,6,21,-15,25,10,1
2,88,1,0,6,21,-15,47,10,1
2,76,1,1,21,6,15,51,10,1
2,54,1,1,21,6,15,3,3,1
3,858,2,0,13,21,-8,40,7,1
3,685,2,0,13,21,-8,27,7,1
3,555,2,0,13,21,-8,11,9,1
3,478,2,0,13,28,-15,50,5,1
3,374,1,1,28,13,15,12,10,1
3,348,2,1,28,13,15,18,4,1
3,314,1,1,28,13,15,23,10,1
3,279,2,1,28,13,15,23,10,1
3,197,2,0,13,28,-15,47,4,1
3,75,2,0,13,35,-22,23,16,1
3,8,1,1,35,13,22,22,10,1
4,628,1,1,35,16,19,35,10,1
4,477,2,0,16,35,-19,50,5,1
4,257,2,1,35,23,12,43,6,1
4,190,2,1,35,23,12,53,10,1
4,165,1,0,23,35,-12,15,10,1
1,740,2,0,0,0,0,54,5,1
1,618,2,0,0,0,0,17,7,1
1,539,1,1,0,0,0,48,10,1
1,262,1,0,0,1,-1,45,10,1
1,232,1,1,1,0,1,37,10,1
1,136,1,0,7,1,6,47,10,1
1,1,2,0,7,4,3,51,4,1
2,889,1,1,4,7,-3,37,5,1
2,835,1,1,4,14,-10,45,10,1
2,810,2,1,4,14,-10,47,8,1
2,709,1,0,14,4,10,32,10,1
2,685,2,1,4,14,-10,39,3,1
2,633,2,0,14,4,10,47,10,1
2,595,1,1,4,14,-10,53,10,1
2,534,1,1,4,14,-10,39,10,1
2,453,1,1,4,15,-11,35,10,1
2,174,2,0,15,4,11,18,10,1
2,139,1,1,4,15,-11,46,10,1
2,130,1,0,15,4,11,45,10,1
2,75,1,0,15,7,8,25,10,1
2,54,2,0,15,7,8,36,10,1
2,49,1,1,7,15,-8,46,10,1
2,39,1,1,7,15,-8,33,10,1
2,25,2,1,7,15,-8,29,6,1
2,7,2,1,7,15,-8,5,5,1
3,664,1,1,7,23,-16,46,10,1
3,646,1,0,23,7,16,50,10,1
3,480,2,0,23,7,16,35,10,1
3,235,2,1,10,23,-13,24,15,1
3,40,2,1,10,23,-13,18,7,1
4,765,1,1,10,26,-16,45,10,1
4,694,2,1,10,26,-16,53,14,1
4,321,2,1,10,26,-16,33,10,1
4,269,2,0,26,10,16,50,10,1
4,139,2,1,10,26,-16,51,10,1
4,133,1,0,26,10,16,49,10,1
4,19,2,1,10,26,-16,33,10,1
4,13,3,1,10,26,-16,34,9,1
1,859,1,1,0,0,0,33,10,1
1,689,2,0,0,0,0,16,25,1
1,653,1,1,0,0,0,55,10,1
1,534,1,0,0,0,0,25,10,1
1,285,2,1,0,0,0,22,7,1
1,46,1,0,0,0,0,37,10,1
2,886,2,0,0,0,0,25,8,1
2,625,1,0,0,7,-7,45,10,1
2,471,2,0,0,7,-7,39,14,1
2,383,2,0,0,14,-14,45,22,1
2,284,2,1,14,1,13,37,8,1
2,241,1,0,1,14,-13,14,10,1
2,217,2,0,1,14,-13,20,4,1
2,100,2,0,1,14,-13,50,5,1
2,60,2,1,14,1,13,50,7,1
3,880,1,0,2,14,-12,28,10,1
3,762,2,1,14,2,12,20,9,1
3,635,2,0,9,14,-5,19,7,1
3,601,2,0,9,14,-5,41,7,1
3,470,2,1,14,16,-2,37,7,1
3,340,2,1,14,16,-2,54,3,1
3,1,1,0,16,14,2,43,10,1
4,680,1,0,16,14,2,28,10,1
4,660,2,0,16,14,2,29,9,1
4,512,1,0,16,14,2,30,10,1
4,303,1,0,16,14,2,29,10,1
4,59,2,1,14,16,-2,26,11,1
4,13,1,1,14,19,-5,35,10,1
1,723,2,1,0,0,0,33,14,1
1,619,1,0,0,0,0,23,10,1
1,590,1,0,0,7,-7,45,10,1
1,246,2,0,0,14,-14,52,5,1
1,177,2,0,0,14,-14,26,5,1
1,31,2,1,17,0,17,55,14,1
2,836,1,0,0,18,-18,46,10,1
2,731,2,1,18,0,18,50,9,1
2,693,1,1,18,0,18,35,10,1
2,632,2,1,18,0,18,23,10,1
2,588,1,1,18,3,15,25,10,1
2,505,2,1,18,3,15,29,16,1
2,463,1,0,3,18,-15,37,10,1
2,370,2,1,18,3,15,13,10,1
2,348,1,1,18,10,8,37,10,1
2,277,1,1,18,10,8,55,10,1
2,133,2,1,21,10,11,47,9,1
2,109,1,0,10,21,-11,34,10,1
2,27,1,0,10,21,-11,34,10,1
2,18,2,0,10,21,-11,39,4,1
2,7,1,1,21,10,11,47,10,1
3,892,1,1,21,13,8,33,10,1
3,862,2,1,21,13,8,37,6,1
3,829,1,0,13,21,-8,52,10,1
3,789,2,0,13,21,-8,50,8,1
3,695,1,0,13,21,-8,40,10,1
3,657,2,0,13,21,-8,37,7,1
3,603,1,0,13,24,-11,38,10,1
3,519,1,0,13,24,-11,4,10,1
3,418,2,0,13,24,-11,7,17,1
3,333,2,1,24,13,11,46,6,1
3,271,2,0,13,24,-11,51,10,1
3,163,1,0,13,31,-18,36,10,1
4,853,1,0,13,34,-21,30,15,1
4,846,2,0,13,34,-21,39,6,1
4,748,2,0,13,34,-21,39,10,1
4,625,2,0,13,37,-24,35,10,1
4,569,1,1,37,13,24,41,10,1
4,547,2,1,37,13,24,45,6,1
4,477,2,0,13,37,-24,54,5,1
4,213,1,0,13,37,-24,38,10,1
4,189,2,0,13,37,-24,32,4,1
1,858,2,1,0,0,0,35,9,1
1,835,1,1,0,0,0,53,10,1
1,778,1,0,0,0,0,47,10,1
1,686,2,0,0,0,0,27,7,1
1,669,1,0,0,7,-7,41,10,1
1,618,2,1,7,0,7,53,4,1
1,528,2,1,7,0,7,15,10,1
1,453,1,1,7,0,7,55,10,1
1,369,2,0,0,7,-7,34,9,1
1,247,2,0,0,7,-7,9,9,1
1,135,1,0,0,14,-14,48,10,1
2,876,2,0,0,17,-17,35,10,1
2,803,2,0,0,17,-17,45,10,1
2,445,1,0,0,17,-17,15,10,1
2,300,2,1,17,0,17,17,9,1
2,174,2,0,0,17,-17,25,3,1
2,163,1,1,24,0,24,26,10,1
2,126,1,1,24,0,24,14,10,1
2,85,1,0,7,24,-17,25,10,1
2,70,1,0,7,24,-17,40,10,1
2,15,1,1,24,7,17,42,10,1
3,885,2,0,7,24,-17,27,10,1
3,828,1,1,24,7,17,48,10,1
3,766,1,0,7,24,-17,34,10,1
3,635,1,0,7,31,-24,33,10,1
3,511,1,1,31,7,24,54,10,1
3,436,2,1,31,7,24,39,10,1
3,399,1,1,31,7,24,25,10,1
3,352,1,1,31,7,24,5,5,1
3,256,1,0,14,38,-24,15,10,1
3,230,2,0,14,38,-24,23,2,1
3,214,1,0,14,38,-24,33,10,1
3,160,1,1,38,14,24,29,10,1
3,99,1,1,38,14,24,19,10,1
3,1,2,1,38,14,24,11,7,1
4,778,2,1,38,14,24,53,5,1
4,734,3,0,14,38,-24,54,2,1
4,632,2,0,14,38,-24,25,12,1
4,490,2,0,14,38,-24,7,6,1
4,467,1,0,14,45,-31,13,10,1
4,440,1,0,14,45,-31,25,10,1
4,284,2,1,45,14,31,25,10,1
4,178,2,0,21,45,-24,37,5,1
1,749,2,0,0,1,-1,35,10,1
1,515,2,1,1,0,1,31,18,1
1,461,1,1,1,0,1,1,10,1
1,427,2,1,1,0,1,6,5,1
1,291,2,1,1,0,1,35,9,1
1,222,2,0,0,1,-1,39,10,1
1,80,2,0,0,4,-4,51,10,1
1,0,1,1,4,0,4,8,10,1
2,732,1,0,0,11,-11,28,10,1
2,679,2,0,0,11,-11,28,22,1
2,616,1,1,11,0,11,50,10,1
2,581,2,1,11,0,11,52,8,1
2,335,1,0,0,11,-11,23,10,1
2,175,1,0,0,11,-11,55,10,1
2,164,1,1,11,0,11,43,10,1
3,893,1,1,11,0,11,53,10,1
3,809,2,0,0,11,-11,45,8,1
3,619,2,0,0,14,-14,35,10,1
3,519,1,1,14,0,14,40,10,1
3,452,1,0,0,14,-14,37,10,1
3,375,1,1,14,0,14,24,10,1
3,235,2,0,0,15,-15,37,8,1
3,174,2,0,0,15,-15,45,10,1
3,14,1,1,15,1,14,45,10,1
4,758,2,0,1,22,-21,27,10,1
4,659,1,1,22,1,21,14,10,1
4,602,1,0,1,22,-21,32,10,1
4,468,2,0,1,22,-21,16,5,1
4,69,1,0,1,29,-28,15,10,1
4,64,2,0,1,29,-28,20,5,1
4,19,2,1,29,1,28,24,10,1
1,893,1,1,0,0,0,38,10,1
1,860,1,1,0,0,0,51,10,1
1,791,2,1,0,0,0,55,6,1
1,756,1,0,0,7,-7,32,10,1
1,704,1,0,0,7,-7,45,10,1
1,661,1,1,7,0,7,47,10,1
1,445,2,1,7,0,7,24,10,1
1,377,1,1,7,0,7,9,9,1
1,194,2,0,7,7,0,43,16,1
1,60,2,0,7,7,0,3,3,1
1,37,1,0,7,14,-7,33,10,1
1,1,1,0,7,14,-7,47,10,1
2,844,1,1,14,7,7,27,10,1
2,584,2,1,14,10,4,53,5,1
2,508,2,1,14,10,4,34,16,1
2,443,1,1,14,13,1,28,10,1
2,364,1,0,13,14,-1,33,10,1
2,326,2,0,13,14,-1,33,10,1
2,163,2,0,13,14,-1,40,10,1
2,139,1,0,13,14,-1,22,10,1
2,65,2,0,13,14,-1,16,16,1
3,728,1,1,17,13,4,47,10,1
3,624,2,0,13,17,-4,33,6,1
3,593,1,0,13,17,-4,40,10,1
3,486,2,0,13,17,-4,33,8,1
3,452,1,0,13,17,-4,24,10,1
3,232,1,1,17,13,4,40,10,1
3,145,3,1,17,13,4,32,2,1
3,63,2,1,17,13,4,24,5,1
3,0,2,1,17,13,4,17,10,1
4,738,1,0,20,17,3,36,10,1
4,693,1,0,20,17,3,47,10,1
4,643,1,1,17,20,-3,52,15,1
4,568,1,1,17,20,-3,35,10,1
4,340,1,1,17,27,-10,36,10,1
4,308,2,1,17,27,-10,43,3,1
4,252,2,0,27,17,10,44,8,1
4,201,1,0,27,20,7,35,10,1
4,137,1,1,20,27,-7,38,10,1
1,863,1,1,0,0,0,53,10,1
1,781,2,0,0,0,0,44,10,1
1,723,2,0,0,0,0,33,11,1
1,672,1,0,0,3,-3,35,10,1
1,593,1,1,3,0,3,39,10,1
1,414,2,0,0,3,-3,9,1,1
1,378,1,0,0,3,-3,2,2,1
1,1,2,0,0,12,-12,41,4,1
2,900,1,0,0,12,-12,33,10,1
2,819,1,0,0,19,-19,33,10,1
2,689,2,0,0,19,-19,3,10,1
2,455,2,0,0,21,-21,47,10,1
2,309,1,0,1,21,-20,53,20,1
2,100,1,0,1,21,-20,19,10,1
2,48,2,0,1,24,-23,40,5,1
2,32,2,0,1,24,-23,51,10,1
3,892,1,0,1,24,-23,31,10,1
3,516,1,0,1,24,-23,10,10,1
3,244,2,0,3,31,-28,35,10,1
3,126,2,0,3,31,-28,43,12,1
4,850,2,1,31,3,28,28,10,1
4,651,1,0,3,31,-28,45,10,1
4,613,1,1,31,3,28,49,10,1
4,586,1,1,31,3,28,34,10,1
4,418,1,1,31,10,21,5,10,1
4,129,2,0,10,31,-21,44,17,1
4,45,1,0,10,31,-21,35,10,1
4,37,1,0,10,31,-21,48,10,1
4,26,1,1,31,10,21,52,10,1
1,796,2,0,0,0,0,48,10,1
1,497,1,1,0,7,-7,26,10,1
1,474,1,1,0,14,-14,33,10,1
1,440,1,1,0,14,-14,48,10,1
1,226,1,0,14,7,7,15,10,1
1,205,2,0,14,7,7,22,3,1
1,121,2,1,7,14,-7,44,5,1
1,95,1,1,7,14,-7,29,10,1
1,0,2,1,7,14,-7,8,8,1
2,889,1,1,7,21,-14,45,10,1
2,849,1,0,21,7,14,53,10,1
2,771,1,0,21,7,14,27,10,1
2,665,1,1,7,21,-14,22,10,1
2,576,1,1,7,21,-14,48,5,1
2,540,1,0,21,7,14,48,10,1
2,499,1,0,21,7,14,33,10,1
2,450,2,0,21,7,14,25,2,1
2,320,2,0,21,14,7,42,7,1
2,300,1,0,21,14,7,53,10,1
2,258,2,0,21,14,7,54,9,1
2,160,2,1,14,21,-7,38,10,1
2,143,1,1,14,21,-7,52,10,1
2,41,1,1,14,21,-7,39,10,1
2,37,1,1,14,21,-7,53,10,1
2,28,2,0,21,14,7,51,4,1
3,855,2,0,21,17,4,36,9,1
3,779,2,1,17,21,-4,50,10,1
3,1,2,1,20,25,-5,38,7,1
4,858,1,1,20,25,-5,42,10,1
4,787,2,1,20,25,-5,27,6,1
4,586,2,0,28,26,2,44,9,1
4,324,1,1,26,28,-2,50,10,1
4,290,2,0,28,26,2,53,3,1
4,270,1,0,28,26,2,47,10,1
4,110,2,1,33,28,5,33,7,1
1,857,2,1,0,0,0,31,8,1
1,719,1,1,0,0,0,16,10,1
1,546,1,1,0,0,0,38,10,1
1,328,2,1,7,0,7,42,7,1
1,304,1,0,0,7,-7,54,10,1
1,173,2,0,0,7,-7,43,10,1
2,835,1,0,0,14,-14,8,15,1
2,588,2,1,14,0,14,8,10,1
2,453,1,0,0,14,-14,9,10,1
2,377,2,0,0,14,-14,23,10,1
2,165,1,0,0,17,-17,46,10,1
2,50,1,1,17,0,17,30,10,1
2,43,1,1,17,0,17,43,10,1
3,663,2,1,20,0,20,45,15,1
3,463,2,0,3,20,-17,52,10,1
3,382,2,1,20,3,17,54,10,1
3,221,1,0,3,20,-17,35,10,1
3,142,2,1,20,3,17,24,10,1
3,86,1,0,3,20,-17,45,10,1
3,1,1,1,20,3,17,38,15,1
4,900,2,1,20,3,17,28,5,1
4,715,2,0,3,20,-17,48,9,1
4,680,1,0,3,20,-17,28,10,1
4,636,2,0,3,20,-17,30,12,1
4,490,1,0,3,21,-18,40,20,1
4,288,2,1,21,3,18,49,5,1
4,155,1,0,3,24,-21,35,10,1
4,80,3,1,24,3,21,7,7,1
1,748,2,1,0,0,0,45,5,1
1,709,1,1,0,0,0,51,10,1
1,574,2,0,0,0,0,9,5,1
1,469,2,0,0,0,0,3,3,1
1,384,1,0,0,7,-7,48,10,1
1,293,1,1,7,0,7,40,10,1
1,265,1,1,7,0,7,16,10,1
1,164,1,1,7,0,7,10,10,1
1,72,1,1,7,7,0,32,10,1
2,839,2,0,7,7,0,16,10,1
2,810,1,0,7,7,0,52,10,1
2,652,1,1,7,7,0,48,10,1
2,635,1,0,7,7,0,20,10,1
2,487,1,0,7,10,-3,35,10,1
2,388,1,1,10,7,3,30,10,1
2,329,2,1,10,7,3,13,27,1
2,150,1,1,10,10,0,35,10,1
2,76,1,1,10,10,0,40,10,1
2,71,2,1,10,10,0,47,3,1
3,894,1,1,10,10,0,17,10,1
3,842,1,0,10,10,0,42,10,1
3,771,2,1,10,10,0,22,10,1
3,541,2,0,17,10,7,50,9,1
3,500,1,0,17,10,7,29,10,1
3,474,2,0,17,10,7,27,8,1
3,327,1,1,13,17,-4,37,10,1
4,778,1,1,13,17,-4,49,20,1
4,713,2,1,13,17,-4,10,10,1
4,682,1,0,24,13,11,42,10,1
4,644,1,0,24,13,11,31,10,1
4,625,2,0,24,13,11,25,4,1
4,586,1,0,24,14,10,35,10,1
4,492,1,0,24,21,3,33,10,1
4,416,1,0,24,22,2,35,10,1
4,213,1,1,22,24,-2,38,10,1
4,180,1,1,22,24,-2,48,10,1
4,166,1,0,24,22,2,52,10,1
4,133,2,0,24,22,2,39,11,1
4,79,1,0,24,25,-1,17,10,1
4,48,1,0,24,28,-4,35,10,1
4,32,1,1,28,24,4,51,10,1
4,24,1,1,28,24,4,18,10,1
4,14,3,1,28,24,4,12,4,1
1,894,1,1,0,0,0,28,10,1
1,753,1,1,0,0,0,34,10,1
1,675,1,0,0,0,0,45,10,1
1,622,1,0,0,0,0,9,9,1
1,492,2,0,0,7,-7,55,5,1
1,380,1,1,7,0,7,1,10,1
1,364,2,1,7,0,7,6,5,1
1,189,1,1,7,0,7,49,15,1
1,130,1,1,7,0,7,10,10,1
1,58,2,1,7,0,7,49,5,1
2,795,2,0,0,10,-10,45,6,1
2,760,1,0,0,10,-10,35,10,1
2,694,1,0,0,10,-10,14,10,1
2,673,1,0,0,17,-17,27,10,1
2,570,2,0,0,17,-17,32,19,1
2,414,2,0,0,17,-17,45,3,1
2,391,1,0,0,17,-17,55,10,1
2,172,2,1,17,1,16,43,17,1
2,108,1,0,1,17,-16,29,10,1
2,55,2,1,17,1,16,27,3,1
2,37,1,1,17,1,16,46,10,1
2,17,2,1,17,1,16,50,6,1
3,855,2,0,1,17,-16,41,5,1
3,810,1,1,17,1,16,15,10,1
3,780,2,1,17,1,16,21,4,1
3,684,1,0,1,17,-16,31,10,1
3,651,1,0,1,17,-16,19,10,1
3,576,2,0,1,17,-16,14,5,1
3,498,2,0,1,24,-23,20,20,1
3,445,1,1,24,1,23,42,10,1
3,278,1,0,1,25,-24,51,10,1
3,231,2,1,25,8,17,33,10,1
3,184,1,0,8,25,-17,33,10,1
3,166,1,1,25,8,17,38,10,1
3,104,1,1,25,8,17,9,9,1
3,95,1,1,25,15,10,45,10,1
3,74,1,1,25,15,10,55,10,1
4,850,2,0,15,28,-13,37,8,1
4,802,2,0,15,28,-13,51,10,1
4,609,1,0,15,28,-13,19,10,1
4,506,1,0,15,28,-13,5,5,1
4,430,2,0,15,34,-19,17,19,1
4,340,1,0,15,34,-19,23,10,1
4,222,1,0,15,41,-26,30,10,1
4,106,2,0,15,48,-33,42,4,1
4,52,2,0,15,48,-33,51,17,1
4,32,3,1,48,15,33,48,6,1
1,755,2,1,0,0,0,13,10,1
1,666,1,1,0,3,-3,45,10,1
1,577,2,0,3,0,3,46,6,1
1,527,1,0,3,7,-4,55,10,1
1,453,1,1,7,3,4,41,15,1
1,156,2,1,7,10,-3,30,10,1
1,85,2,1,7,10,-3,44,8,1
2,843,2,0,10,10,0,36,9,1
2,741,1,0,10,10,0,35,10,1
2,652,2,0,10,10,0,42,24,1
2,605,1,1,10,10,0,16,10,1
2,435,2,0,10,10,0,11,9,1
2,391,1,0,10,10,0,22,10,1
2,348,2,0,10,10,0,20,12,1
2,218,1,0,16,10,6,54,10,1
2,113,1,0,16,13,3,35,10,1
2,106,1,0,16,13,3,48,10,1
2,86,2,0,16,13,3,52,6,1
2,60,1,1,13,16,-3,49,10,1
2,40,1,1,13,16,-3,29,10,1
3,893,1,1,13,19,-6,29,10,1
3,850,2,1,13,19,-6,35,4,1
3,729,1,0,19,13,6,51,10,1
3,667,2,0,19,13,6,49,8,1
3,472,1,0,19,20,-1,36,10,1
3,203,2,0,22,20,2,34,21,1
3,10,1,1,23,22,1,43,20,1
4,900,2,1,23,22,1,50,13,1
4,767,2,0,22,23,-1,25,10,1
4,663,2,0,22,23,-1,5,5,1
4,640,1,0,22,30,-8,42,10,1
4,388,2,0,28,30,-2,38,10,1
4,310,2,1,30,28,2,29,7,1
4,127,1,0,28,33,-5,50,10,1
4,100,1,1,33,28,5,47,10,1
4,94,2,1,33,28,5,48,11,1
4,67,1,1,33,28,5,39,15,1
4,49,3,1,33,28,5,29,5,1
4,29,3,1,33,28,5,18,10,1
4,13,3,1,33,34,-1,22,10,1
4,6,1,1,33,34,-1,49,10,1
1,640,2,1,0,0,0,30,9,1
1,550,1,1,0,0,0,52,10,1
1,510,2,1,0,0,0,50,8,1
1,441,1,1,0,0,0,5,15,1
1,327,2,1,0,0,0,23,8,1
1,251,2,1,0,0,0,47,3,1
1,145,1,0,0,0,0,50,10,1
1,67,1,0,0,1,-1,35,10,1
2,496,1,0,0,1,-1,30,10,1
2,357,1,1,1,7,-6,44,10,1
2,335,1,0,7,1,6,43,10,1
2,180,2,0,7,1,6,30,12,1
2,128,1,1,1,7,-6,22,10,1
2,94,1,1,1,7,-6,34,10,1
2,59,1,0,7,1,6,32,10,1
2,28,2,0,7,1,6,20,10,1
3,894,1,1,2,7,-5,33,10,1
3,850,1,0,7,2,5,46,10,1
3,761,1,0,7,10,-3,25,10,1
3,565,2,1,10,7,3,55,3,1
3,454,2,0,7,11,-4,40,5,1
3,370,2,0,7,11,-4,51,4,1
3,284,2,1,11,7,4,7,6,1
3,217,1,1,11,7,4,37,10,1
3,58,1,0,8,11,-3,49,10,1
4,848,2,0,8,11,-3,30,6,1
4,830,1,0,8,18,-10,15,10,1
4,624,1,0,8,18,-10,7,7,1
4,555,2,0,8,18,-10,1,1,1
4,534,1,0,8,25,-17,29,10,1
4,477,2,0,8,25,-17,40,10,1
4,439,2,1,25,8,17,38,10,1
4,161,2,1,25,11,14,49,5,1
4,122,2,1,27,11,16,37,8,1
4,71,1,0,11,27,-16,37,10,1
4,58,1,1,27,11,16,50,10,1
4,30,1,1,27,11,16,33,10,1
1,885,1,1,0,0,0,21,10,1
1,824,2,0,0,0,0,47,12,1
1,737,2,0,0,3,-3,35,10,1
1,693,1,1,3,0,3,50,10,1
1,632,2,1,3,0,3,37,10,1
1,598,1,1,3,3,0,35,10,1
1,584,2,1,3,3,0,40,5,1
1,549,1,1,3,3,0,47,10,1
1,507,1,0,3,3,0,41,10,1
1,255,2,0,3,6,-3,30,15,1
1,81,2,0,3,6,-3,16,8,1
1,0,2,0,3,6,-3,52,4,1
2,810,1,1,6,10,-4,47,10,1
2,755,1,0,10,6,4,50,10,1
2,685,1,0,10,6,4,30,10,1
2,589,1,1,6,10,-4,8,8,1
2,560,1,1,6,17,-11,35,10,1
2,365,2,0,17,6,11,20,6,1
2,145,1,1,6,17,-11,21,10,1
2,133,2,1,6,17,-11,28,3,1
2,112,2,1,6,17,-11,46,10,1
2,76,2,0,17,6,11,11,10,1
2,17,2,1,9,17,-8,54,5,1
3,821,2,0,17,9,8,40,10,1
3,672,1,1,9,17,-8,15,10,1
3,632,1,0,24,9,15,53,10,1
3,570,1,0,24,9,15,41,10,1
3,546,1,0,24,9,15,18,10,1
3,482,1,0,24,12,12,35,10,1
3,310,1,1,12,24,-12,13,10,1
3,268,1,1,12,31,-19,26,10,1
3,221,2,0,31,12,19,51,15,1
3,142,2,0,31,15,16,34,11,1
3,53,1,1,15,31,-16,27,15,1
4,720,2,1,15,31,-16,32,8,1
4,593,1,1,15,34,-19,35,10,1
4,575,2,1,15,34,-19,44,1,1
4,548,1,1,15,34,-19,53,10,1
4,445,1,1,15,34,-19,53,10,1
4,315,1,1,15,34,-19,28,20,1
4,280,2,1,15,34,-19,28,20,1
4,259,3,1,15,34,-19,43,5,1
4,229,1,1,15,34,-19,50,10,1
4,90,1,1,15,34,-19,24,10,1
4,79,1,1,15,34,-19,40,10,1
4,38,3,1,15,34,-19,47,3,1
4,25,1,1,15,34,-19,54,10,1
4,20,2,0,34,15,19,53,7,1
4,2,1,0,34,15,19,40,10,1
1,888,1,0,0,0,0,38,10,1
1,762,2,1,0,1,-1,39,6,1
1,578,1,0,1,0,1,10,10,1
1,505,1,0,1,0,1,24,10,1
1,349,1,1,0,1,-1,53,10,1
1,293,1,1,0,1,-1,19,10,1
2,900,2,1,0,11,-11,30,7,1
2,866,1,1,0,11,-11,41,10,1
2,761,1,0,11,0,11,47,10,1
2,739,1,0,11,0,11,33,10,1
2,702,1,0,11,0,11,18,10,1
2,507,2,0,11,3,8,40,7,1
2,402,1,0,11,6,5,28,10,1
2,376,2,0,11,6,5,34,4,1
2,248,1,0,11,6,5,47,10,1
2,151,2,0,11,6,5,5,5,1
2,139,2,0,11,13,-2,35,5,1
2,113,1,0,11,13,-2,43,10,1
2,92,1,1,13,11,2,51,10,1
3,608,2,0,14,13,1,44,6,1
3,275,2,1,13,14,-1,47,15,1
4,851,2,1,13,16,-3,44,4,1
4,739,1,1,13,16,-3,26,10,1
4,574,2,0,19,13,6,49,7,1
4,346,2,1,13,19,-6,20,12,1
4,314,1,1,13,26,-13,32,10,1
4,294,2,1,13,26,-13,38,4,1
4,251,2,1,13,26,-13,51,10,1
4,22,2,1,13,26,-13,19,10,1
4,15,1,1,13,26,-13,29,10,1
4,1,2,1,13,26,-13,36,4,1
1,560,2,0,0,0,0,53,24,1
1,338,2,1,0,7,-7,40,10,1
1,54,2,1,0,7,-7,48,4,1
2,875,2,0,7,0,7,25,6,1
2,805,2,0,7,0,7,41,9,1
2,770,1,1,0,7,-7,47,10,1
2,685,1,1,0,7,-7,35,10,1
2,660,2,1,0,7,-7,27,2,1
2,569,1,1,0,7,-7,7,7,1
2,315,1,1,0,10,-10,35,10,1
2,290,1,1,0,10,-10,23,10,1
2,195,2,1,0,10,-10,19,19,1
2,120,2,1,0,13,-13,50,10,1
2,36,1,1,3,13,-10,40,10,1
2,27,2,1,3,13,-10,49,1,1
2,1,2,1,3,13,-10,52,10,1
3,862,2,0,13,3,10,27,6,1
3,674,1,0,13,3,10,34,10,1
3,649,1,0,13,3,10,45,10,1
3,578,1,1,3,13,-10,53,10,1
3,487,1,1,3,13,-10,10,5,1
3,414,1,1,3,13,-10,16,10,1
3,246,2,0,13,3,10,54,9,1
3,116,2,0,13,3,10,14,14,1
4,608,1,1,3,13,-10,13,10,1
4,294,2,0,23,3,20,44,6,1
4,208,2,1,3,23,-20,22,5,1
4,158,1,1,3,26,-23,35,10,1
4,1,2,1,3,26,-23,30,11,1
1,885,1,0,0,0,0,35,10,1
1,851,2,0,0,0,0,42,3,1
1,815,1,0,0,0,0,50,10,1
1,795,2,0,0,0,0,54,6,1
1,526,2,1,0,3,-3,30,13,1
1,400,2,0,3,0,3,46,5,1
1,116,1,0,3,3,0,15,10,1
1,50,2,0,3,3,0,41,4,1
1,1,1,0,3,3,0,45,20,1
2,738,1,1,3,4,-1,50,10,1
2,631,2,0,4,3,1,40,9,1
2,568,2,0,4,3,1,22,10,1
2,516,1,0,4,6,-2,35,10,1
2,262,1,0,7,6,1,20,10,1
2,147,1,1,6,7,-1,33,10,1
2,57,1,0,7,6,1,15,10,1
3,783,1,0,7,9,-2,30,10,1
3,656,1,0,7,9,-2,26,10,1
3,441,1,0,7,9,-2,38,10,1
3,406,2,0,7,9,-2,46,6,1
3,339,2,1,9,7,2,51,10,1
3,316,1,0,7,9,-2,44,10,1
3,199,2,0,7,9,-2,28,10,1
3,116,2,0,7,12,-5,27,18,1
3,9,2,0,7,12,-5,51,10,1
4,900,1,1,12,7,5,38,10,1
4,857,1,1,12,7,5,20,10,1
4,746,2,1,12,14,-2,51,15,1
4,656,2,0,14,12,2,40,11,1
4,525,2,1,12,14,-2,15,10,1
4,473,2,1,12,14,-2,25,10,1
4,434,1,1,12,14,-2,40,10,1
4,363,2,0,14,12,2,42,5,1
4,231,1,0,14,15,-1,45,10,1
4,161,2,1,15,14,1,51,10,1
4,93,1,1,15,17,-2,35,10,1
4,67,2,1,15,17,-2,46,10,1
4,28,1,0,17,18,-1,35,10,1
1,884,2,1,0,1,-1,39,6,1
1,703,2,1,0,1,-1,16,10,1
1,292,1,0,1,0,1,50,10,1
1,250,2,1,0,1,-1,48,10,1
1,89,2,1,0,4,-4,30,15,1
2,885,1,0,4,0,4,19,10,1
2,844,1,0,4,0,4,50,10,1
2,745,1,1,0,4,-4,40,10,1
2,700,1,0,4,0,4,54,10,1
2,655,1,0,4,0,4,49,15,1
2,627,2,0,4,0,4,42,8,1
2,585,1,0,4,0,4,24,10,1
2,434,2,0,4,7,-3,33,5,1
2,256,1,1,7,4,3,25,10,1
2,77,1,0,4,7,-3,44,10,1
3,893,1,0,4,7,-3,28,10,1
3,861,1,0,4,7,-3,40,10,1
3,827,2,0,4,7,-3,48,2,1
3,640,2,1,7,4,3,41,10,1
3,616,1,1,7,4,3,52,10,1
3,83,2,0,7,7,0,55,9,1
3,1,2,1,7,7,0,42,8,1
4,874,1,1,7,7,0,22,10,1
4,781,1,0,7,7,0,32,10,1
4,724,1,0,7,7,0,51,10,1
4,585,1,1,7,7,0,31,10,1
4,527,2,1,7,7,0,54,10,1
4,470,2,0,7,7,0,40,10,1
4,384,1,1,10,7,3,45,10,1
4,304,1,1,10,7,3,34,10,1
4,225,1,1,10,7,3,23,10,1
4,123,1,1,10,7,3,30,10,1
4,25,1,0,7,10,-3,17,10,1
1,880,2,1,0,0,0,37,10,1
1,808,2,1,0,0,0,54,9,1
1,598,2,1,3,0,3,54,4,1
1,585,1,0,0,3,-3,46,10,1
1,546,2,0,0,3,-3,42,6,1
1,484,1,0,0,3,-3,35,10,1
1,335,1,1,10,0,10,35,10,1
1,247,1,1,10,3,7,35,10,1
1,6,1,1,10,3,7,37,10,1
2,720,1,1,10,3,7,39,10,1
2,529,1,1,10,3,7,33,10,1
2,498,2,1,10,3,7,39,4,1
2,420,2,0,3,10,-7,50,14,1
2,377,2,0,3,10,-7,35,10,1
2,334,1,0,3,10,-7,20,10,1
2,228,1,0,3,13,-10,35,10,1
2,129,1,0,3,13,-10,29,10,1
2,108,1,0,3,13,-10,7,7,1
2,47,1,1,20,3,17,44,10,1
3,897,1,0,3,20,-17,24,10,1
3,789,2,0,3,20,-17,39,24,1
3,697,2,0,3,20,-17,33,9,1
3,620,2,1,20,3,17,32,18,1
3,600,1,0,3,20,-17,43,10,1
3,550,2,0,3,20,-17,33,10,1
3,420,2,0,3,20,-17,10,5,1
3,203,1,0,3,27,-24,36,10,1
3,10,2,1,27,3,24,50,10,1
4,830,1,0,3,27,-24,27,10,1
4,710,1,0,3,34,-31,13,10,1
4,620,2,0,3,41,-38,48,10,1
4,256,1,0,5,41,-36,55,10,1
4,100,1,1,41,5,36,35,10,1
1,806,2,1,0,0,0,32,15,1
1,763,1,1,0,3,-3,35,10,1
1,739,2,1,0,3,-3,40,5,1
1,652,2,0,3,0,3,33,11,1
1,480,2,1,3,3,0,23,10,1
1,414,2,1,3,3,0,35,10,1
1,184,1,1,3,10,-7,18,10,1
1,148,2,1,3,10,-7,17,11,1
1,14,1,0,10,3,7,47,10,1
2,755,1,1,10,10,0,51,10,1
2,732,2,0,10,10,0,52,3,1
2,668,2,0,10,10,0,46,10,1
2,590,1,0,10,10,0,43,10,1
2,467,1,0,10,10,0,38,30,1
2,422,2,0,10,10,0,35,33,1
2,208,2,1,10,10,0,34,10,1
2,166,1,1,10,13,-3,21,10,1
2,160,2,1,10,13,-3,30,1,1
2,154,2,1,10,13,-3,37,1,1
2,120,2,0,13,10,3,43,6,1
2,10,1,1,13,13,0,16,10,1
3,623,1,0,20,13,7,23,10,1
3,511,1,0,20,13,7,32,10,1
3,347,1,0,20,20,0,46,10,1
3,322,2,0,20,20,0,49,7,1
3,269,2,1,20,20,0,41,7,1
3,228,1,1,20,20,0,27,10,1
3,44,2,1,20,23,-3,39,6,1
4,691,1,0,23,20,3,51,20,1
4,659,2,1,20,23,-3,49,10,1
4,535,1,1,20,26,-6,35,10,1
4,284,2,0,26,20,6,21,20,1
4,120,1,1,20,26,-6,43,10,1
1,772,2,1,0,0,0,28,4,1
1,654,1,0,0,0,0,43,10,1
1,610,1,1,0,0,0,29,10,1
1,556,2,1,0,0,0,20,14,1
1,260,1,1,0,3,-3,49,10,1
1,43,2,0,6,0,6,39,10,1
2,753,1,1,0,6,-6,45,10,1
2,605,1,1,0,9,-9,27,10,1
2,400,1,0,9,0,9,29,10,1
2,325,2,0,9,0,9,13,5,1
2,168,1,0,9,3,6,54,10,1
2,151,1,1,3,9,-6,33,10,1
2,98,1,1,3,9,-6,23,10,1
2,92,2,1,3,9,-6,25,8,1
2,26,2,0,9,3,6,42,10,1
2,8,2,0,9,3,6,26,10,1
3,889,1,1,6,9,-3,24,10,1
3,816,2,1,6,9,-3,52,5,1
3,681,1,0,9,6,3,30,10,1
3,473,1,1,6,12,-6,50,10,1
3,442,2,1,6,12,-6,46,6,1
3,185,1,0,20,6,14,54,10,1
3,116,1,1,6,20,-14,44,10,1
4,841,2,0,23,6,17,38,6,1
4,683,2,1,6,23,-17,18,10,1
4,571,1,0,23,6,17,52,10,1
4,458,2,1,6,23,-17,28,10,1
4,383,2,1,6,23,-17,46,9,1
4,314,2,1,6,23,-17,48,19,1
4,140,2,0,23,6,17,40,4,1
4,88,1,1,6,23,-17,34,10,1
4,82,2,1,6,23,-17,40,4,1
4,75,1,0,23,6,17,54,10,1
1,894,1,1,0,0,0,33,10,1
1,842,1,1,0,0,0,53,10,1
1,757,1,0,0,7,-7,49,10,1
1,641,2,1,7,0,7,45,5,1
1,548,2,1,7,0,7,37,9,1
1,522,1,1,7,0,7,26,10,1
1,445,2,1,7,0,7,10,10,1
1,164,1,0,7,14,-7,53,10,1
1,11,1,1,14,7,7,35,10,1
2,797,2,1,14,7,7,19,5,1
2,558,3,1,14,14,0,48,10,1
2,505,2,1,14,14,0,21,8,1
2,373,2,1,14,17,-3,36,9,1
2,287,2,1,14,17,-3,50,7,1
2,188,1,0,17,14,3,34,10,1
2,116,1,0,17,17,0,35,10,1
2,72,1,1,17,17,0,45,10,1
2,63,2,1,17,17,0,50,5,1
2,43,1,0,17,17,0,53,10,1
2,35,2,0,17,17,0,48,5,1
2,21,1,0,17,17,0,42,15,1
2,15,2,0,17,17,0,38,11,1
3,894,1,0,17,20,-3,35,10,1
3,871,2,0,17,20,-3,39,6,1
3,742,2,1,20,17,3,17,10,1
3,619,1,1,20,17,3,47,20,1
3,550,1,1,20,20,0,35,10,1
3,536,2,1,20,20,0,39,6,1
3,493,1,1,20,20,0,51,10,1
3,352,2,0,20,23,-3,36,9,1
3,240,1,1,23,20,3,50,10,1
3,212,1,0,20,23,-3,47,10,1
3,95,1,0,20,23,-3,7,17,1
3,37,2,1,23,20,3,55,10,1
4,900,1,0,20,23,-3,15,10,1
4,884,2,0,20,23,-3,20,5,1
4,842,1,0,20,23,-3,44,10,1
4,796,1,1,23,20,3,49,10,1
4,721,2,1,23,20,3,18,10,1
4,498,2,0,23,23,0,42,6,1
4,430,1,1,23,23,0,14,10,1
4,299,1,0,23,30,-7,35,10,1
4,273,2,0,23,30,-7,35,10,1
4,198,2,0,23,30,-7,52,5,1
4,151,1,1,30,23,7,55,10,1
4,55,1,0,23,33,-10,35,10,1
1,610,1,0,0,14,-14,28,10,1
1,550,2,0,0,14,-14,34,4,1
1,430,2,1,14,0,14,37,7,1
1,207,1,0,3,14,-11,48,10,1
1,147,2,1,14,3,11,16,10,1
2,900,2,0,6,14,-8,40,10,1
2,817,2,1,14,6,8,37,5,1
2,742,2,0,6,14,-8,15,10,1
2,712,1,0,6,14,-8,29,10,1
2,677,2,0,6,14,-8,35,4,1
2,611,2,1,14,6,8,30,10,1
2,497,2,0,6,14,-8,8,19,1
2,447,1,1,14,6,8,47,10,1
2,428,1,0,6,14,-8,45,10,1
2,282,2,0,6,14,-8,38,14,1
2,156,1,0,6,21,-15,45,10,1
2,116,1,1,21,6,15,52,10,1
2,93,1,0,6,28,-22,32,10,1
2,86,1,0,6,28,-22,43,10,1
3,657,2,0,6,28,-22,38,3,1
3,594,1,0,6,28,-22,40,10,1
3,474,1,0,6,31,-25,52,10,1
3,393,1,1,31,6,25,48,10,1
3,339,2,1,31,6,25,51,13,1
3,90,2,1,31,9,22,41,4,1
3,44,2,1,31,9,22,51,10,1
3,1,1,0,9,31,-22,10,10,1
4,900,2,0,9,31,-22,8,12,1
4,693,2,0,9,34,-25,40,7,1
4,659,1,0,9,34,-25,53,10,1
4,474,2,0,9,37,-28,35,10,1
4,297,2,0,9,37,-28,40,9,1
4,180,3,1,37,9,28,32,7,1
4,133,2,1,37,9,28,24,10,1
4,70,1,0,9,37,-28,26,10,1
4,61,1,0,9,37,-28,44,10,1
4,36,2,0,9,37,-28,52,2,1
4,18,1,1,37,9,28,51,10,1
1,896,1,0,0,0,0,20,10,1
1,832,2,0,0,0,0,33,10,1
1,806,1,1,0,0,0,37,10,1
1,747,2,1,0,0,0,23,7,1
1,718,1,1,0,0,0,16,10,1
1,563,1,0,3,0,3,28,10,1
1,520,1,0,3,0,3,40,10,1
1,455,2,0,3,0,3,49,12,1
1,323,1,1,0,3,-3,50,10,1
1,188,1,1,0,6,-6,25,20,1
2,887,2,0,6,0,6,30,10,1
2,806,2,0,6,6,0,34,10,1
2,503,2,0,6,6,0,13,13,1
2,363,1,0,6,6,0,36,10,1
2,338,2,0,6,6,0,42,4,1
2,261,1,0,6,6,0,48,20,1
2,197,1,1,6,6,0,33,10,1
2,158,1,1,6,6,0,22,10,1
2,100,1,1,6,13,-7,17,10,1
2,32,1,1,6,13,-7,51,10,1
3,816,2,1,6,13,-7,31,7,1
3,715,1,1,6,20,-14,35,10,1
3,694,2,1,6,20,-14,41,4,1
3,664,1,1,6,20,-14,47,10,1
3,559,2,1,6,20,-14,55,3,1
3,505,1,0,20,6,14,48,10,1
3,197,2,1,13,20,-7,24,10,1
3,169,1,1,13,20,-7,54,10,1
3,32,1,0,20,13,7,14,10,1
4,846,2,0,20,20,0,20,19,1
4,658,1,0,20,29,-9,47,10,1
4,634,1,0,20,29,-9,35,10,1
4,499,1,0,20,29,-9,35,10,1
4,457,1,0,20,29,-9,50,10,1
4,370,1,1,29,20,9,31,10,1
4,354,2,1,29,20,9,34,7,1
4,249,2,1,29,20,9,40,13,1
4,187,1,0,20,29,-9,10,10,1
4,135,2,1,29,20,9,46,9,1
4,100,1,0,20,29,-9,16,10,1
4,73,2,0,20,29,-9,45,10,1
4,66,1,1,29,20,9,48,10,1
4,58,2,1,29,20,9,42,4,1
4,45,3,1,29,20,9,40,2,1
4,21,2,1,29,20,9,24,10,1
4,0,2,1,29,20,9,2,2,1
1,679,1,1,1,0,1,37,10,1
1,652,1,1,1,0,1,51,10,1
1,578,1,0,0,1,-1,49,10,1
1,386,1,1,4,0,4,46,10,1
1,240,1,1,4,0,4,21,15,1
1,126,1,1,4,0,4,37,10,1
2,849,2,1,4,3,1,54,7,1
2,805,1,0,3,4,-1,43,10,1
2,679,2,0,3,5,-2,45,10,1
2,597,2,1,5,3,2,50,5,1
2,448,2,1,5,3,2,30,10,1
2,339,1,0,3,5,-2,23,10,1
2,128,1,0,3,5,-2,38,10,1
2,117,2,0,3,5,-2,42,6,1
2,73,2,0,3,5,-2,50,10,1
2,44,1,1,5,3,2,10,10,1
3,891,1,0,10,5,5,55,10,1
3,869,1,1,5,10,-5,42,10,1
3,723,1,1,5,10,-5,5,5,1
3,695,1,1,5,17,-12,28,10,1
3,230,1,1,5,17,-12,45,10,1
3,63,2,1,5,17,-12,16,19,1
4,900,2,0,17,5,12,41,16,1
4,836,1,1,5,17,-12,3,10,1
4,755,1,0,19,5,14,41,10,1
4,560,2,0,21,5,16,40,10,1
4,496,2,1,5,21,-16,46,5,1
4,423,1,1,5,21,-16,36,10,1
4,85,1,1,5,31,-26,36,10,1
4,61,3,1,5,31,-26,41,5,1
1,708,2,0,0,0,0,43,7,1
1,649,2,1,0,0,0,26,10,1
1,503,2,0,0,0,0,20,8,1
1,257,2,0,7,0,7,47,6,1
1,219,1,0,7,0,7,36,10,1
1,167,1,0,7,0,7,18,10,1
1,117,2,0,7,7,0,25,10,1
2,900,1,0,7,7,0,19,10,1
2,872,2,0,7,7,0,25,4,1
2,736,1,1,7,7,0,27,10,1
2,617,2,0,7,7,0,48,7,1
2,558,2,1,7,7,0,44,9,1
2,504,1,1,7,10,-3,35,10,1
2,339,1,0,10,14,-4,42,10,1
2,202,2,0,10,14,-4,25,10,1
2,115,1,0,10,21,-11,43,10,1
2,85,1,1,21,10,11,6,10,1
3,855,2,0,10,21,-11,32,8,1
3,807,2,0,10,21,-11,50,10,1
3,654,1,0,10,21,-11,29,10,1
3,619,1,0,10,21,-11,41,10,1
3,582,1,0,10,21,-11,55,10,1
3,499,2,1,21,10,11,14,10,1
3,149,2,1,21,13,8,20,7,1
3,74,2,1,21,13,8,30,8,1
3,14,2,1,21,13,8,44,5,1
4,879,1,0,13,21,-8,19,10,1
4,834,1,0,13,21,-8,44,10,1
4,697,2,1,21,13,8,32,8,1
4,599,2,1,21,13,8,4,4,1
4,576,1,1,21,19,2,29,10,1
4,535,1,1,21,19,2,44,10,1
4,497,2,1,21,19,2,50,4,1
4,449,1,0,19,21,-2,35,10,1
4,337,1,0,19,24,-5,40,10,1
4,215,2,1,24,19,5,29,10,1
4,156,1,0,19,24,-5,29,10,1
4,141,2,0,19,24,-5,38,1,1
4,92,1,0,19,24,-5,45,10,1
4,87,1,1,24,25,-1,32,10,1
4,70,1,1,24,25,-1,43,10,1
1,819,1,0,0,0,0,32,10,1
1,749,2,0,0,0,0,48,7,1
1,715,1,1,0,0,0,54,10,1
1,670,1,1,0,0,0,38,10,1
1,636,1,1,0,0,0,25,10,1
1,536,2,1,0,7,-7,15,10,1
1,413,2,1,0,10,-10,37,2,1
1,388,1,1,0,10,-10,23,10,1
1,350,1,1,0,10,-10,9,9,1
1,269,1,1,0,17,-17,30,10,1
1,209,2,1,0,17,-17,45,8,1
1,153,1,1,0,17,-17,27,10,1
1,32,2,1,0,24,-24,38,10,1
2,862,1,0,24,0,24,25,10,1
2,801,1,0,24,0,24,36,10,1
2,653,3,1,0,24,-24,24,13,1
2,469,1,1,0,32,-32,35,10,1
2,287,1,0,32,7,25,29,10,1
2,236,2,0,32,7,25,44,12,1
2,165,1,0,32,7,25,54,10,1
2,149,1,0,32,7,25,43,10,1
2,94,1,0,32,7,25,30,10,1
2,63,1,1,7,32,-25,7,10,1
2,43,2,1,7,32,-25,19,10,1
2,5,1,0,32,7,25,48,10,1
3,894,1,1,7,32,-25,30,10,1
3,807,2,0,32,7,25,18,7,1
3,695,1,1,7,32,-25,26,10,1
3,396,1,1,7,35,-28,35,10,1
3,268,1,0,35,7,28,24,10,1
3,236,2,0,35,7,28,26,8,1
3,195,1,1,7,35,-28,35,10,1
3,162,2,1,7,35,-28,40,5,1
4,711,2,1,7,35,-28,23,25,1
4,680,1,0,35,7,28,34,10,1
4,554,1,0,35,7,28,40,10,1
4,469,1,1,7,38,-31,35,10,1
4,453,1,1,7,38,-31,50,10,1
4,418,1,0,38,7,31,45,10,1
4,366,1,0,38,7,31,5,5,1
4,223,1,1,14,38,-24,37,10,1
1,858,2,1,0,0,0,44,6,1
1,645,1,1,0,0,0,46,10,1
1,611,2,1,0,0,0,40,4,1
1,518,2,1,0,0,0,47,25,1
1,460,1,1,0,3,-3,30,10,1
1,332,2,0,3,0,3,17,14,1
1,290,1,0,3,0,3,50,10,1
1,267,2,0,3,0,3,42,2,1
1,185,2,0,3,0,3,38,9,1
1,1,1,1,3,3,0,32,10,1
2,886,2,1,3,3,0,47,10,1
2,690,1,1,3,3,0,6,15,1
2,684,1,1,3,3,0,22,10,1
2,560,2,1,3,3,0,49,15,1
2,441,2,0,3,3,0,29,9,1
2,275,2,0,3,10,-7,49,6,1
2,62,1,1,10,3,7,35,10,1
2,56,1,1,10,3,7,48,10,1
3,852,2,0,3,10,-7,34,7,1
3,775,1,1,10,3,7,24,15,1
3,750,2,1,10,3,7,34,5,1
3,649,2,1,10,3,7,46,6,1
3,510,1,0,3,10,-7,19,10,1
3,482,2,0,3,10,-7,26,3,1
3,408,2,0,3,10,-7,23,20,1
3,383,1,1,10,3,7,38,10,1
3,197,2,0,3,10,-7,37,21,1
3,1,2,1,10,10,0,5,5,1
4,880,1,1,10,13,-3,34,10,1
4,840,1,0,13,10,3,45,10,1
4,695,1,0,13,11,2,33,10,1
4,373,2,1,11,16,-5,40,5,1
4,325,1,0,16,11,5,12,10,1
4,16,2,1,17,23,-6,17,28,1
1,896,1,1,0,0,0,29,10,1
1,732,1,1,0,0,0,35,10,1
1,678,2,1,0,7,-7,38,7,1
1,633,1,1,0,7,-7,52,10,1
1,547,1,0,7,1,6,35,10,1
1,482,1,1,1,7,-6,39,10,1
1,369,1,1,1,10,-9,32,10,1
1,327,2,1,1,10,-9,30,12,1
1,1,2,0,10,5,5,27,12,1
2,519,2,1,8,17,-9,33,9,1
2,272,2,0,20,8,12,42,2,1
2,236,1,0,20,8,12,54,10,1
2,157,1,1,8,20,-12,25,10,1
2,101,2,0,27,8,19,44,14,1
2,58,1,1,8,27,-19,52,20,1
2,50,2,1,8,27,-19,37,5,1
2,21,1,1,8,30,-22,35,10,1
2,14,1,1,8,30,-22,45,10,1
3,721,1,1,8,30,-22,37,10,1
3,692,2,1,8,30,-22,43,4,1
3,575,1,0,30,8,22,46,10,1
3,437,2,0,30,8,22,36,10,1
3,219,1,1,11,30,-19,17,10,1
3,127,2,1,11,30,-19,27,13,1
3,41,1,1,11,30,-19,41,10,1
3,1,2,1,11,30,-19,47,4,1
4,555,1,0,30,14,16,6,10,1
4,512,1,0,30,14,16,22,10,1
4,319,1,1,14,30,-16,34,10,1
4,221,1,0,30,17,13,35,10,1
4,141,1,1,17,30,-13,30,10,1
4,129,2,1,17,30,-13,46,10,1
4,30,2,0,33,17,16,43,18,1
1,880,1,1,0,0,0,39,15,1
1,803,2,0,0,0,0,40,3,1
1,638,2,0,0,3,-3,30,15,1
1,511,1,0,0,3,-3,33,10,1
1,444,1,0,0,3,-3,10,10,1
1,386,1,1,10,0,10,12,10,1
1,227,1,1,10,3,7,31,10,1
1,187,2,1,10,3,7,37,4,1
1,38,1,0,3,10,-7,33,10,1
2,891,1,0,3,17,-14,43,10,1
2,872,1,1,17,3,14,54,10,1
2,844,2,1,17,3,14,51,7,1
2,644,1,0,6,17,-11,30,10,1
2,529,1,1,17,6,11,21,10,1
2,290,1,0,13,17,-4,27,10,1
2,252,2,0,13,17,-4,23,10,1
2,224,1,1,17,13,4,30,10,1
2,150,1,1,17,16,1,35,10,1
2,121,1,1,17,16,1,37,10,1
2,116,2,1,17,16,1,33,6,1
3,896,1,0,19,17,2,34,10,1
3,820,1,1,17,19,-2,37,10,1
3,761,1,0,19,17,2,48,10,1
3,694,1,1,17,19,-2,27,10,1
3,606,1,0,19,20,-1,35,10,1
3,583,1,1,20,19,1,46,10,1
3,538,1,1,20,19,1,35,15,1
3,451,1,1,20,19,1,13,10,1
3,386,1,0,19,20,-1,46,10,1
3,250,1,1,27,19,8,41,10,1
3,215,1,1,27,19,8,30,10,1
3,16,1,0,26,27,-1,30,10,1
4,790,2,1,27,26,1,15,15,1
4,734,2,1,27,26,1,32,10,1
4,693,1,1,27,26,1,47,10,1
4,630,2,0,26,27,-1,50,10,1
4,517,1,0,26,30,-4,35,10,1
4,489,2,0,26,30,-4,40,5,1
4,262,2,0,29,30,-1,47,3,1
4,152,1,0,29,33,-4,35,10,1
4,85,2,1,33,29,4,44,14,1
1,733,1,0,0,0,0,20,10,1
1,707,1,0,0,0,0,32,10,1
1,627,1,0,0,0,0,41,10,1
1,597,1,0,0,0,0,28,10,1
1,500,2,0,0,0,0,16,10,1
1,355,2,0,0,7,-7,22,7,1
1,207,1,0,0,7,-7,9,20,1
1,163,2,0,0,7,-7,11,18,1
1,50,1,1,7,0,7,47,10,1
1,34,2,1,7,0,7,45,12,1
2,827,2,0,0,7,-7,44,10,1
2,728,1,0,0,7,-7,17,10,1
2,714,1,0,0,14,-14,24,10,1
2,515,2,0,0,14,-14,51,4,1
2,418,1,1,14,0,14,50,10,1
2,372,2,1,14,0,14,51,9,1
2,314,1,0,0,14,-14,42,10,1
2,271,2,0,0,14,-14,33,11,1
2,150,2,0,0,14,-14,22,15,1
2,142,1,0,0,21,-21,27,10,1
2,88,1,0,7,21,-14,51,10,1
2,83,2,0,7,21,-14,46,5,1
2,78,1,0,7,21,-14,40,10,1
2,48,2,0,7,21,-14,17,10,1
3,843,2,1,28,7,21,33,14,1
3,759,2,0,7,28,-21,49,10,1
3,703,1,0,7,28,-21,8,10,1
3,670,1,0,7,28,-21,27,10,1
3,621,1,0,7,28,-21,17,10,1
3,529,1,0,7,31,-24,35,10,1
3,472,2,0,7,31,-24,52,9,1
3,432,1,1,31,7,24,45,10,1
3,282,1,1,31,7,24,32,10,1
3,232,1,0,14,31,-17,54,10,1
3,72,1,0,14,32,-18,35,10,1
3,52,1,0,14,32,-18,47,10,1
4,900,2,1,32,14,18,34,13,1
4,810,2,1,32,17,15,40,5,1
4,760,1,1,32,17,15,48,10,1
4,730,2,1,32,17,15,50,8,1
4,652,2,0,17,32,-15,39,7,1
4,475,1,0,17,35,-18,41,10,1
4,438,1,0,17,35,-18,29,10,1
4,366,1,0,17,38,-21,35,10,1
4,279,2,0,17,38,-21,47,10,1
4,188,2,1,38,17,21,18,18,1
4,142,1,1,38,17,21,16,10,1
4,106,2,1,38,17,21,30,9,1
1,830,2,1,0,0,0,20,15,1
1,700,1,0,0,0,0,47,10,1
1,654,2,0,0,0,0,51,6,1
1,597,1,1,0,0,0,12,10,1
1,534,2,1,0,0,0,9,7,1
1,493,1,1,0,7,-7,23,10,1
1,444,2,1,0,7,-7,40,10,1
1,289,2,0,7,0,7,52,12,1
1,129,1,0,7,0,7,30,10,1
1,33,1,1,0,7,-7,13,10,1
1,8,1,1,0,7,-7,26,10,1
2,844,1,0,7,0,7,43,10,1
2,775,1,0,7,0,7,31,10,1
2,636,2,0,7,7,0,37,3,1
2,610,1,0,7,7,0,42,10,1
2,517,2,0,7,7,0,35,17,1
2,255,2,1,7,7,0,21,4,1
2,220,1,1,7,14,-7,49,10,1
2,156,2,0,14,7,7,43,7,1
2,135,1,0,14,7,7,28,10,1
2,113,2,0,14,7,7,26,8,1
2,81,1,0,14,7,7,15,10,1
2,35,1,0,14,14,0,21,10,1
2,28,2,0,14,14,0,18,7,1
2,3,1,0,14,14,0,6,6,1
3,859,2,0,14,21,-7,17,9,1
3,722,1,0,14,21,-7,50,10,1
3,454,1,1,21,21,0,35,10,1
3,368,1,0,21,21,0,38,10,1
3,277,2,1,21,21,0,40,10,1
3,94,1,0,21,21,0,49,10,1
3,33,2,0,21,21,0,39,10,1
4,842,1,0,21,21,0,15,10,1
4,784,1,0,21,28,-7,24,20,1
4,430,1,1,31,21,10,24,20,1
4,397,2,1,31,21,10,27,17,1
4,205,2,0,21,31,-10,33,10,1
4,174,1,0,21,38,-17,48,10,1
4,151,3,0,21,38,-17,45,13,1
4,136,1,1,38,21,17,51,10,1
4,126,3,1,38,21,17,43,2,1
4,41,1,0,21,38,-17,32,10,1
4,34,2,0,21,38,-17,37,5,1
4,12,2,0,21,38,-17,47,10,1
1,871,2,1,0,0,0,46,4,1
1,793,2,0,0,0,0,52,5,1
1,644,2,0,0,1,-1,41,4,1
1,539,2,1,1,0,1,18,4,1
1,342,1,0,0,1,-1,10,10,1
1,314,1,0,0,1,-1,23,10,1
1,205,2,0,0,1,-1,16,4,1
2,800,2,0,1,4,-3,20,10,1
2,749,1,0,1,7,-6,35,10,1
2,716,2,0,1,7,-6,40,5,1
2,653,2,1,7,1,6,44,9,1
2,540,1,1,7,4,3,35,10,1
2,370,2,0,4,8,-4,49,9,1
2,278,2,1,8,4,4,22,9,1
2,188,2,1,8,4,4,41,6,1
2,118,1,1,8,4,4,52,10,1
2,81,1,0,4,8,-4,17,10,1
2,74,2,0,4,8,-4,23,4,1
3,892,1,0,4,8,-4,39,10,1
3,719,2,1,8,4,4,29,8,1
3,675,1,1,8,4,4,19,10,1
3,519,1,1,8,4,4,39,10,1
3,419,2,1,8,4,4,41,23,1
3,366,1,1,8,4,4,40,10,1
3,274,2,1,8,4,4,26,10,1
3,116,2,0,7,8,-1,36,6,1
3,41,2,0,7,8,-1,52,3,1
4,810,1,0,7,8,-1,19,10,1
4,785,2,0,7,8,-1,22,7,1
4,759,1,0,7,8,-1,43,10,1
4,721,1,1,8,7,1,53,10,1
4,471,1,1,8,7,1,11,10,1
4,335,1,1,8,7,1,38,10,1
4,293,2,1,8,7,1,38,10,1
4,270,1,1,8,7,1,50,10,1
4,202,1,0,7,8,-1,9,10,1
4,180,1,0,7,8,-1,32,10,1
4,119,2,1,8,7,1,54,9,1
4,93,1,1,8,7,1,41,10,1
4,20,1,1,8,10,-2,35,10,1
1,854,2,1,0,0,0,28,11,1
1,825,1,1,0,0,0,44,10,1
1,626,1,0,0,0,0,45,10,1
1,522,1,1,0,0,0,40,10,1
1,366,1,1,0,7,-7,44,10,1
1,303,1,1,0,7,-7,55,10,1
1,284,1,0,7,7,0,26,10,1
1,212,2,1,7,7,0,43,7,1
1,180,1,1,7,7,0,34,10,1
1,160,1,1,7,7,0,18,10,1
2,809,1,1,7,10,-3,23,10,1
2,772,1,1,7,10,-3,35,10,1
2,680,1,0,10,7,3,40,10,1
2,565,1,1,7,10,-3,12,10,1
2,550,1,1,7,10,-3,31,10,1
2,465,1,1,7,10,-3,54,10,1
2,440,2,0,10,7,3,54,8,1
2,337,1,0,10,7,3,46,10,1
2,260,1,0,10,7,3,30,10,1
2,190,1,1,7,10,-3,6,6,1
2,162,1,1,7,17,-10,40,10,1
2,142,2,1,7,17,-10,44,20,1
2,124,1,0,17,7,10,30,10,1
2,119,2,0,17,7,10,30,10,1
2,84,1,0,17,7,10,41,10,1
2,75,2,0,17,7,10,45,6,1
2,61,2,0,17,7,10,51,10,1
2,36,1,1,7,17,-10,40,10,1
3,828,2,0,17,7,10,33,14,1
3,768,2,0,17,7,10,40,25,1
3,718,1,1,7,17,-10,24,10,1
3,590,2,1,7,17,-10,40,7,1
3,493,1,1,7,17,-10,39,10,1
3,369,1,1,7,20,-13,35,10,1
3,107,2,1,10,20,-10,53,6,1
3,46,2,0,20,10,10,45,10,1
3,2,2,0,20,10,10,31,8,1
4,884,1,0,20,10,10,21,10,1
4,589,1,1,17,23,-6,35,10,1
4,522,2,0,23,17,6,38,8,1
4,400,2,0,23,17,6,29,10,1
4,266,2,0,23,20,3,40,20,1
4,149,1,1,20,23,-3,10,10,1
4,76,2,1,20,23,-3,11,9,1
4,28,1,1,20,30,-10,41,10,1
4,16,1,1,20,30,-10,53,10,1
4,9,2,0,30,20,10,50,3,1
1,892,1,1,0,0,0,32,10,1
1,772,2,0,0,0,0,47,9,1
1,726,1,1,0,0,0,47,10,1
1,600,2,1,0,0,0,46,21,1
1,408,1,1,0,0,0,53,5,1
1,349,2,1,0,0,0,37,7,1
1,289,2,1,0,0,0,22,10,1
1,216,1,1,0,0,0,52,10,1
1,96,2,0,0,1,-1,40,5,1
2,822,2,1,1,1,0,40,5,1
2,788,1,1,1,1,0,50,10,1
2,721,1,0,1,1,0,49,10,1
2,684,1,0,1,1,0,35,10,1
2,343,1,1,4,4,0,35,10,1
2,209,1,0,4,4,0,18,10,1
2,163,2,0,4,4,0,28,20,1
2,142,1,1,4,4,0,18,10,1
2,125,2,1,4,4,0,23,5,1
2,107,1,1,4,4,0,30,10,1
2,55,1,0,4,4,0,34,10,1
2,50,2,0,4,4,0,35,9,1
2,14,1,0,4,4,0,45,10,1
3,818,1,1,4,4,0,36,10,1
3,691,2,0,4,5,-1,41,4,1
3,542,2,1,5,4,1,29,5,1
3,473,2,1,5,4,1,42,9,1
3,292,1,0,4,5,-1,41,10,1
3,24,2,1,5,4,1,52,6,1
3,1,1,0,4,5,-1,52,10,1
4,886,1,0,4,5,-1,30,10,1
4,685,2,1,12,4,8,36,5,1
4,642,1,1,12,4,8,41,10,1
4,464,2,0,4,12,-8,12,15,1
4,400,2,0,4,12,-8,34,10,1
4,127,1,0,11,13,-2,40,10,1
1,870,2,0,0,0,0,43,10,1
1,797,2,1,0,0,0,19,5,1
1,696,2,1,0,0,0,36,4,1
1,343,2,1,0,7,-7,35,7,1
1,80,2,1,0,10,-10,19,10,1
2,795,2,0,10,0,10,31,5,1
2,599,1,1,3,10,-7,28,10,1
2,590,1,1,3,10,-7,38,10,1
2,566,2,1,3,10,-7,43,5,1
2,427,1,0,10,6,4,30,10,1
2,403,2,0,10,6,4,33,7,1
2,310,2,0,10,6,4,31,19,1
2,273,1,1,6,10,-4,28,10,1
2,178,2,0,10,6,4,36,6,1
2,7,1,1,6,13,-7,50,10,1
3,870,2,1,9,13,-4,51,12,1
3,748,1,0,13,9,4,30,15,1
3,716,2,0,13,9,4,37,8,1
3,678,2,1,9,13,-4,52,7,1
3,592,2,1,9,13,-4,18,7,1
3,544,1,1,9,13,-4,28,10,1
3,349,1,1,9,13,-4,40,10,1
3,285,2,0,13,9,4,53,4,1
3,220,2,0,13,10,3,20,25,1
3,143,2,1,10,13,-3,43,10,1
3,105,1,1,10,13,-3,53,10,1
3,70,2,1,10,13,-3,49,14,1
4,884,2,0,13,10,3,18,10,1
4,842,2,0,13,17,-4,46,6,1
4,543,2,1,17,19,-2,25,10,1
4,387,2,1,17,19,-2,53,6,1
4,359,1,1,17,26,-9,26,10,1
4,223,2,0,26,17,9,37,8,1
4,88,1,1,17,33,-16,24,10,1
1,817,1,0,0,0,0,34,10,1
1,779,2,0,0,0,0,35,9,1
1,729,1,1,0,0,0,24,10,1
1,579,1,1,0,0,0,34,10,1
1,435,2,0,0,1,-1,40,5,1
1,333,1,0,0,1,-1,45,10,1
1,293,2,0,0,1,-1,42,13,1
1,208,2,1,1,0,1,2,14,1
1,72,1,1,1,0,1,44,10,1
1,1,2,1,1,0,1,39,15,1
2,756,1,0,0,1,-1,52,10,1
2,535,2,1,1,0,1,46,8,1
2,496,1,1,1,0,1,29,10,1
2,169,1,1,1,3,-2,25,10,1
2,95,1,0,3,1,2,20,10,1
2,89,2,0,3,1,2,27,3,1
2,47,1,0,3,1,2,25,15,1
2,40,1,1,1,3,-2,45,10,1
3,665,1,0,6,8,-2,25,10,1
3,631,2,0,6,8,-2,31,4,1
3,590,1,0,6,8,-2,36,10,1
3,551,2,0,6,8,-2,39,7,1
3,304,1,0,6,8,-2,10,10,1
3,258,1,1,8,6,2,29,10,1
3,185,1,1,8,6,2,16,10,1
3,75,1,1,8,13,-5,34,10,1
3,1,1,1,8,13,-5,44,10,1
4,890,1,0,13,8,5,27,10,1
4,820,2,0,13,8,5,15,10,1
4,694,1,0,13,11,2,53,10,1
4,552,1,0,13,14,-1,35,10,1
4,485,2,1,14,13,1,48,7,1
4,442,1,1,14,13,1,30,10,1
4,232,2,1,14,16,-2,36,10,1
4,192,1,0,16,14,2,53,10,1
4,49,2,0,16,24,-8,35,10,1
1,875,2,0,0,0,0,24,10,1
1,731,1,1,0,0,0,48,10,1
1,712,1,0,0,0,0,50,10,1
1,592,1,1,0,0,0,10,10,1
1,564,2,1,0,0,0,14,6,1
1,491,2,1,0,0,0,33,3,1
1,360,2,1,0,0,0,35,4,1
1,293,2,1,0,0,0,26,6,1
1,194,2,1,0,0,0,17,8,1
1,172,1,1,0,7,-7,30,10,1
2,708,1,0,7,7,0,48,10,1
2,132,2,0,7,24,-17,54,10,1
2,87,2,0,7,24,-17,20,10,1
2,55,1,0,7,31,-24,36,10,1
2,48,1,0,7,31,-24,50,10,1
3,788,1,1,31,10,21,46,10,1
3,725,2,1,31,10,21,24,17,1
3,674,1,1,31,13,18,35,10,1
3,596,2,0,13,31,-18,28,10,1
3,542,2,0,13,31,-18,55,7,1
3,498,2,1,31,13,18,45,10,1
3,295,1,1,31,16,15,47,10,1
3,281,2,1,31,16,15,41,4,1
3,196,2,1,31,16,15,11,6,1
3,140,2,1,31,23,8,31,5,1
3,100,1,1,31,23,8,43,10,1
4,900,1,0,23,31,-8,16,10,1
4,879,1,0,23,31,-8,31,10,1
4,728,1,1,31,24,7,35,10,1
4,520,2,0,24,34,-10,30,15,1
4,392,2,0,24,34,-10,39,10,1
4,303,2,1,34,24,10,39,9,1
4,247,1,0,24,34,-10,10,10,1
4,214,2,0,24,34,-10,16,4,1
4,156,1,0,24,34,-10,35,10,1
4,147,1,0,24,34,-10,45,10,1
4,140,2,0,24,34,-10,54,1,1
4,132,1,1,34,24,10,44,10,1
4,89,1,1,34,27,7,47,10,1
1,866,2,0,0,0,0,30,7,1
1,755,2,0,0,7,-7,33,6,1
1,681,2,0,0,7,-7,43,12,1
1,610,1,1,7,0,7,23,10,1
1,467,2,1,7,0,7,50,8,1
1,248,2,1,7,0,7,14,9,1
1,143,2,1,7,7,0,7,10,1
1,56,2,1,7,7,0,50,10,1
2,900,2,1,7,7,0,37,7,1
2,700,2,0,8,7,1,13,6,1
2,605,2,0,8,7,1,36,5,1
2,479,2,1,7,8,-1,44,10,1
2,145,1,1,7,8,-1,38,10,1
2,90,1,0,8,7,1,14,10,1
2,82,1,0,8,7,1,25,10,1
2,76,1,0,8,7,1,36,10,1
3,835,2,1,7,8,-1,51,5,1
3,652,1,0,8,7,1,33,10,1
3,558,2,1,7,8,-1,13,4,1
3,500,1,1,7,8,-1,9,10,1
3,482,1,1,7,8,-1,31,10,1
3,440,2,1,7,8,-1,36,5,1
3,213,1,1,7,11,-4,35,10,1
3,196,2,1,7,11,-4,38,7,1
3,18,2,1,7,11,-4,40,7,1
4,832,1,0,11,7,4,14,10,1
4,634,1,1,7,11,-4,4,10,1
4,555,1,0,11,7,4,45,10,1
4,244,1,1,7,25,-18,42,10,1
4,181,1,1,7,25,-18,46,10,1
4,117,2,1,7,32,-25,35,10,1
4,107,1,1,7,32,-25,46,10,1
1,890,1,0,0,0,0,50,10,1
1,811,2,0,0,0,0,35,6,1
1,624,1,0,0,10,-10,37,10,1
1,548,1,0,0,10,-10,50,10,1
1,475,1,1,10,0,10,54,15,1
1,395,1,1,10,0,10,18,10,1
1,360,2,1,10,0,10,23,5,1
1,283,2,1,10,0,10,53,9,1
1,137,1,0,0,10,-10,43,10,1
2,873,1,1,10,3,7,31,10,1
2,589,2,1,10,3,7,24,10,1
2,541,1,1,10,3,7,34,10,1
2,481,1,0,3,10,-7,37,10,1
2,387,2,0,3,10,-7,18,17,1
2,293,2,1,13,3,10,38,10,1
2,44,1,0,6,13,-7,44,10,1
2,27,1,1,13,6,7,54,15,1
3,812,2,0,9,13,-4,17,10,1
3,675,1,0,9,16,-7,47,10,1
3,449,2,0,12,16,-4,31,15,1
3,371,2,1,16,12,4,26,18,1
3,270,2,0,12,16,-4,22,8,1
3,196,2,0,12,16,-4,42,4,1
3,0,1,1,16,12,4,1,1,1
4,874,2,1,16,19,-3,39,10,1
4,782,1,0,19,16,3,47,10,1
4,430,2,0,19,16,3,18,22,1
4,338,2,0,19,16,3,45,7,1
4,239,2,0,19,16,3,20,6,1
4,29,1,1,16,20,-4,32,10,1
4,22,1,1,16,20,-4,43,10,1
4,11,3,1,16,20,-4,48,5,1
1,828,1,0,0,0,0,51,10,1
1,800,1,1,0,0,0,50,15,1
1,660,2,1,0,3,-3,38,5,1
1,360,1,0,3,0,3,36,10,1
1,244,2,0,3,0,3,6,6,1
1,108,2,0,3,0,3,1,1,1
1,61,2,0,3,7,-4,35,5,1
2,863,1,0,3,7,-4,54,10,1
2,765,2,0,3,8,-5,35,10,1
2,690,2,1,8,3,5,32,10,1
2,603,2,1,8,3,5,55,5,1
2,404,2,0,3,8,-5,8,10,1
2,336,2,0,3,8,-5,23,6,1
2,70,1,0,3,8,-5,20,15,1
2,49,2,0,3,8,-5,25,10,1
2,30,2,0,3,8,-5,45,2,1
3,851,2,1,8,3,5,20,10,1
3,622,2,1,9,3,6,34,6,1
3,578,1,1,9,3,6,42,10,1
3,480,2,0,3,9,-6,35,7,1
3,304,2,1,9,3,6,45,8,1
3,194,1,0,3,12,-9,35,10,1
3,115,2,0,3,12,-9,46,7,1
4,798,1,0,3,13,-10,21,10,1
4,684,1,1,13,3,10,32,15,1
4,596,2,1,13,3,10,55,7,1
4,534,1,0,3,13,-10,30,10,1
4,518,2,0,3,13,-10,33,7,1
4,480,1,0,3,13,-10,53,10,1
4,426,2,1,13,3,10,38,4,1
4,374,1,1,13,3,10,28,10,1
4,270,1,0,10,20,-10,48,10,1
4,129,1,0,10,20,-10,36,10,1
4,116,1,0,10,20,-10,47,10,1
4,17,1,0,10,20,-10,44,10,1
4,10,2,0,10,20,-10,51,3,1
1,892,1,0,0,0,0,40,10,1
1,862,2,0,0,0,0,45,5,1
1,823,1,0,0,0,0,54,10,1
1,739,2,1,0,0,0,41,5,1
1,543,0,0,0,0,0,27,0,1
1,450,1,1,0,7,-7,25,10,1
1,216,2,1,0,7,-7,20,8,1
1,184,1,1,0,7,-7,30,10,1
1,108,1,1,0,7,-7,43,10,1
1,69,1,1,0,7,-7,55,10,1
2,802,1,0,7,0,7,10,25,1
2,674,2,1,2,7,-5,34,10,1
2,456,1,0,7,4,3,28,10,1
2,326,2,0,7,11,-4,15,10,1
2,193,1,0,7,11,-4,53,10,1
2,110,1,0,7,11,-4,27,10,1
3,894,1,0,7,14,-7,34,10,1
3,796,1,0,7,14,-7,43,10,1
3,685,2,0,7,14,-7,11,6,1
3,476,2,0,7,21,-14,52,9,1
3,432,1,1,21,7,14,45,10,1
3,332,1,1,21,7,14,13,10,1
4,837,1,1,21,21,0,47,10,1
4,405,1,1,21,27,-6,51,10,1
4,333,2,1,21,27,-6,51,10,1
4,152,1,1,28,30,-2,46,10,1
4,20,1,0,30,35,-5,31,10,1
4,15,1,0,30,35,-5,50,10,1
1,696,1,1,3,1,2,35,10,1
1,601,2,1,3,1,2,50,6,1
1,563,1,0,1,3,-2,49,10,1
1,474,2,0,1,3,-2,9,8,1
1,322,1,1,10,1,9,13,10,1
1,261,2,1,10,1,9,15,8,1
1,218,1,1,10,1,9,41,10,1
1,121,1,0,3,10,-7,45,10,1
2,883,2,1,10,3,7,15,6,1
2,724,2,0,3,10,-7,52,6,1
2,665,1,1,10,3,7,9,10,1
2,650,1,1,10,3,7,38,10,1
2,583,1,1,10,3,7,48,10,1
2,503,2,1,10,3,7,38,20,1
2,379,1,1,10,3,7,39,20,1
2,350,2,1,10,3,7,44,15,1
2,314,1,0,3,10,-7,27,10,1
2,100,1,0,3,13,-10,12,10,1
2,95,2,0,3,13,-10,15,7,1
2,22,1,1,13,3,10,20,10,1
3,713,2,0,12,13,-1,51,10,1
3,586,1,0,12,13,-1,17,10,1
3,528,2,0,12,13,-1,18,19,1
3,466,1,1,13,12,1,40,10,1
3,452,2,1,13,12,1,48,2,1
3,291,1,1,13,12,1,34,10,1
3,266,1,1,13,12,1,48,10,1
3,155,1,0,12,13,-1,40,10,1
4,890,1,0,12,13,-1,39,10,1
4,796,1,1,13,12,1,54,10,1
4,741,1,0,12,13,-1,43,10,1
4,657,2,0,12,13,-1,27,10,1
4,566,1,0,12,13,-1,20,10,1
4,544,1,1,13,12,1,52,10,1
4,443,1,1,13,12,1,17,10,1
4,416,1,1,13,12,1,27,10,1
4,374,2,1,13,12,1,31,6,1
4,296,2,1,13,12,1,38,10,1
4,268,1,0,12,13,-1,54,10,1
4,164,1,0,12,13,-1,12,10,1
4,27,1,0,12,13,-1,28,10,1
4,7,1,0,12,13,-1,41,10,1
1,899,1,1,0,0,0,45,10,1
1,847,2,1,0,0,0,55,10,1
1,694,2,0,0,0,0,21,4,1
1,610,1,0,0,8,-8,35,10,1
1,378,2,1,8,7,1,27,10,1
1,285,2,0,7,8,-1,13,5,1
1,252,1,0,7,8,-1,28,10,1
1,142,1,1,8,7,1,51,10,1
1,1,1,0,7,8,-1,8,10,1
2,900,2,0,7,8,-1,14,4,1
2,620,2,1,8,7,1,46,11,1
2,583,1,0,7,8,-1,47,10,1
2,520,1,0,7,8,-1,27,10,1
2,376,1,0,7,15,-8,41,10,1
2,263,2,1,15,7,8,25,4,1
2,114,1,0,10,15,-5,47,10,1
3,894,1,1,15,10,5,31,10,1
3,856,1,1,15,10,5,44,10,1
3,795,1,0,10,15,-5,52,10,1
3,707,1,0,10,15,-5,41,10,1
3,543,1,1,18,10,8,34,10,1
3,219,2,1,18,10,8,35,7,1
3,95,1,0,10,18,-8,16,10,1
3,23,2,1,18,10,8,53,6,1
4,900,1,1,18,10,8,8,10,1
4,858,1,1,18,10,8,28,10,1
4,840,1,1,18,10,8,44,10,1
4,664,2,0,10,18,-8,33,10,1
4,511,2,0,10,25,-15,33,10,1
4,470,1,0,10,25,-15,45,10,1
4,436,2,1,25,10,15,43,10,1
4,141,1,0,13,28,-15,35,10,1
4,133,1,0,13,28,-15,46,10,1
4,103,1,1,28,13,15,39,10,1
1,857,2,1,0,0,0,50,10,1
1,813,2,0,0,0,0,34,10,1
1,742,1,0,0,3,-3,40,5,1
1,457,2,0,0,3,-3,38,6,1
1,368,1,1,3,0,3,40,10,1
1,252,1,0,0,3,-3,22,10,1
1,139,1,1,3,0,3,33,10,1
1,106,2,1,3,0,3,35,8,1
1,68,1,1,3,0,3,48,10,1
2,839,2,0,0,3,-3,9,19,1
2,666,1,1,3,0,3,39,10,1
2,562,1,1,3,3,0,35,10,1
2,540,1,1,3,3,0,50,10,1
2,433,2,0,3,3,0,51,14,1
2,393,3,0,3,3,0,42,5,1
2,303,1,0,3,3,0,21,5,1
2,180,2,1,5,3,2,42,10,1
2,153,1,1,5,3,2,53,10,1
2,99,1,0,3,5,-2,25,10,1
2,91,1,0,3,5,-2,45,10,1
2,41,1,1,5,3,2,41,10,1
2,17,2,1,5,3,2,38,7,1
3,845,2,0,6,5,1,37,11,1
3,763,2,1,5,6,-1,18,23,1
3,706,1,0,6,5,1,45,10,1
3,615,2,1,5,6,-1,25,9,1
3,537,2,1,5,6,-1,39,8,1
3,456,1,0,6,5,1,44,15,1
3,388,1,1,5,6,-1,51,10,1
3,281,1,1,5,7,-2,35,10,1
3,91,2,1,5,7,-2,33,18,1
4,586,2,0,7,5,2,25,19,1
4,520,1,0,7,5,2,51,10,1
4,488,2,0,7,5,2,45,4,1
4,425,2,0,7,5,2,37,6,1
4,260,2,0,7,5,2,26,10,1
4,145,2,0,7,5,2,34,12,1
4,113,2,1,5,7,-2,51,14,1
1,823,1,0,0,0,0,35,10,1
1,698,2,1,0,0,0,14,10,1
1,623,1,1,0,0,0,48,10,1
1,579,2,0,0,0,0,49,8,1
1,338,2,1,0,3,-3,17,20,1
1,247,2,1,0,3,-3,51,10,1
1,178,1,1,0,3,-3,14,10,1
1,160,2,1,0,3,-3,18,6,1
1,118,1,1,0,3,-3,15,20,1
1,70,2,1,0,3,-3,19,16,1
2,863,1,1,0,3,-3,20,10,1
2,624,2,1,0,3,-3,28,20,1
2,584,1,1,0,3,-3,54,10,1
2,492,2,0,3,0,3,26,10,1
2,475,1,0,3,7,-4,50,10,1
2,337,1,1,7,3,4,30,10,1
2,180,1,1,7,10,-3,39,10,1
2,142,1,1,7,17,-10,25,10,1
2,135,1,1,7,17,-10,39,10,1
2,114,2,1,7,17,-10,41,8,1
2,80,2,0,17,7,10,27,10,1
2,52,1,0,17,7,10,48,10,1
2,45,2,0,17,7,10,39,1,1
2,35,1,0,17,7,10,31,10,1
2,19,2,0,17,7,10,19,10,1
3,834,2,0,17,10,7,42,6,1
3,644,1,1,10,17,-7,11,10,1
3,530,2,0,24,10,14,26,4,1
3,420,2,0,24,10,14,50,7,1
3,374,1,1,10,24,-14,52,10,1
3,80,2,0,31,10,21,13,11,1
3,5,1,0,31,10,21,50,10,1
4,648,1,1,13,31,-18,48,10,1
4,401,2,1,13,34,-21,35,10,1
4,287,3,0,34,13,21,21,10,1
4,170,1,0,34,20,14,40,10,1
4,148,1,0,34,27,7,31,10,1
4,83,1,1,27,41,-14,50,10,1
4,55,3,0,41,27,14,51,1,1
4,38,1,0,41,27,14,46,10,1
4,21,1,0,41,27,14,24,10,1
1,751,1,0,0,7,-7,32,10,1
1,723,1,0,0,7,-7,55,10,1
1,579,2,0,0,7,-7,54,5,1
1,497,2,1,7,0,7,54,16,1
1,384,1,1,7,10,-3,27,10,1
1,282,2,1,7,10,-3,52,7,1
1,241,1,1,7,10,-3,38,10,1
1,195,1,1,7,10,-3,21,5,1
1,65,2,1,7,10,-3,17,12,1
1,0,2,1,7,10,-3,3,3,1
2,873,2,1,7,17,-10,25,10,1
2,801,2,1,7,17,-10,50,7,1
2,474,2,1,7,17,-10,26,9,1
2,388,2,1,7,17,-10,26,20,1
2,340,1,0,17,7,10,47,10,1
2,308,2,0,17,7,10,50,7,1
2,204,2,0,17,7,10,51,20,1
2,163,2,1,7,17,-10,12,1,1
2,123,1,1,7,20,-13,35,10,1
2,118,2,1,7,20,-13,41,4,1
2,88,1,0,20,7,13,34,10,1
2,80,1,0,20,7,13,50,10,1
2,40,2,1,7,20,-13,51,11,1
3,893,1,1,7,21,-14,37,10,1
3,831,1,0,21,7,14,34,10,1
3,777,1,0,21,10,11,35,10,1
3,745,2,0,21,10,11,40,5,1
3,634,1,1,10,21,-11,51,10,1
3,483,1,1,10,24,-14,36,10,1
3,413,1,0,24,10,14,34,10,1
3,203,2,0,24,17,7,40,11,1
3,169,1,1,17,24,-7,12,10,1
3,98,2,1,17,24,-7,49,5,1
3,62,1,0,24,17,7,53,10,1
3,0,1,0,24,17,7,10,10,1
4,733,1,1,31,24,7,17,10,1
4,535,1,1,31,24,7,36,10,1
4,394,2,0,24,31,-7,35,5,1
4,274,2,0,24,31,-7,43,13,1
4,208,1,0,24,31,-7,13,10,1
4,169,1,0,24,38,-14,37,10,1
4,163,2,0,24,38,-14,42,5,1
4,127,2,0,24,38,-14,43,15,1
4,121,3,0,24,38,-14,44,14,1
4,80,3,1,38,24,14,38,10,1
4,12,1,1,38,24,14,2,2,1
1,893,1,1,0,0,0,40,10,1
1,731,2,0,0,0,0,7,4,1
1,696,1,0,0,0,0,14,10,1
1,568,1,0,0,0,0,48,10,1
1,526,2,0,0,0,0,54,4,1
1,326,1,1,0,1,-1,30,10,1
1,283,2,1,0,1,-1,30,10,1
1,195,2,0,1,0,1,40,7,1
1,154,1,0,1,0,1,25,10,1
1,108,1,0,1,7,-6,25,10,1
1,74,2,0,1,7,-6,28,7,1
2,823,2,1,7,8,-1,20,7,1
2,785,1,1,7,8,-1,28,10,1
2,738,1,0,8,7,1,35,10,1
2,327,2,1,8,10,-2,29,6,1
2,79,2,1,8,20,-12,20,20,1
2,17,1,1,8,27,-19,21,10,1
2,1,2,1,8,27,-19,28,3,1
3,858,1,0,27,8,19,43,10,1
3,822,2,0,27,8,19,40,7,1
3,778,1,0,27,8,19,19,10,1
3,727,2,0,27,8,19,14,5,1
3,562,2,0,27,15,12,26,10,1
3,355,1,1,15,30,-15,33,10,1
4,843,2,1,16,30,-14,34,10,1
4,714,1,1,16,30,-14,37,10,1
4,491,1,1,17,30,-13,18,10,1
4,303,1,1,17,30,-13,25,10,1
4,263,1,1,17,30,-13,39,10,1
4,192,2,1,17,30,-13,51,11,1
4,180,1,0,30,17,13,44,10,1
4,170,2,0,30,17,13,38,4,1
4,147,2,0,30,17,13,29,8,1
4,49,1,1,24,30,-6,35,10,1
1,825,1,1,0,0,0,26,10,1
1,683,1,1,0,0,0,28,10,1
1,634,2,1,0,0,0,39,10,1
2,893,1,0,0,5,-5,43,10,1
2,734,2,1,5,0,5,47,17,1
2,617,1,1,5,3,2,48,10,1
2,502,1,0,3,5,-2,36,10,1
2,463,2,0,3,5,-2,31,5,1
2,381,2,0,3,5,-2,29,15,1
2,231,2,0,3,6,-3,44,10,1
2,169,1,0,3,6,-3,33,10,1
2,150,2,1,6,3,3,54,7,1
2,129,1,1,6,3,3,46,10,1
2,104,2,0,3,6,-3,52,22,1
2,41,1,1,6,3,3,34,10,1
3,896,1,1,6,6,0,39,10,1
3,864,2,1,6,6,0,45,4,1
3,826,1,0,6,6,0,11,10,1
3,512,1,0,6,9,-3,45,10,1
3,460,1,1,9,6,3,48,10,1
3,305,1,1,9,9,0,35,10,1
3,176,2,1,9,9,0,54,6,1
3,16,1,0,9,12,-3,35,10,1
4,885,1,0,9,12,-3,46,10,1
4,859,1,1,12,16,-4,39,10,1
4,783,2,0,16,12,4,7,7,1
4,659,1,0,16,19,-3,49,10,1
4,595,1,0,16,19,-3,26,10,1
4,411,1,0,16,26,-10,25,10,1
4,355,2,0,16,26,-10,36,10,1
4,299,1,1,26,16,10,35,10,1
4,241,2,1,26,16,10,55,7,1
4,161,1,0,16,26,-10,23,10,1
4,80,2,0,16,33,-17,45,6,1
4,72,1,0,16,33,-17,53,10,1
1,883,1,0,0,0,0,29,10,1
1,824,1,0,0,3,-3,35,10,1
1,749,1,0,0,3,-3,48,10,1
1,730,1,1,3,0,3,26,10,1
1,653,1,1,3,0,3,15,10,1
1,634,1,1,3,7,-4,25,10,1
1,547,1,0,7,3,4,21,10,1
1,524,1,1,3,7,-4,50,10,1
1,483,1,1,3,7,-4,35,10,1
1,426,1,1,3,7,-4,24,10,1
1,355,1,1,3,7,-4,11,10,1
1,298,2,1,3,15,-12,41,4,1
1,197,2,0,15,3,12,44,10,1
2,841,2,0,15,3,12,30,20,1
2,741,1,1,3,15,-12,38,10,1
2,701,2,1,3,15,-12,44,4,1
2,664,1,1,3,15,-12,19,10,1
2,553,2,1,3,15,-12,2,2,1
2,466,1,1,3,22,-19,40,10,1
2,385,1,1,3,22,-19,38,10,1
2,284,2,1,3,22,-19,27,10,1
2,235,1,1,3,29,-26,19,20,1
2,213,2,1,3,29,-26,26,13,1
2,149,2,0,29,3,26,26,11,1
2,94,1,0,29,3,26,51,10,1
2,47,2,0,29,3,26,20,5,1
2,38,1,0,29,3,26,12,10,1
3,860,2,1,10,29,-19,8,9,1
3,810,1,0,29,10,19,34,10,1
3,778,2,0,29,10,19,40,4,1
3,740,1,0,29,10,19,52,10,1
3,401,1,0,32,18,14,30,10,1
3,307,1,0,32,18,14,14,10,1
3,290,1,0,32,25,7,19,10,1
3,224,1,0,32,25,7,29,10,1
3,140,1,1,25,32,-7,34,10,1
3,1,1,0,32,25,7,40,10,1
4,900,2,0,32,25,7,44,6,1
4,870,1,0,32,25,7,51,10,1
4,800,1,1,25,32,-7,46,10,1
4,767,2,1,25,32,-7,46,10,1
4,713,1,1,25,33,-8,35,10,1
4,612,2,0,33,25,8,35,6,1
4,465,2,1,25,33,-8,55,8,1
4,355,2,0,33,25,8,21,6,1
4,303,1,0,33,25,8,15,10,1
4,249,2,0,33,33,0,16,27,1
4,200,1,0,33,33,0,52,10,1
4,180,1,0,33,33,0,37,10,1
4,108,1,0,33,33,0,25,20,1
4,98,1,0,33,40,-7,41,10,1
4,85,1,0,33,40,-7,54,10,1
4,56,2,0,33,40,-7,52,12,1
4,39,1,1,40,33,7,42,10,1
1,891,1,0,0,0,0,45,10,1
1,852,2,0,0,0,0,48,7,1
1,812,1,1,0,0,0,49,10,1
1,645,1,1,0,0,0,23,10,1
1,571,1,1,0,0,0,34,10,1
1,467,1,0,0,0,0,41,10,1
1,396,2,1,0,0,0,40,3,1
1,275,1,1,0,0,0,25,10,1
1,121,1,1,0,3,-3,34,10,1
2,872,1,1,3,3,0,44,10,1
2,795,2,0,3,3,0,40,3,1
2,780,1,0,3,3,0,33,10,1
2,716,2,0,3,3,0,29,19,1
2,575,1,0,3,6,-3,36,10,1
2,507,2,0,3,6,-3,29,17,1
2,412,2,1,6,3,3,37,5,1
2,330,2,1,6,3,3,51,11,1
2,155,1,1,8,3,5,39,10,1
2,149,1,0,3,8,-5,27,10,1
2,125,1,0,3,8,-5,16,10,1
2,82,2,0,3,8,-5,16,10,1
2,45,2,0,3,8,-5,4,4,1
2,37,1,0,3,15,-12,40,10,1
3,873,2,1,15,3,12,50,10,1
3,792,1,0,3,15,-12,21,10,1
3,751,2,0,3,15,-12,22,9,1
3,524,1,1,15,6,9,35,10,1
3,479,1,0,6,15,-9,52,10,1
3,440,2,0,6,15,-9,52,10,1
3,310,1,0,6,16,-10,38,10,1
3,220,2,1,16,6,10,53,5,1
4,698,2,1,16,9,7,39,6,1
4,447,2,0,9,19,-10,34,11,1
4,335,1,0,9,19,-10,16,10,1
4,190,2,0,9,19,-10,30,3,1
1,895,1,1,0,0,0,37,10,1
1,856,2,1,0,0,0,41,6,1
1,819,1,1,0,0,0,50,10,1
1,613,1,1,3,0,3,37,10,1
1,588,1,1,3,0,3,48,10,1
1,432,1,0,0,6,-6,48,10,1
1,329,1,1,6,0,6,51,10,1
1,248,1,1,6,0,6,14,10,1
1,229,2,1,6,0,6,22,2,1
1,165,2,1,6,0,6,19,18,1
1,3,1,0,0,6,-6,44,10,1
2,826,2,0,0,6,-6,14,8,1
2,770,2,0,0,13,-13,30,18,1
2,671,2,1,13,0,13,33,3,1
2,532,1,1,13,0,13,15,10,1
2,473,1,0,0,13,-13,52,10,1
2,179,1,1,13,3,10,35,10,1
2,96,1,0,3,13,-10,49,10,1
2,70,2,0,3,13,-10,40,1,1
2,52,1,0,3,13,-10,29,10,1
2,14,2,0,3,13,-10,21,17,1
3,808,1,0,3,13,-10,53,10,1
3,668,2,0,3,13,-10,54,22,1
3,606,1,0,3,13,-10,25,10,1
3,544,2,0,3,13,-10,17,18,1
3,297,1,1,20,3,17,46,10,1
3,206,1,0,3,20,-17,40,10,1
4,769,1,1,20,3,17,26,10,1
4,732,2,1,20,3,17,32,4,1
4,676,2,1,20,3,17,50,10,1
4,510,1,1,20,3,17,25,10,1
4,466,1,1,20,3,17,36,10,1
4,332,1,0,3,20,-17,49,10,1
4,285,1,0,3,20,-17,20,10,1
4,227,2,0,3,20,-17,14,4,1
4,202,1,0,3,27,-24,15,10,1
4,64,1,0,3,28,-25,33,10,1
4,42,2,0,3,28,-25,43,0,1
4,6,3,0,3,28,-25,50,10,1
1,766,1,0,0,0,0,6,10,1
1,728,1,0,0,0,0,36,10,1
1,604,1,1,0,1,-1,35,10,1
1,512,2,0,1,0,1,44,10,1
1,468,1,1,0,1,-1,54,10,1
1,431,2,1,0,1,-1,51,7,1
1,330,2,1,0,4,-4,37,8,1
2,900,2,1,0,4,-4,45,4,1
2,853,1,1,0,4,-4,30,10,1
2,781,2,1,0,11,-11,45,7,1
2,657,1,0,11,1,10,35,10,1
2,641,1,0,11,1,10,55,10,1
2,567,1,1,1,11,-10,38,10,1
2,538,1,1,1,18,-17,51,10,1
2,470,2,0,18,1,17,40,7,1
2,393,2,0,18,1,17,20,10,1
2,369,1,0,18,8,10,22,10,1
2,346,2,0,18,8,10,30,2,1
2,264,2,0,18,8,10,42,6,1
2,196,1,1,8,18,-10,22,10,1
2,160,2,1,8,18,-10,42,5,1
2,141,1,0,18,8,10,43,10,1
2,85,1,0,18,9,9,35,10,1
2,68,1,0,18,9,9,50,10,1
3,892,1,0,21,9,12,39,10,1
3,703,2,0,21,9,12,29,10,1
3,280,2,1,9,28,-19,35,13,1
3,208,1,0,28,9,19,34,10,1
3,172,2,0,28,9,19,37,7,1
3,32,1,1,9,28,-19,52,10,1
3,2,2,1,9,28,-19,48,6,1
4,871,1,1,9,28,-19,2,10,1
4,589,1,1,9,30,-21,50,10,1
4,563,2,0,30,9,21,35,10,1
4,533,2,0,30,9,21,18,10,1
4,477,3,0,30,9,21,13,5,1
4,420,2,0,30,16,14,36,8,1
4,333,2,1,16,30,-14,42,7,1
4,261,1,1,16,33,-17,35,10,1
4,234,2,1,16,33,-17,40,5,1
4,201,1,0,33,16,17,54,10,1
4,179,1,0,33,16,17,44,10,1
4,170,2,0,33,16,17,38,4,1
4,150,3,0,33,16,17,13,10,1
4,49,1,1,23,40,-17,27,10,1
4,41,1,1,23,40,-17,44,10,1
1,894,1,1,0,0,0,15,10,1
1,740,2,0,0,0,0,45,8,1
1,705,1,1,0,0,0,52,10,1
1,688,2,1,0,0,0,53,11,1
1,517,1,1,0,0,0,15,10,1
1,486,2,1,0,0,0,13,12,1
1,456,1,1,0,0,0,47,10,1
1,335,1,0,0,0,0,22,10,1
1,276,1,1,0,0,0,48,10,1
1,71,1,0,0,0,0,51,5,1
1,41,1,0,0,0,0,20,10,1
1,3,2,0,0,0,0,14,4,1
2,717,1,1,3,1,2,35,10,1
2,698,2,1,3,1,2,37,8,1
2,571,1,1,3,1,2,19,10,1
2,451,1,0,1,3,-2,41,10,1
2,399,1,1,3,1,2,53,10,1
2,298,1,0,1,3,-2,18,10,1
2,160,2,1,3,1,2,4,4,1
2,130,1,1,3,15,-12,40,10,1
2,66,2,0,15,3,12,28,10,1
3,894,1,0,15,3,12,50,10,1
3,760,1,0,15,3,12,19,10,1
3,670,1,0,15,6,9,35,10,1
3,655,2,0,15,6,9,40,5,1
3,592,2,0,15,6,9,50,11,1
3,396,1,1,6,15,-9,49,10,1
3,155,1,1,7,15,-8,40,15,1
3,142,1,0,15,7,8,54,10,1
3,91,2,0,15,7,8,41,10,1
3,33,1,0,15,10,5,35,10,1
3,17,2,0,15,10,5,37,8,1
4,859,1,0,15,10,5,40,10,1
4,834,1,0,15,10,5,26,10,1
4,759,1,0,15,10,5,19,15,1
4,685,1,0,15,17,-2,35,10,1
4,383,1,0,15,17,-2,41,10,1
4,371,2,0,15,17,-2,47,4,1
4,296,1,1,17,16,1,35,10,1
4,272,1,1,17,16,1,53,10,1
4,160,1,0,16,17,-1,44,10,1
4,94,1,0,16,25,-9,20,10,1
4,71,2,0,16,25,-9,30,10,1
4,58,2,0,16,25,-9,41,10,1
4,53,3,0,16,25,-9,49,2,1
4,29,2,1,25,16,9,53,10,1
4,6,1,1,25,16,9,29,10,1
1,872,1,0,0,0,0,34,15,1
1,865,1,0,0,0,0,54,10,1
1,629,1,1,0,0,0,19,10,1
1,503,2,0,0,0,0,53,10,1
1,435,2,1,0,0,0,22,7,1
1,195,1,1,0,0,0,32,10,1
1,105,2,1,0,0,0,48,6,1
1,26,2,0,0,0,0,52,9,1
2,900,2,0,0,0,0,25,10,1
2,689,2,1,7,0,7,46,1,1
2,627,2,1,7,0,7,55,15,1
2,566,2,0,0,8,-8,35,10,1
2,482,1,1,8,1,7,35,10,1
2,385,1,1,8,1,7,46,10,1
2,278,2,0,1,8,-7,17,6,1
2,161,2,1,15,1,14,33,8,1
2,100,1,1,15,1,14,13,10,1
3,750,2,1,15,8,7,45,6,1
3,610,2,1,15,15,0,50,5,1
3,441,2,0,15,15,0,33,10,1
3,379,2,1,15,15,0,45,10,1
3,265,1,0,15,15,0,43,10,1
3,230,1,0,15,15,0,30,10,1
3,103,2,0,15,15,0,17,8,1
4,845,2,0,15,18,-3,41,6,1
4,794,1,0,15,18,-3,21,10,1
4,699,1,0,15,18,-3,10,10,1
4,675,1,0,15,25,-10,32,10,1
4,520,1,0,15,25,-10,29,10,1
4,473,1,0,15,28,-13,35,10,1
4,302,1,0,15,28,-13,30,10,1
4,215,2,0,15,28,-13,39,6,1
4,151,2,0,15,31,-16,35,15,1
4,85,1,0,15,31,-16,22,10,1
4,62,2,0,15,31,-16,35,10,1
1,858,2,0,0,0,0,30,5,1
1,785,2,0,0,0,0,42,7,1
1,547,1,1,0,0,0,39,10,1
1,458,2,1,0,7,-7,27,7,1
1,392,2,1,0,7,-7,37,7,1
1,75,2,1,3,7,-4,29,9,1
1,1,2,0,7,3,4,50,10,1
2,738,1,0,8,3,5,30,10,1
2,723,1,1,3,8,-5,50,10,1
2,700,2,1,3,8,-5,45,5,1
2,656,1,1,3,8,-5,39,10,1
2,584,2,1,3,8,-5,29,10,1
2,515,1,1,3,8,-5,18,10,1
2,366,2,1,3,8,-5,12,12,1
2,161,1,0,15,10,5,30,10,1
2,136,2,0,15,10,5,45,10,1
2,104,1,1,10,15,-5,18,10,1
2,97,2,1,10,15,-5,18,10,1
2,36,2,1,10,15,-5,21,10,1
2,20,1,1,10,15,-5,8,8,1
3,853,2,1,10,22,-12,36,10,1
3,789,1,0,22,10,12,38,10,1
3,704,1,0,22,10,12,18,10,1
3,687,1,0,22,17,5,44,10,1
3,661,1,0,22,17,5,55,10,1
3,469,1,1,17,22,-5,14,10,1
3,354,2,0,29,17,12,1,10,1
3,287,2,0,29,17,12,25,10,1
3,223,1,0,29,17,12,50,10,1
3,165,1,0,29,17,12,50,20,1
4,843,2,1,17,29,-12,50,9,1
4,790,2,0,29,24,5,37,7,1
4,684,1,1,24,29,-5,13,10,1
4,591,2,1,24,29,-5,36,17,1
4,350,2,1,24,29,-5,19,10,1
4,312,1,1,24,29,-5,35,10,1
4,113,1,1,24,32,-8,35,10,1
4,105,1,1,24,32,-8,45,10,1
4,83,2,0,32,24,8,47,10,1
5,0,2,0,32,32,0,35,10,1
5,0,2,0,32,35,-3,43,18,1
1,832,1,0,0,0,0,22,10,1
1,698,1,1,0,0,0,25,10,1
1,610,2,1,0,0,0,42,6,1
1,505,2,0,0,0,0,11,6,1
1,441,2,0,0,0,0,25,12,1
1,364,1,0,0,0,0,26,10,1
1,53,1,0,0,0,0,16,10,1
2,789,1,0,0,0,0,41,10,1
2,647,1,1,0,7,-7,34,10,1
2,600,2,1,0,7,-7,49,5,1
2,437,1,1,0,7,-7,44,10,1
2,296,1,1,0,10,-10,29,10,1
2,231,2,1,0,10,-10,42,8,1
2,180,1,1,0,10,-10,51,10,1
2,154,1,0,10,0,10,44,10,1
2,123,1,0,10,0,10,33,10,1
2,75,2,0,10,0,10,44,21,1
3,865,2,0,10,7,3,45,10,1
3,650,2,0,11,7,4,27,8,1
3,600,1,0,11,7,4,41,20,1
3,369,1,1,7,12,-5,50,10,1
3,349,2,1,7,12,-5,55,5,1
3,148,2,0,12,7,5,36,4,1
3,118,1,0,12,7,5,52,10,1
3,90,1,1,7,12,-5,45,10,1
4,817,2,1,7,12,-5,9,10,1
4,811,1,1,7,12,-5,27,10,1
4,773,1,1,7,12,-5,37,10,1
4,617,1,0,12,7,5,50,10,1
4,367,1,1,7,15,-8,35,10,1
4,277,2,0,15,7,8,35,8,1
4,169,2,0,15,7,8,50,5,1
4,83,1,1,7,15,-8,20,10,1
4,76,2,1,7,15,-8,23,7,1
4,44,2,1,7,15,-8,43,10,1
4,24,1,0,15,7,8,43,10,1
4,13,1,0,15,7,8,21,10,1
1,873,2,1,0,0,0,35,10,1
1,785,2,0,0,0,0,28,10,1
1,667,2,0,0,7,-7,39,10,1
1,593,1,1,7,0,7,13,20,1
1,495,2,1,7,0,7,34,10,1
1,447,1,1,7,0,7,48,15,1
1,347,2,0,0,7,-7,39,2,1
1,312,1,0,0,7,-7,35,10,1
2,633,1,0,0,13,-13,39,10,1
2,497,2,1,13,0,13,26,10,1
2,364,2,0,0,13,-13,53,7,1
2,226,2,0,0,13,-13,47,11,1
2,153,2,0,0,14,-14,33,10,1
2,65,2,0,0,14,-14,49,15,1
3,730,1,1,14,0,14,54,10,1
3,521,2,1,17,0,17,10,10,1
3,185,2,1,17,0,17,30,17,1
3,145,1,0,0,17,-17,42,10,1
4,877,1,0,0,17,-17,52,10,1
4,705,1,1,17,0,17,28,10,1
4,561,1,0,0,17,-17,39,10,1
4,479,1,0,0,17,-17,51,10,1
4,384,1,1,17,0,17,11,10,1
4,314,1,0,0,17,-17,50,10,1
4,82,1,0,0,17,-17,41,10,1
4,52,1,0,0,17,-17,10,10,1
1,896,1,0,0,0,0,33,10,1
1,844,2,0,0,0,0,40,3,1
1,540,1,1,0,3,-3,17,10,1
1,511,2,1,0,3,-3,22,5,1
1,472,1,1,0,3,-3,40,10,1
1,276,2,1,0,3,-3,40,7,1
1,160,1,0,3,0,3,43,10,1
1,62,2,1,0,3,-3,27,17,1
1,35,1,0,3,0,3,52,10,1
1,1,2,0,3,0,3,48,6,1
2,810,2,1,2,3,-1,41,10,1
2,751,1,1,2,3,-1,49,20,1
2,559,1,1,2,10,-8,32,10,1
2,230,1,0,10,5,5,50,10,1
2,193,2,0,10,5,5,47,13,1
2,154,1,1,5,10,-5,28,10,1
2,114,1,0,10,5,5,38,10,1
2,71,2,0,10,5,5,50,10,1
3,889,1,1,5,10,-5,45,10,1
3,817,0,0,10,5,5,42,0,1
3,668,1,0,13,5,8,54,10,1
3,571,1,1,5,13,-8,35,10,1
3,459,2,1,5,13,-8,36,24,1
3,280,1,1,5,13,-8,47,10,1
3,177,1,1,5,13,-8,14,10,1
3,109,1,1,5,13,-8,27,10,1
3,70,1,1,5,13,-8,40,10,1
4,900,1,0,13,5,8,32,10,1
4,874,2,0,13,5,8,34,8,1
4,836,1,0,13,5,8,43,10,1
4,798,2,0,13,5,8,50,3,1
4,722,2,1,5,13,-8,47,5,1
4,500,1,1,5,16,-11,44,10,1
4,461,2,1,5,16,-11,50,4,1
4,399,1,0,16,5,11,25,10,1
4,352,1,0,16,5,11,6,6,1
4,325,1,0,16,11,5,9,10,1
4,247,1,0,16,11,5,25,10,1
4,202,2,0,16,11,5,26,9,1
4,124,1,1,11,16,-5,23,10,1
4,108,1,1,11,16,-5,42,10,1
4,99,1,1,11,16,-5,55,10,1
4,91,1,0,16,11,5,41,10,1
4,71,1,0,16,11,5,30,10,1
4,54,1,0,16,11,5,15,10,1
4,34,3,0,16,11,5,11,6,1
1,894,1,0,0,0,0,33,10,1
1,859,2,0,0,0,0,39,4,1
1,807,2,0,0,0,0,51,4,1
1,700,1,1,0,0,0,30,10,1
1,681,2,1,0,0,0,25,5,1
1,352,2,0,7,0,7,37,5,1
1,240,2,1,0,7,-7,53,11,1
1,173,2,0,7,0,7,32,10,1
2,732,1,1,0,7,-7,44,10,1
2,569,2,0,7,0,7,49,7,1
2,358,2,0,7,3,4,35,10,1
2,144,2,0,7,3,4,23,4,1
3,894,1,1,3,7,-4,32,10,1
3,598,1,1,5,7,-2,41,10,1
3,576,1,0,7,5,2,53,10,1
3,517,2,0,7,5,2,28,11,1
3,451,2,0,7,8,-1,35,10,1
3,348,2,1,8,7,1,53,10,1
3,298,2,0,7,8,-1,46,10,1
4,900,2,1,11,7,4,48,13,1
4,669,1,0,7,14,-7,37,10,1
4,626,2,0,7,14,-7,37,10,1
4,306,2,0,7,14,-7,48,7,1
4,154,2,1,14,7,7,20,7,1
4,95,2,0,7,14,-7,50,10,1
1,756,1,1,7,0,7,41,10,1
1,704,2,1,7,0,7,52,10,1
1,630,2,0,0,7,-7,46,10,1
1,425,2,0,7,7,0,12,16,1
1,220,2,1,7,7,0,46,10,1
1,139,2,1,7,7,0,20,5,1
1,57,2,1,7,7,0,3,3,1
2,900,1,1,7,10,-3,46,10,1
2,788,2,0,10,7,3,6,7,1
2,747,1,0,10,7,3,25,10,1
2,664,1,1,7,10,-3,40,10,1
2,629,1,1,7,10,-3,51,10,1
2,457,1,1,14,10,4,29,10,1
2,319,2,1,14,17,-3,34,7,1
2,103,1,0,17,14,3,5,10,1
2,98,1,0,17,21,-4,42,10,1
2,91,1,0,17,21,-4,53,10,1
2,43,1,1,21,17,4,38,10,1
2,35,1,0,17,21,-4,52,10,1
2,28,1,0,17,21,-4,40,10,1
2,15,1,0,17,21,-4,5,5,1
3,802,1,1,28,17,11,54,10,1
3,795,2,0,17,28,-11,53,7,1
3,736,1,0,17,28,-11,26,10,1
3,630,1,0,17,31,-14,54,10,1
3,527,1,1,31,17,14,34,10,1
3,497,2,1,31,17,14,29,5,1
3,461,1,1,31,17,14,20,10,1
3,351,2,1,31,20,11,38,7,1
3,330,1,1,31,20,11,50,10,1
3,249,1,0,20,31,-11,39,20,1
3,200,2,0,20,31,-11,25,6,1
3,110,2,0,20,39,-19,37,8,1
3,61,1,1,39,20,19,50,10,1
3,35,1,0,20,39,-19,49,10,1
3,1,2,0,20,39,-19,43,4,1
4,900,1,0,20,39,-19,32,10,1
4,759,2,0,20,42,-22,30,15,1
4,691,1,0,20,42,-22,45,10,1
4,418,1,0,20,42,-22,39,10,1
4,312,1,1,42,20,22,42,10,1
4,160,2,0,20,42,-22,33,10,1
1,850,2,0,0,0,0,39,6,1
1,557,2,1,0,0,0,37,5,1
1,417,1,1,0,0,0,25,10,1
1,295,2,1,0,2,-2,52,8,1
1,156,2,1,0,2,-2,24,8,1
1,87,2,1,0,2,-2,33,10,1
2,616,1,0,2,0,2,44,10,1
2,369,2,1,0,2,-2,11,10,1
2,348,1,1,0,9,-9,30,10,1
2,249,2,1,0,9,-9,50,5,1
2,92,1,0,9,0,9,54,10,1
2,54,1,1,0,9,-9,40,10,1
2,27,2,1,0,9,-9,26,10,1
3,863,2,1,0,9,-9,35,11,1
3,464,2,1,0,10,-10,7,7,1
3,405,2,1,0,17,-17,17,8,1
3,315,2,1,0,17,-17,42,3,1
3,210,1,1,0,24,-24,38,10,1
3,153,2,1,0,24,-24,44,4,1
3,35,1,1,8,24,-16,40,10,1
4,750,2,1,16,24,-8,20,10,1
4,674,1,1,16,24,-8,51,10,1
4,480,2,0,24,24,0,49,10,1
4,383,2,1,24,24,0,16,11,1
4,353,1,1,24,24,0,33,10,1
4,218,1,0,24,24,0,25,10,1
4,189,1,0,24,24,0,43,10,1
4,163,1,0,24,24,0,54,10,1
4,151,1,1,24,24,0,37,10,1
4,26,1,1,24,31,-7,40,10,1
4,18,1,0,31,24,7,44,10,1
1,860,2,1,0,0,0,42,10,1
1,660,1,0,0,0,0,43,10,1
1,621,1,0,0,0,0,28,10,1
1,474,1,0,0,7,-7,10,10,1
1,408,2,0,0,7,-7,6,6,1
1,267,1,0,7,14,-7,44,10,1
1,230,2,0,7,14,-7,50,16,1
1,79,1,0,7,17,-10,24,10,1
1,45,2,0,7,17,-10,27,7,1
1,1,1,0,7,17,-10,40,10,1
2,900,2,0,7,17,-10,48,2,1
2,795,2,1,17,7,10,36,5,1
2,600,1,0,7,20,-13,45,10,1
2,568,2,0,7,20,-13,51,4,1
2,472,2,1,20,7,13,52,10,1
2,406,2,1,20,7,13,34,5,1
2,321,1,1,20,14,6,36,10,1
2,224,2,1,20,14,6,15,4,1
2,181,2,1,20,21,-1,45,10,1
2,168,1,0,21,20,1,51,10,1
2,152,2,0,21,20,1,45,4,1
2,127,1,0,21,20,1,39,10,1
2,57,2,0,21,20,1,29,6,1
2,42,2,0,21,20,1,36,15,1
3,872,2,0,21,20,1,30,10,1
3,794,2,0,21,20,1,44,6,1
3,755,1,1,20,21,-1,48,10,1
3,746,2,1,20,21,-1,41,3,1
3,696,2,1,20,21,-1,35,10,1
3,639,1,1,20,21,-1,37,10,1
3,532,2,0,21,20,1,36,4,1
3,375,2,0,21,23,-2,34,11,1
3,304,2,1,23,21,2,37,7,1
3,188,1,0,21,23,-2,53,10,1
4,669,1,0,21,29,-8,35,10,1
4,580,2,1,29,21,8,45,12,1
4,496,2,1,29,24,5,35,10,1
4,453,1,1,29,24,5,46,10,1
4,422,2,1,29,24,5,54,2,1
4,250,2,0,24,30,-6,35,10,1
4,192,1,1,30,24,6,49,10,1
4,49,1,0,24,33,-9,42,10,1
4,25,1,1,33,24,9,15,10,1
1,850,2,0,0,0,0,30,10,1
1,749,2,0,0,0,0,52,3,1
1,714,2,0,0,0,0,55,10,1
1,659,1,1,0,0,0,20,10,1
1,560,1,0,0,0,0,47,10,1
1,478,1,1,0,0,0,52,10,1
1,345,1,1,0,0,0,37,10,1
1,328,2,1,0,0,0,43,4,1
1,156,1,0,0,0,0,48,10,1
1,90,2,1,0,0,0,28,10,1
2,887,2,0,10,0,10,50,10,1
2,733,2,0,10,3,7,38,7,1
2,596,2,0,10,3,7,50,5,1
2,495,2,0,10,3,7,49,9,1
2,455,1,0,10,3,7,34,10,1
2,235,2,1,6,10,-4,26,10,1
2,196,1,1,6,10,-4,55,10,1
2,175,2,0,10,6,4,50,5,1
2,156,1,0,10,6,4,35,10,1
2,130,2,0,10,6,4,27,2,1
2,53,1,1,9,10,-1,41,10,1
3,899,1,0,10,9,1,45,10,1
3,780,2,1,9,10,-1,47,3,1
3,730,1,1,9,10,-1,7,10,1
3,697,1,1,9,10,-1,26,10,1
3,658,1,1,9,10,-1,39,10,1
3,619,1,0,10,9,1,51,10,1
3,255,2,0,10,12,-2,52,8,1
3,193,1,1,12,10,2,17,10,1
3,176,1,1,12,17,-5,15,10,1
3,132,1,1,12,17,-5,32,10,1
3,86,1,0,17,12,5,52,10,1
3,33,2,1,12,17,-5,55,13,1
4,873,2,0,17,12,5,25,11,1
4,718,1,0,17,12,5,30,10,1
4,625,2,0,17,12,5,42,10,1
4,577,1,0,17,12,5,48,10,1
4,544,2,0,17,12,5,23,10,1
4,390,2,1,14,17,-3,44,15,1
4,285,2,0,17,14,3,5,12,1
4,243,1,0,17,16,1,51,10,1
4,198,1,0,17,16,1,38,10,1
4,180,1,0,17,16,1,15,10,1
4,103,1,0,17,19,-2,35,10,1
4,97,1,0,17,19,-2,51,10,1
4,10,3,0,17,19,-2,28,10,1
1,896,1,1,0,0,0,13,10,1
1,829,2,1,0,0,0,20,13,1
1,775,1,0,0,0,0,37,10,1
1,720,1,0,0,0,0,40,20,1
1,690,2,1,0,0,0,52,2,1
1,646,1,1,0,0,0,45,10,1
1,551,2,1,0,0,0,3,3,1
1,489,2,1,0,7,-7,23,3,1
1,435,2,1,0,7,-7,37,18,1
1,365,2,0,7,0,7,45,6,1
1,299,1,1,0,7,-7,36,10,1
1,209,1,1,0,7,-7,47,10,1
1,94,1,1,0,7,-7,42,10,1
2,900,2,1,0,10,-10,36,9,1
2,862,1,0,10,0,10,37,10,1
2,752,2,0,10,0,10,39,21,1
2,633,1,1,0,10,-10,15,10,1
2,562,1,1,0,13,-13,35,10,1
2,499,1,1,0,13,-13,50,10,1
2,302,1,0,13,0,13,10,10,1
2,235,2,0,13,0,13,2,2,1
2,213,1,0,13,7,6,43,10,1
2,180,1,1,7,13,-6,45,10,1
2,145,1,1,7,13,-6,33,20,1
2,102,1,1,7,20,-13,26,10,1
2,95,2,1,7,20,-13,31,5,1
2,68,1,0,20,7,13,36,10,1
2,56,2,0,20,7,13,29,3,1
2,39,1,0,20,7,13,20,10,1
3,895,1,0,20,10,10,31,10,1
3,791,1,1,10,20,-10,16,15,1
3,715,1,1,10,20,-10,34,20,1
3,583,2,1,10,23,-13,25,20,1
3,503,2,1,10,23,-13,50,5,1
3,469,1,0,23,10,13,50,10,1
3,297,1,1,13,23,-10,37,10,1
3,206,2,1,13,23,-10,22,10,1
3,137,2,1,13,30,-17,17,21,1
4,900,2,0,30,13,17,18,10,1
4,846,1,0,30,13,17,6,6,1
4,782,1,0,30,20,10,25,15,1
4,718,2,0,30,20,10,40,10,1
4,652,1,1,20,30,-10,41,10,1
4,490,2,0,30,20,10,43,9,1
4,361,2,1,20,30,-10,33,10,1
4,299,1,1,20,33,-13,35,10,1
4,227,3,1,20,33,-13,45,10,1
4,191,2,0,33,20,13,50,10,1
4,165,1,0,33,20,13,24,10,1
4,153,2,0,33,20,13,17,3,1
4,97,1,1,27,33,-6,30,10,1
4,74,1,1,27,33,-6,41,10,1
1,852,2,0,0,0,0,24,6,1
1,731,1,1,0,0,0,26,10,1
1,702,1,0,0,0,0,44,10,1
1,664,2,0,0,0,0,34,0,1
1,599,2,0,0,0,0,33,10,1
1,518,1,0,0,3,-3,35,10,1
1,421,1,0,0,3,-3,42,15,1
1,397,2,0,0,3,-3,48,9,1
1,285,1,1,3,0,3,16,10,1
1,155,1,0,0,3,-3,50,10,1
2,900,1,1,3,0,3,20,10,1
2,600,2,1,3,0,3,41,7,1
2,488,2,0,0,3,-3,23,7,1
2,344,1,0,0,10,-10,50,10,1
2,202,1,1,10,3,7,25,20,1
2,150,2,1,10,3,7,50,10,1
2,106,1,1,17,3,14,33,10,1
2,81,2,1,17,3,14,52,5,1
3,893,1,1,17,3,14,25,10,1
3,864,1,1,17,3,14,35,10,1
3,836,1,1,17,3,14,47,10,1
3,803,2,1,17,3,14,53,4,1
3,766,1,0,3,17,-14,52,10,1
3,722,1,0,3,17,-14,19,10,1
3,588,1,0,3,17,-14,9,9,1
3,550,2,0,3,24,-21,44,10,1
3,496,1,1,24,3,21,39,10,1
3,435,1,1,24,3,21,49,10,1
3,302,1,0,3,27,-24,28,10,1
3,257,2,0,3,27,-24,33,5,1
3,172,1,0,3,27,-24,39,10,1
3,130,2,0,3,27,-24,44,5,1
3,81,2,1,27,3,24,52,10,1
3,1,2,1,27,3,24,21,3,1
4,742,2,0,3,27,-24,3,3,1
4,560,1,1,34,3,31,45,10,1
4,391,1,0,3,34,-31,31,10,1
4,320,1,0,3,34,-31,41,10,1
1,673,1,1,0,0,0,9,10,1
1,297,2,1,0,0,0,17,5,1
1,221,2,1,0,0,0,11,10,1
2,900,2,0,7,0,7,35,10,1
2,806,2,1,0,7,-7,11,7,1
2,661,1,0,7,0,7,25,10,1
2,263,2,1,7,7,0,49,10,1
2,104,2,0,7,14,-7,15,8,1
3,726,2,0,7,14,-7,25,19,1
3,705,1,0,7,21,-14,51,10,1
3,510,2,1,21,7,14,25,10,1
3,414,1,0,7,21,-14,51,10,1
3,389,1,0,7,21,-14,25,10,1
3,262,2,0,7,24,-17,30,10,1
3,210,2,0,7,31,-24,20,18,1
3,166,1,0,7,31,-24,51,10,1
3,36,1,0,7,34,-27,35,10,1
4,720,2,1,34,7,27,6,9,1
4,635,1,0,9,34,-25,53,10,1
4,68,2,0,9,40,-31,38,7,1
4,30,2,0,9,40,-31,54,4,1
1,787,1,1,0,0,0,28,10,1
1,711,1,0,0,0,0,26,10,1
1,630,1,1,0,0,0,53,10,1
1,471,2,0,0,0,0,31,9,1
1,280,2,0,0,7,-7,26,7,1
1,200,2,0,0,7,-7,23,15,1
1,146,1,0,0,10,-10,35,10,1
1,79,1,1,10,0,10,31,10,1
1,40,1,1,10,0,10,42,10,1
2,755,2,0,0,11,-11,25,20,1
2,680,2,1,11,0,11,35,8,1
2,645,1,1,11,0,11,46,10,1
2,417,1,1,14,0,14,22,10,1
2,142,1,1,30,0,30,32,10,1
2,136,2,1,30,0,30,34,8,1
2,112,1,1,30,0,30,46,10,1
2,80,1,0,0,30,-30,10,10,1
2,71,1,0,0,30,-30,25,10,1
2,40,1,1,30,0,30,42,10,1
2,30,1,1,30,0,30,55,10,1
3,894,1,1,37,0,37,34,10,1
3,800,2,1,37,0,37,51,5,1
3,625,2,0,0,40,-40,35,10,1
3,593,1,1,40,0,40,52,10,1
3,545,3,1,40,0,40,45,3,1
3,385,1,0,3,40,-37,42,15,1
3,185,2,0,3,40,-37,37,7,1
3,147,1,1,40,3,37,28,10,1
3,52,2,1,40,6,34,41,4,1
4,766,2,0,6,41,-35,55,10,1
4,724,1,1,41,6,35,30,10,1
4,707,2,1,41,6,35,25,5,1
4,589,1,1,41,9,32,25,20,1
4,435,2,1,41,9,32,45,6,1
4,306,1,1,41,9,32,25,10,1
4,147,2,0,9,41,-32,2,13,1
4,120,1,0,9,41,-32,31,10,1
4,103,1,0,9,41,-32,48,10,1
4,97,2,0,9,41,-32,54,4,1
4,72,3,1,41,9,32,49,10,1
4,13,1,0,9,41,-32,34,10,1
1,797,2,1,0,0,0,51,10,1
1,713,2,0,0,0,0,48,10,1
1,681,1,0,0,0,0,35,10,1
1,464,1,1,3,0,3,46,10,1
1,409,3,1,3,0,3,43,13,1
1,277,2,0,0,4,-4,35,10,1
1,80,2,1,4,0,4,19,5,1
2,886,2,1,4,0,4,51,5,1
2,768,1,0,0,4,-4,20,10,1
2,671,2,1,4,0,4,47,10,1
2,502,1,0,1,4,-3,24,10,1
2,389,1,1,4,1,3,39,10,1
2,294,2,1,4,1,3,48,10,1
2,106,1,1,4,1,3,29,10,1
2,81,1,1,4,1,3,40,10,1
2,67,1,1,4,1,3,50,10,1
2,34,2,0,1,4,-3,40,5,1
2,23,1,0,1,4,-3,31,10,1
3,896,1,0,1,7,-6,31,10,1
3,812,2,0,1,7,-6,51,10,1
3,760,1,1,7,1,6,48,10,1
3,561,2,0,3,7,-4,46,5,1
3,509,1,0,3,7,-4,41,20,1
3,442,2,1,7,3,4,44,6,1
3,348,2,1,7,3,4,43,15,1
3,17,2,1,7,6,1,38,7,1
4,840,2,0,6,7,-1,7,7,1
4,719,1,1,15,6,9,50,10,1
4,550,2,1,15,6,9,51,10,1
4,490,1,0,6,16,-10,35,10,1
4,402,1,1,16,6,10,48,10,1
4,250,1,0,6,16,-10,25,10,1
1,894,1,1,0,0,0,28,10,1
1,722,1,1,0,0,0,35,10,1
1,661,1,1,0,0,0,45,10,1
1,629,1,0,0,0,0,54,10,1
1,411,1,1,3,0,3,35,10,1
1,322,1,1,3,3,0,34,10,1
1,296,2,1,3,3,0,39,5,1
1,244,1,0,3,3,0,20,10,1
1,224,1,0,3,3,0,32,10,1
1,176,1,0,3,3,0,50,10,1
1,90,2,1,3,3,0,44,5,1
1,60,1,1,3,3,0,26,10,1
1,0,1,1,3,3,0,10,10,1
2,864,2,1,3,10,-7,35,10,1
2,838,1,1,3,10,-7,47,10,1
2,776,1,0,10,3,7,50,10,1
2,532,1,1,6,10,-4,27,10,1
2,474,2,1,6,10,-4,42,6,1
2,356,1,0,10,6,4,15,10,1
2,332,2,0,10,6,4,16,9,1
2,187,1,0,10,6,4,39,10,1
2,102,1,0,10,6,4,27,10,1
2,38,1,1,6,10,-4,44,10,1
3,547,1,1,6,13,-7,35,10,1
3,437,2,1,6,13,-7,50,7,1
3,343,2,1,6,13,-7,54,22,1
3,244,1,1,6,13,-7,8,18,1
3,205,2,1,6,13,-7,10,16,1
3,104,2,1,6,13,-7,42,5,1
3,78,1,1,6,13,-7,34,10,1
4,589,1,0,20,6,14,45,20,1
4,545,2,0,20,6,14,39,14,1
4,454,2,0,20,9,11,32,8,1
4,387,1,0,20,9,11,47,20,1
4,278,2,1,9,20,-11,52,10,1
4,200,2,0,20,9,11,44,10,1
4,147,1,1,12,20,-8,35,10,1
4,141,1,1,12,20,-8,55,10,1
4,122,2,0,20,12,8,49,4,1
4,98,2,0,20,12,8,44,10,1
1,816,1,0,0,0,0,53,10,1
1,748,2,1,0,0,0,39,7,1
1,546,2,1,0,0,0,25,15,1
1,448,2,0,7,0,7,45,6,1
1,386,1,1,0,7,-7,51,10,1
1,334,2,1,0,14,-14,40,4,1
1,301,1,1,0,14,-14,48,10,1
1,259,1,0,14,0,14,52,10,1
1,203,2,0,14,0,14,42,11,1
1,154,2,0,14,0,14,28,10,1
1,52,1,1,3,14,-11,53,15,1
1,30,2,1,3,14,-11,50,12,1
2,900,1,1,3,15,-12,35,10,1
2,870,1,1,3,15,-12,49,10,1
2,702,2,0,15,6,9,25,20,1
2,579,2,1,6,15,-9,46,6,1
2,497,2,1,6,16,-10,38,7,1
2,459,1,1,6,16,-10,48,10,1
2,348,1,0,16,6,10,17,10,1
2,279,1,0,16,6,10,19,20,1
2,181,1,0,16,6,10,35,10,1
2,145,1,0,16,6,10,51,10,1
2,86,1,1,6,16,-10,29,10,1
2,80,1,1,6,16,-10,42,10,1
2,45,2,0,16,6,10,26,10,1
2,21,1,1,6,16,-10,38,10,1
2,1,1,1,6,16,-10,50,10,1
3,698,1,1,7,16,-9,53,10,1
3,573,1,1,7,23,-16,33,10,1
3,82,2,1,9,23,-14,47,13,1
4,864,1,0,23,16,7,39,20,1
4,642,1,1,16,26,-10,35,10,1
4,580,2,1,16,26,-10,52,8,1
4,234,2,1,23,26,-3,54,4,1
4,173,2,1,23,26,-3,37,10,1
4,80,1,1,23,33,-10,32,10,1
1,860,2,1,0,0,0,27,10,1
1,722,2,1,0,0,0,10,6,1
1,680,1,1,0,0,0,22,10,1
1,555,1,0,0,0,0,39,10,1
1,485,1,0,0,3,-3,35,10,1
1,391,1,0,0,3,-3,35,20,1
1,80,2,1,3,0,3,38,20,1
1,1,1,0,0,3,-3,20,10,1
2,900,1,0,0,3,-3,30,10,1
2,875,1,0,0,3,-3,50,10,1
2,840,2,0,0,3,-3,53,7,1
2,798,1,1,3,0,3,50,10,1
2,762,2,1,3,0,3,35,10,1
2,573,1,1,3,3,0,47,10,1
2,389,2,1,3,4,-1,36,9,1
2,272,1,0,4,3,1,39,10,1
2,137,2,1,3,4,-1,54,10,1
2,131,1,0,4,3,1,35,10,1
2,108,2,0,4,3,1,30,5,1
2,58,2,0,4,3,1,17,10,1
3,703,1,0,11,13,-2,7,17,1
3,595,2,1,13,11,2,55,8,1
3,444,2,0,11,13,-2,53,10,1
3,270,2,1,13,14,-1,36,9,1
3,213,1,0,14,13,1,30,10,1
3,185,2,0,14,13,1,35,5,1
3,7,1,1,13,14,-1,33,10,1
4,900,2,1,13,14,-1,17,5,1
4,734,1,0,17,13,4,26,10,1
4,668,2,0,17,13,4,45,9,1
4,627,1,1,13,17,-4,48,10,1
4,548,2,1,13,17,-4,21,5,1
4,270,2,0,24,13,11,16,5,1
4,116,2,1,13,24,-11,34,9,1
4,101,1,1,13,24,-11,50,10,1
4,84,2,0,24,13,11,50,0,1
4,42,3,0,24,13,11,28,10,1
1,876,1,1,0,0,0,36,10,1
1,758,2,0,0,0,0,28,3,1
1,639,2,0,0,0,0,5,5,1
1,562,2,0,0,7,-7,13,10,1
1,491,2,0,0,7,-7,38,5,1
1,154,2,1,7,7,0,52,8,1
2,662,2,1,7,7,0,50,5,1
2,503,2,1,7,7,0,52,9,1
2,435,2,0,7,7,0,47,14,1
2,313,1,1,7,7,0,34,10,1
2,141,2,0,10,7,3,48,10,1
2,107,2,1,7,10,-3,25,9,1
2,65,2,1,7,10,-3,14,10,1
3,860,2,0,13,7,6,34,7,1
3,830,1,0,13,7,6,43,10,1
3,705,2,1,7,13,-6,11,10,1
3,618,2,1,7,20,-13,51,6,1
3,493,2,1,7,23,-16,36,9,1
3,419,2,1,7,23,-16,48,8,1
3,265,2,0,23,7,16,53,15,1
3,244,3,0,23,7,16,48,10,1
3,114,1,0,23,10,13,31,10,1
4,849,2,0,23,10,13,53,10,1
4,788,1,1,10,23,-13,8,10,1
4,744,1,1,10,23,-13,52,10,1
4,604,2,1,17,23,-6,48,10,1
4,475,2,0,23,17,6,18,8,1
4,405,1,0,23,17,6,27,10,1
4,370,2,0,23,17,6,33,4,1
4,320,1,0,23,17,6,50,10,1
4,151,1,1,17,23,-6,10,10,1
4,65,3,1,17,23,-6,23,10,1
1,894,1,1,0,0,0,37,10,1
1,820,2,1,0,0,0,54,7,1
1,769,1,0,0,0,0,47,10,1
1,562,1,1,1,0,1,44,10,1
1,447,2,1,1,0,1,50,16,1
1,345,1,0,0,1,-1,46,20,1
1,319,1,1,1,0,1,42,10,1
1,257,2,1,1,0,1,28,10,1
1,190,1,1,1,3,-2,38,10,1
1,71,2,0,3,1,2,54,3,1
2,799,1,1,8,3,5,40,10,1
2,622,1,0,3,8,-5,34,10,1
2,560,2,0,3,8,-5,50,13,1
2,486,1,1,8,3,5,24,10,1
2,387,1,0,10,8,2,35,10,1
2,272,2,1,8,10,-2,49,5,1
2,166,2,1,8,13,-5,35,10,1
2,123,1,0,13,8,5,41,10,1
2,47,1,1,8,20,-12,47,10,1
2,42,1,0,20,8,12,51,10,1
2,32,2,0,20,8,12,44,3,1
3,851,2,0,20,15,5,26,20,1
3,790,1,1,15,20,-5,31,10,1
3,758,2,1,15,20,-5,27,14,1
3,610,1,1,15,20,-5,51,10,1
3,501,1,1,15,20,-5,40,10,1
3,361,2,0,27,15,12,29,7,1
3,225,2,1,15,27,-12,25,10,1
3,38,1,1,15,27,-12,50,10,1
4,866,2,0,27,15,12,46,8,1
4,790,1,0,27,15,12,24,10,1
4,724,1,0,27,15,12,11,10,1
4,513,2,0,27,23,4,43,10,1
4,471,2,0,27,23,4,21,10,1
4,375,1,0,27,30,-3,26,10,1
4,293,1,0,27,37,-10,33,10,1
4,137,2,0,27,40,-13,35,10,1
4,130,1,0,27,40,-13,49,10,1
4,101,3,0,27,40,-13,49,10,1
4,92,1,1,40,27,13,46,10,1
4,79,1,1,40,27,13,34,10,1
4,62,2,1,40,27,13,27,3,1
1,792,2,1,2,0,2,54,4,1
1,755,1,0,0,2,-2,46,10,1
1,735,2,0,0,2,-2,45,9,1
1,504,1,1,5,0,5,28,10,1
1,384,1,0,0,5,-5,38,10,1
1,357,1,0,0,5,-5,20,10,1
1,214,2,1,8,0,8,43,7,1
1,64,1,0,0,8,-8,32,20,1
1,0,2,0,0,8,-8,22,10,1
2,790,1,1,15,0,15,53,10,1
2,635,1,0,0,15,-15,35,15,1
2,536,2,1,15,0,15,16,12,1
2,485,1,0,0,15,-15,32,10,1
2,424,1,1,15,0,15,50,10,1
2,319,1,0,7,15,-8,44,10,1
2,301,2,0,7,15,-8,51,3,1
2,98,2,0,7,15,-8,19,10,1
3,867,2,1,15,7,8,45,10,1
3,833,1,0,7,15,-8,20,10,1
3,733,2,0,7,15,-8,30,10,1
3,662,2,0,7,15,-8,53,10,1
3,611,1,1,15,7,8,43,10,1
3,558,2,1,15,14,1,52,4,1
3,528,1,0,14,15,-1,48,10,1
3,420,1,0,14,15,-1,1,10,1
3,404,1,0,14,15,-1,14,10,1
3,339,1,0,14,15,-1,28,10,1
3,311,1,0,14,15,-1,44,10,1
3,280,2,0,14,15,-1,47,7,1
3,192,2,1,15,14,1,47,9,1
3,176,1,1,15,14,1,27,10,1
3,112,2,1,15,14,1,27,10,1
4,900,1,0,21,15,6,35,10,1
4,849,1,1,15,21,-6,54,10,1
4,810,2,1,15,21,-6,54,10,1
4,688,2,0,21,18,3,33,12,1
4,531,1,0,21,18,3,45,10,1
4,481,1,0,21,18,3,15,10,1
4,396,2,0,21,18,3,3,3,1
4,288,1,0,21,25,-4,40,10,1
4,264,1,0,21,25,-4,52,10,1
4,225,2,0,21,25,-4,55,7,1
4,182,3,1,25,21,4,50,2,1
4,145,2,1,25,24,1,38,7,1
4,9,3,0,24,26,-2,35,10,1
1,791,2,0,0,0,0,25,10,1
1,605,1,1,3,0,3,43,10,1
1,538,2,0,0,3,-3,35,15,1
1,480,1,0,0,4,-4,35,10,1
1,172,2,1,4,7,-3,23,10,1
1,60,1,0,7,4,3,31,10,1
2,722,1,0,7,4,3,16,10,1
2,692,2,0,7,4,3,22,4,1
2,532,1,0,7,4,3,17,10,1
2,201,1,0,7,7,0,19,10,1
2,123,2,1,14,7,7,30,14,1
2,39,1,1,14,10,4,51,10,1
3,882,2,0,13,14,-1,45,10,1
3,829,1,1,14,13,1,9,10,1
3,561,1,0,13,14,-1,51,10,1
3,295,1,0,13,17,-4,36,10,1
3,210,2,0,13,17,-4,46,15,1
3,143,2,1,17,13,4,43,8,1
4,860,1,0,13,17,-4,19,10,1
4,578,1,1,17,13,4,12,10,1
4,311,1,0,21,17,4,49,10,1
4,250,2,0,21,17,4,55,4,1
4,211,2,1,17,28,-11,48,10,1
4,188,3,1,17,28,-11,55,3,1
4,20,1,1,23,28,-5,26,10,1
4,16,2,1,23,28,-5,32,4,1
4,11,1,1,23,28,-5,48,10,1
1,891,1,1,0,0,0,48,10,1
1,802,1,0,0,0,0,9,10,1
1,756,2,0,0,0,0,25,10,1
1,610,1,1,0,0,0,42,15,1
1,585,2,1,0,0,0,52,5,1
1,498,2,0,0,0,0,24,7,1
1,311,1,1,1,0,1,24,10,1
1,222,2,0,0,1,-1,51,5,1
1,78,1,0,0,8,-8,34,10,1
1,23,2,1,8,0,8,48,7,1
2,680,1,1,8,0,8,13,10,1
2,650,1,1,8,7,1,49,10,1
2,593,2,0,7,8,-1,42,10,1
2,508,2,0,7,8,-1,33,13,1
2,326,1,1,15,14,1,53,10,1
2,195,1,1,15,14,1,17,10,1
2,101,2,1,15,14,1,44,10,1
3,869,2,0,14,15,-1,36,12,1
3,558,1,0,17,15,2,47,10,1
3,400,1,0,17,22,-5,29,10,1
4,884,2,1,22,24,-2,49,5,1
4,835,1,1,22,24,-2,43,10,1
4,689,1,1,22,27,-5,35,10,1
4,656,2,1,22,27,-5,46,10,1
4,586,2,0,27,22,5,37,2,1
4,441,1,0,27,25,2,35,10,1
4,204,2,1,25,34,-9,46,10,1
4,178,1,0,34,25,9,48,10,1
4,148,2,0,34,25,9,36,10,1
4,139,1,0,34,25,9,22,10,1
4,87,2,0,34,25,9,45,9,1
1,818,2,1,0,0,0,53,5,1
1,668,1,0,0,0,0,10,10,1
1,428,1,0,0,7,-7,20,10,1
1,228,1,1,7,0,7,50,10,1
1,2,1,0,3,7,-4,36,10,1
2,873,1,0,3,7,-4,24,10,1
2,303,2,0,3,10,-7,44,8,1
2,137,1,0,3,10,-7,36,10,1
3,797,1,1,10,3,7,25,10,1
3,758,2,1,10,3,7,22,13,1
3,637,2,1,10,3,7,4,4,1
3,598,2,1,10,9,1,41,10,1
3,5,1,1,11,9,2,29,10,1
4,900,2,1,11,9,2,36,3,1
4,753,1,0,9,11,-2,41,10,1
4,638,2,0,9,11,-2,51,10,1
4,546,2,1,11,9,2,12,5,1
4,296,2,1,11,15,-4,32,7,1
4,249,2,1,11,15,-4,19,9,1
4,122,1,0,18,11,7,45,10,1
4,3,1,1,13,18,-5,52,15,1
1,896,1,0,0,0,0,36,10,1
1,645,2,0,0,3,-3,40,5,1
1,477,2,1,3,0,3,35,10,1
1,375,1,0,0,3,-3,9,9,1
1,179,1,1,10,0,10,20,10,1
1,143,2,1,10,0,10,15,5,1
2,872,1,1,10,3,7,27,10,1
2,814,2,0,3,10,-7,52,4,1
2,731,2,0,3,10,-7,32,15,1
2,150,1,1,20,3,17,36,10,1
2,114,2,0,3,20,-17,42,6,1
2,83,1,0,3,20,-17,12,10,1
3,678,1,0,3,20,-17,27,10,1
3,526,1,0,3,27,-24,38,10,1
3,504,1,0,3,27,-24,55,10,1
3,470,1,1,27,3,24,42,10,1
3,418,3,1,27,3,24,35,3,1
3,339,1,1,27,3,24,32,10,1
3,296,1,1,27,3,24,46,10,1
3,258,1,0,3,27,-24,28,10,1
3,145,1,0,3,27,-24,12,10,1
4,658,2,1,30,3,27,44,8,1
4,623,1,0,3,30,-27,38,10,1
4,549,1,0,3,30,-27,5,5,1
4,495,2,0,3,37,-34,40,6,1
4,401,1,1,37,3,34,7,10,1
4,231,1,0,3,37,-34,49,10,1
4,104,1,0,3,37,-34,47,10,1
4,95,2,0,3,37,-34,41,4,1
1,891,1,0,0,0,0,31,10,1
1,693,2,1,0,0,0,38,5,1
1,653,1,0,0,0,0,50,10,1
1,571,1,0,0,0,0,18,10,1
1,323,2,1,0,0,0,54,8,1
1,278,1,1,0,0,0,15,10,1
1,160,2,1,0,3,-3,40,5,1
1,58,1,0,3,0,3,9,10,1
1,11,1,0,3,0,3,31,10,1
2,696,1,0,3,0,3,36,10,1
2,517,2,1,7,3,4,27,10,1
2,423,1,0,3,7,-4,44,10,1
2,390,1,0,3,7,-4,55,10,1
2,353,2,1,7,3,4,51,6,1
2,104,1,1,7,4,3,54,10,1
2,98,2,1,7,4,3,47,3,1
2,74,1,1,7,4,3,43,10,1
2,61,2,1,7,4,3,27,10,1
2,56,1,1,7,4,3,17,10,1
2,32,1,1,7,4,3,5,5,1
2,10,2,1,7,4,3,1,1,1
3,814,1,0,11,7,4,52,10,1
3,602,1,0,11,7,4,43,10,1
3,530,1,1,7,11,-4,52,10,1
3,444,1,1,7,11,-4,16,10,1
3,372,2,1,7,11,-4,25,13,1
3,314,1,1,7,11,-4,37,10,1
3,263,1,1,7,11,-4,25,10,1
3,223,2,1,7,11,-4,20,5,1
3,171,1,1,7,14,-7,35,10,1
3,13,1,0,14,7,7,52,10,1
4,794,2,0,14,10,4,30,10,1
4,695,2,0,14,10,4,29,22,1
4,612,2,1,10,14,-4,34,8,1
4,559,1,0,14,10,4,23,10,1
4,534,1,0,14,17,-3,31,10,1
4,344,1,0,14,17,-3,40,10,1
4,270,1,1,17,14,3,33,10,1
4,149,2,0,14,17,-3,25,18,1
1,799,1,1,0,0,0,32,10,1
1,740,2,1,0,0,0,51,10,1
1,675,1,0,0,0,0,32,10,1
1,606,1,0,0,0,0,12,10,1
1,531,1,0,0,7,-7,3,3,1
1,460,2,0,0,14,-14,20,20,1
1,397,1,1,14,0,14,48,10,1
1,383,1,0,0,14,-14,51,10,1
1,280,2,0,0,14,-14,37,10,1
1,212,2,0,0,14,-14,25,10,1
1,152,2,1,14,0,14,48,8,1
1,88,1,0,0,14,-14,48,10,1
2,847,1,0,0,17,-17,53,10,1
2,748,2,1,17,0,17,13,9,1
2,570,2,1,17,0,17,11,13,1
2,475,2,1,17,0,17,34,6,1
2,405,1,0,0,17,-17,49,20,1
2,377,2,0,0,17,-17,37,8,1
2,137,2,1,20,0,20,37,6,1
2,55,1,0,0,20,-20,13,10,1
2,43,2,0,0,20,-20,19,4,1
2,21,2,0,0,20,-20,29,10,1
3,896,1,1,20,1,19,35,10,1
3,872,1,1,20,1,19,45,10,1
3,740,2,0,1,20,-19,52,8,1
3,592,1,1,20,1,19,25,10,1
3,565,2,1,20,1,19,30,5,1
3,534,1,0,1,20,-19,44,10,1
3,381,2,0,1,20,-19,16,8,1
3,350,1,0,1,20,-19,27,10,1
3,311,1,0,1,20,-19,40,10,1
3,147,1,1,20,2,18,35,10,1
3,39,2,0,2,20,-18,22,6,1
4,867,2,0,2,20,-18,35,5,1
4,836,1,0,2,20,-18,43,10,1
4,690,1,1,20,5,15,30,15,1
4,555,1,0,5,20,-15,47,10,1
4,514,2,0,5,20,-15,44,7,1
4,436,1,0,5,23,-18,35,10,1
4,272,1,0,5,23,-18,19,10,1
4,231,2,1,23,5,18,14,10,1
4,126,2,0,5,23,-18,47,10,1
4,53,2,0,5,23,-18,7,10,1
4,26,2,0,5,23,-18,44,10,1
1,893,1,0,0,0,0,44,10,1
1,829,2,1,0,0,0,35,10,1
1,599,2,0,3,0,3,50,4,1
1,564,1,0,3,0,3,39,10,1
1,530,1,0,3,0,3,28,10,1
1,350,1,0,3,3,0,48,10,1
1,316,1,1,3,3,0,42,10,1
1,235,1,1,3,3,0,4,10,1
1,198,2,1,3,3,0,6,8,1
1,127,2,1,3,3,0,43,9,1
1,37,1,0,3,3,0,31,10,1
2,900,2,1,3,3,0,54,5,1
2,851,1,1,3,3,0,21,10,1
2,833,1,1,3,10,-7,29,10,1
2,713,2,0,10,3,7,45,5,1
2,666,3,0,10,3,7,43,3,1
2,458,1,0,10,6,4,54,10,1
2,387,1,0,10,6,4,25,10,1
2,298,1,1,6,10,-4,50,10,1
2,277,2,1,6,10,-4,44,4,1
2,132,1,1,6,17,-11,22,10,1
2,128,2,1,6,17,-11,28,4,1
2,113,1,1,6,17,-11,33,10,1
2,95,2,1,6,17,-11,39,4,1
2,85,1,1,6,17,-11,54,10,1
2,61,1,0,17,6,11,46,10,1
2,55,1,0,17,13,4,45,10,1
2,49,2,0,17,13,4,50,5,1
2,23,1,1,13,17,-4,24,10,1
3,820,1,1,13,24,-11,39,10,1
3,787,2,1,13,24,-11,45,4,1
3,678,1,0,24,13,11,19,10,1
3,417,2,0,24,13,11,23,7,1
3,356,1,0,24,16,8,41,10,1
3,272,2,1,16,24,-8,40,5,1
3,200,2,1,16,24,-8,24,10,1
3,84,1,1,16,27,-11,46,10,1
4,879,1,0,27,16,11,44,10,1
4,817,2,1,16,27,-11,49,9,1
4,593,1,0,30,16,14,49,10,1
4,549,2,0,30,16,14,50,11,1
4,511,1,0,30,16,14,36,10,1
4,449,3,0,30,16,14,34,8,1
4,434,1,0,30,16,14,30,10,1
4,369,2,0,30,16,14,49,3,1
4,308,2,1,16,30,-14,53,8,1
4,266,1,1,16,30,-14,36,10,1
4,222,2,1,16,30,-14,35,9,1
4,190,1,1,16,30,-14,22,10,1
4,138,1,1,16,33,-17,35,10,1
1,857,2,1,0,0,0,42,5,1
1,817,1,0,0,0,0,22,10,1
1,692,2,0,0,3,-3,35,10,1
1,634,1,1,3,0,3,45,10,1
1,520,1,0,0,4,-4,35,10,1
1,319,2,1,4,0,4,36,4,1
1,279,1,1,4,0,4,52,10,1
1,35,2,0,0,4,-4,34,7,1
2,674,1,0,0,4,-4,45,10,1
2,546,1,0,0,11,-11,13,10,1
2,504,1,0,0,11,-11,28,10,1
2,260,2,1,11,3,8,37,10,1
2,161,1,1,11,6,5,35,10,1
2,105,1,0,6,11,-5,30,10,1
3,875,2,0,6,11,-5,32,10,1
3,824,1,1,11,6,5,34,10,1
3,761,1,0,6,11,-5,37,10,1
3,481,2,1,14,6,8,34,10,1
3,395,2,1,14,6,8,52,4,1
3,366,1,0,6,14,-8,52,10,1
3,96,2,0,6,14,-8,40,6,1
3,39,2,0,6,14,-8,23,4,1
4,831,1,0,6,14,-8,15,15,1
4,749,2,0,6,14,-8,15,15,1
4,722,1,0,6,21,-15,25,10,1
4,659,2,0,6,21,-15,30,15,1
4,591,1,1,21,6,15,46,10,1
4,524,2,1,21,6,15,21,10,1
4,378,2,1,21,9,12,40,8,1
4,321,1,0,9,21,-12,24,10,1
4,280,2,0,9,21,-12,20,6,1
4,163,2,0,9,28,-19,13,10,1
4,150,2,0,9,28,-19,27,15,1
4,130,2,0,9,28,-19,40,17,1
4,56,2,0,9,29,-20,35,10,1
4,48,1,0,9,29,-20,50,10,1
4,38,2,1,29,9,20,50,0,1
4,19,1,1,29,9,20,17,10,1
1,891,1,0,0,0,0,36,10,1
1,855,1,0,0,0,0,50,10,1
1,795,2,1,0,0,0,40,4,1
1,766,1,1,0,0,0,36,10,1
1,688,1,1,0,1,-1,35,10,1
1,573,1,0,1,0,1,29,10,1
1,440,2,0,1,0,1,11,4,1
1,317,1,0,1,0,1,33,10,1
1,255,1,0,1,0,1,53,15,1
1,212,2,0,1,0,1,49,19,1
2,842,1,0,1,0,1,6,6,1
2,610,1,1,7,1,6,40,10,1
2,462,2,1,7,1,6,18,10,1
2,380,2,1,7,4,3,41,10,1
3,753,1,0,4,16,-12,24,10,1
3,689,1,0,4,16,-12,40,10,1
3,661,1,0,4,23,-19,31,10,1
3,548,1,1,23,4,19,44,10,1
3,203,2,0,7,23,-16,15,8,1
3,138,1,1,23,7,16,52,10,1
3,1,1,0,7,24,-17,35,10,1
4,900,2,0,7,24,-17,41,4,1
4,867,1,0,7,24,-17,47,10,1
4,840,1,1,24,7,17,44,10,1
4,800,2,1,24,7,17,39,5,1
4,702,2,1,24,7,17,35,7,1
4,593,1,0,7,24,-17,41,10,1
4,538,1,0,7,24,-17,52,10,1
4,504,1,0,7,24,-17,55,10,1
4,454,1,1,24,7,17,35,10,1
4,444,2,1,24,7,17,29,4,1
4,64,1,0,17,24,-7,6,10,1
4,58,1,0,17,24,-7,18,10,1
4,24,3,0,17,24,-7,20,8,1
1,893,1,0,0,0,0,27,10,1
1,524,2,0,0,0,0,37,10,1
1,260,2,0,0,1,-1,41,4,1
1,97,1,1,1,0,1,42,10,1
2,749,1,1,1,0,1,30,10,1
2,531,2,0,0,1,-1,53,8,1
2,488,1,0,0,1,-1,40,10,1
2,452,2,0,0,1,-1,33,3,1
2,413,1,0,0,1,-1,22,10,1
2,340,1,0,0,1,-1,10,10,1
2,239,2,0,0,8,-8,55,10,1
2,105,1,0,3,8,-5,44,10,1
2,69,2,0,3,8,-5,16,10,1
2,43,1,0,3,15,-12,54,10,1
3,860,2,1,15,3,12,33,9,1
3,546,1,0,3,22,-19,33,10,1
3,494,1,0,3,22,-19,45,10,1
3,303,2,0,3,22,-19,33,10,1
3,3,2,1,36,3,33,53,4,1
4,869,1,1,36,3,33,48,10,1
4,824,3,1,36,3,33,47,9,1
4,490,2,0,3,50,-47,49,9,1
4,409,1,0,3,50,-47,30,10,1
4,134,2,1,50,3,47,8,5,1
4,40,2,1,50,11,39,8,8,1
1,796,2,0,0,0,0,17,10,1
1,687,2,0,0,0,0,46,3,1
1,617,2,0,0,7,-7,39,13,1
1,382,2,1,7,1,6,30,15,1
1,330,1,0,1,7,-6,17,10,1
1,157,1,0,1,7,-6,54,10,1
1,82,1,1,7,1,6,45,10,1
2,638,1,0,1,15,-14,35,10,1
2,530,2,1,15,1,14,32,10,1
2,487,2,0,1,22,-21,32,7,1
2,444,1,0,1,22,-21,40,10,1
2,330,2,1,22,1,21,30,6,1
2,257,2,0,1,22,-21,31,10,1
2,161,2,0,1,22,-21,55,10,1
2,95,2,1,22,4,18,45,10,1
2,70,1,0,4,22,-18,49,10,1
2,40,1,0,4,22,-18,19,10,1
3,847,2,0,4,29,-25,33,4,1
3,716,2,0,4,29,-25,47,10,1
3,625,2,0,4,29,-25,30,6,1
3,601,1,0,4,36,-32,31,10,1
3,566,2,0,4,36,-32,39,2,1
3,548,1,0,4,36,-32,46,10,1
3,522,1,1,36,4,32,27,10,1
3,456,1,1,36,4,32,15,10,1
3,366,2,1,36,4,32,3,3,1
3,238,2,0,11,36,-25,46,9,1
3,191,1,1,36,11,25,16,10,1
3,87,1,0,18,36,-18,46,10,1
4,867,1,1,36,18,18,23,10,1
4,841,2,1,36,18,18,28,5,1
4,751,2,1,36,18,18,38,12,1
4,676,1,1,36,18,18,51,10,1
4,645,1,1,36,18,18,32,10,1
4,544,2,1,36,18,18,28,10,1
4,113,3,0,18,43,-25,42,10,1
4,55,1,0,18,43,-25,50,10,1
4,35,2,1,43,18,25,53,20,1
4,27,3,1,43,18,25,44,11,1
1,894,1,0,0,0,0,28,10,1
1,576,1,0,0,0,0,49,10,1
1,492,1,1,0,0,0,55,10,1
1,456,1,0,0,0,0,27,10,1
1,413,2,0,0,0,0,20,3,1
1,370,1,0,0,0,0,14,10,1
1,213,1,1,7,0,7,44,10,1
1,82,2,1,7,0,7,46,20,1
1,46,1,0,0,7,-7,36,10,1
2,900,1,0,0,7,-7,25,10,1
2,831,1,0,0,14,-14,26,10,1
2,717,1,1,14,0,14,14,10,1
2,590,1,0,0,14,-14,23,10,1
2,511,1,0,0,14,-14,37,10,1
2,472,1,0,0,14,-14,49,10,1
2,425,1,1,14,0,14,25,10,1
2,331,1,1,14,0,14,23,10,1
2,282,1,0,0,14,-14,44,10,1
2,236,1,0,0,14,-14,19,10,1
2,145,2,0,0,14,-14,9,9,1
2,137,1,0,0,17,-17,35,10,1
2,81,1,1,17,0,17,45,10,1
2,75,1,1,17,7,10,39,10,1
3,893,1,1,17,7,10,31,10,1
3,814,2,0,7,17,-10,53,3,1
3,744,1,0,7,17,-10,52,10,1
3,652,1,1,17,7,10,15,10,1
3,607,1,1,17,7,10,27,10,1
3,585,1,1,17,7,10,43,10,1
3,546,2,1,17,7,10,48,5,1
3,502,1,0,7,17,-10,50,10,1
3,459,2,0,7,17,-10,51,11,1
3,220,2,0,7,20,-13,32,13,1
3,20,1,0,7,20,-13,44,10,1
4,900,2,0,7,20,-13,50,4,1
4,861,1,1,20,7,13,53,10,1
4,836,1,1,20,7,13,37,10,1
4,669,1,1,20,10,10,50,10,1
4,564,2,1,20,10,10,39,10,1
4,513,1,1,20,10,10,26,10,1
4,252,1,0,13,20,-7,41,10,1
4,208,1,1,20,13,7,47,10,1
4,184,2,1,20,13,7,43,6,1
4,120,2,1,20,16,4,35,10,1
4,93,2,1,20,16,4,50,7,1
4,30,2,0,16,20,-4,3,19,1
4,24,1,0,16,20,-4,23,10,1
4,16,2,0,16,20,-4,32,1,1
1,828,1,0,0,0,0,39,10,1
1,792,1,0,0,0,0,28,10,1
1,745,2,0,0,0,0,33,15,1
1,679,2,0,0,3,-3,35,10,1
1,615,1,1,3,0,3,37,10,1
1,583,2,1,3,0,3,33,14,1
2,784,2,0,0,7,-7,44,10,1
2,725,1,0,0,7,-7,15,10,1
2,637,1,0,0,7,-7,31,10,1
2,563,1,0,0,7,-7,18,10,1
2,225,1,0,0,17,-17,25,10,1
2,166,2,0,0,17,-17,28,7,1
2,145,1,0,0,17,-17,35,10,1
2,44,2,1,17,0,17,54,10,1
2,32,2,1,17,7,10,48,4,1
2,25,1,1,17,7,10,53,10,1
3,895,1,1,17,7,10,29,10,1
3,760,2,0,7,17,-10,22,16,1
3,640,1,1,17,7,10,13,10,1
3,305,2,0,7,18,-11,47,10,1
3,257,1,1,18,7,11,51,10,1
3,167,1,1,18,7,11,28,10,1
4,900,2,0,10,18,-8,44,16,1
4,777,1,0,10,18,-8,35,10,1
4,678,1,1,18,10,8,12,10,1
4,547,2,1,18,10,8,19,15,1
4,443,1,1,18,10,8,36,10,1
4,363,2,0,10,18,-8,50,3,1
4,198,1,0,10,18,-8,24,10,1
4,175,1,0,10,18,-8,54,10,1
4,104,1,1,18,10,8,37,10,1
4,97,2,1,18,10,8,40,7,1
1,675,1,0,0,0,0,44,10,1
1,571,2,1,0,0,0,50,5,1
1,496,2,1,0,0,0,37,7,1
1,439,1,1,0,0,0,22,10,1
1,250,1,1,0,7,-7,47,10,1
1,217,1,0,7,0,7,52,10,1
1,61,2,0,7,3,4,23,18,1
2,853,1,0,7,3,4,36,10,1
2,652,1,0,7,10,-3,25,10,1
2,574,1,0,7,10,-3,40,10,1
2,536,2,0,7,10,-3,44,6,1
2,432,1,1,10,7,3,45,10,1
2,290,1,1,10,7,3,9,9,1
2,261,1,1,10,14,-4,28,10,1
2,199,1,1,10,14,-4,38,10,1
2,177,1,1,10,14,-4,53,10,1
2,162,2,1,10,14,-4,54,9,1
2,119,2,0,14,10,4,41,10,1
2,110,1,0,14,10,4,19,10,1
2,80,1,0,14,13,1,35,10,1
2,74,2,0,14,13,1,41,4,1
3,714,1,1,20,14,6,11,10,1
3,648,2,1,20,14,6,19,12,1
3,612,2,1,20,14,6,33,10,1
3,496,1,0,14,20,-6,27,10,1
3,342,1,0,14,27,-13,29,10,1
3,221,2,1,27,14,13,50,8,1
3,161,1,1,27,14,13,42,10,1
3,34,1,1,27,17,10,34,10,1
4,708,1,0,17,27,-10,29,10,1
4,606,1,0,17,27,-10,47,10,1
4,589,1,1,27,24,3,32,10,1
4,465,1,0,24,27,-3,46,10,1
4,446,2,0,24,27,-3,39,3,1
4,328,1,0,24,30,-6,35,10,1
4,299,2,0,24,30,-6,36,9,1
4,173,2,0,24,37,-13,28,20,1
4,161,3,0,24,37,-13,43,5,1
4,43,1,0,24,40,-16,36,10,1
4,37,1,0,24,40,-16,50,10,1
4,24,1,1,40,24,16,45,10,1
4,13,2,1,40,24,16,35,0,1
1,895,1,0,0,0,0,43,10,1
1,829,2,0,0,0,0,53,10,1
1,680,1,0,0,0,0,52,10,1
1,541,2,1,0,0,0,19,6,1
1,373,2,1,0,0,0,37,13,1
1,336,1,0,0,7,-7,34,10,1
1,320,2,0,0,7,-7,39,5,1
1,183,1,1,7,0,7,40,10,1
1,165,2,1,7,0,7,45,5,1
1,59,2,1,7,0,7,41,19,1
2,900,1,0,0,7,-7,25,10,1
2,755,2,1,7,0,7,50,15,1
2,647,1,0,0,7,-7,28,10,1
2,533,1,0,0,10,-10,21,10,1
2,423,1,1,10,0,10,22,10,1
2,263,1,0,0,13,-13,21,15,1
2,145,2,0,0,13,-13,23,10,1
2,26,1,0,0,20,-20,27,10,1
2,20,1,0,0,20,-20,37,10,1
3,864,1,0,0,27,-27,15,10,1
3,784,1,0,0,27,-27,27,15,1
3,661,1,0,0,27,-27,47,10,1
3,641,2,0,0,27,-27,40,3,1
3,490,2,0,0,34,-34,25,10,1
3,350,1,1,34,0,34,55,10,1
3,223,1,0,0,34,-34,25,10,1
3,199,2,0,0,34,-34,30,5,1
3,154,1,0,0,34,-34,35,10,1
3,117,2,0,0,34,-34,41,4,1
3,12,3,1,34,0,34,50,3,1
4,900,1,1,34,0,34,36,10,1
4,874,1,1,34,0,34,26,10,1
4,806,1,1,34,0,34,15,10,1
4,558,2,0,7,37,-30,30,9,1
4,478,1,1,37,7,30,36,10,1
4,400,1,0,7,37,-30,41,10,1
4,370,2,0,7,37,-30,47,4,1
1,895,1,1,0,0,0,29,10,1
1,792,2,0,0,0,0,46,7,1
1,642,2,1,0,0,0,48,15,1
1,547,2,0,0,0,0,21,11,1
1,403,2,0,0,0,0,36,10,1
1,118,2,1,6,0,6,30,8,1
1,84,1,1,6,0,6,21,10,1
2,800,1,0,3,6,-3,55,10,1
2,719,2,1,6,3,3,51,17,1
2,661,1,1,6,6,0,35,10,1
2,640,2,1,6,6,0,38,7,1
2,602,1,1,6,6,0,53,10,1
2,492,1,0,6,6,0,55,10,1
2,343,2,1,6,6,0,28,3,1
2,292,1,1,6,6,0,32,10,1
2,266,2,1,6,6,0,33,9,1
2,147,1,1,6,6,0,33,10,1
2,133,1,1,6,6,0,46,10,1
2,81,1,1,6,6,0,47,10,1
2,30,1,1,6,6,0,11,10,1
2,22,1,1,6,12,-6,37,10,1
3,599,2,1,7,13,-6,25,19,1
3,540,1,1,7,13,-6,53,10,1
3,380,2,0,20,7,13,50,9,1
3,223,1,1,14,20,-6,30,10,1
3,127,2,1,14,20,-6,42,10,1
3,31,1,1,14,27,-13,28,10,1
4,750,0,1,14,27,-13,39,0,1
4,703,1,1,14,27,-13,50,10,1
4,510,1,1,14,34,-20,27,10,1
4,487,1,1,14,34,-20,41,10,1
4,446,2,1,14,34,-20,39,12,1
4,429,1,1,14,34,-20,55,10,1
4,165,1,1,20,34,-14,44,15,1
4,137,2,1,20,34,-14,38,21,1
4,126,2,0,34,27,7,17,8,1
4,115,1,1,27,34,-7,45,10,1
1,876,1,1,0,0,0,33,10,1
1,843,2,1,0,0,0,40,3,1
1,677,2,0,0,0,0,45,3,1
1,463,2,0,0,3,-3,32,5,1
1,436,1,0,0,3,-3,37,10,1
1,251,2,1,3,3,0,29,10,1
1,210,1,1,3,3,0,42,10,1
1,79,1,0,3,3,0,54,10,1
1,50,1,0,3,3,0,45,10,1
1,20,1,0,3,3,0,33,10,1
2,836,1,0,3,6,-3,27,10,1
2,512,1,1,6,3,3,37,10,1
2,342,1,1,6,3,3,42,10,1
2,258,2,0,3,6,-3,49,6,1
2,180,2,1,6,3,3,54,10,1
2,104,1,1,6,6,0,32,10,1
3,894,1,0,6,6,0,26,10,1
3,829,1,0,6,6,0,54,10,1
3,789,1,0,6,6,0,40,10,1
3,713,1,0,6,9,-3,27,10,1
3,604,2,0,6,9,-3,44,7,1
3,534,2,0,6,9,-3,31,9,1
3,462,1,0,6,9,-3,31,20,1
3,293,1,1,12,6,6,22,20,1
3,248,2,1,12,6,6,34,8,1
3,79,2,0,6,12,-6,48,10,1
4,870,1,0,6,12,-6,48,10,1
4,793,1,0,6,12,-6,38,10,1
4,670,1,0,6,12,-6,24,10,1
4,633,1,0,6,20,-14,52,10,1
4,510,2,1,20,6,14,43,5,1
4,382,1,1,20,6,14,50,10,1
4,287,2,0,6,20,-14,46,7,1
4,180,2,0,6,20,-14,36,9,1
1,731,2,0,0,0,0,26,2,1
1,631,1,1,0,0,0,35,10,1
1,603,2,1,0,0,0,40,5,1
1,553,2,0,0,0,0,50,3,1
1,520,1,0,0,0,0,39,10,1
1,406,2,0,0,0,0,18,5,1
1,868,1,1,0,0,0,17,20,1
1,837,2,1,0,0,0,24,13,1
1,686,1,1,0,0,0,34,10,1
1,548,3,0,0,0,0,32,5,1
1,155,1,1,0,1,-1,35,10,1
1,114,2,1,0,1,-1,41,4,1
1,58,1,0,1,0,1,39,10,1
2,900,1,1,0,1,-1,7,10,1
2,868,1,1,0,1,-1,23,10,1
2,730,1,1,0,1,-1,50,10,1
2,361,2,0,4,0,4,48,5,1
2,192,1,0,4,0,4,44,10,1
2,86,1,1,3,4,-1,7,7,1
2,62,2,1,3,12,-9,6,5,1
3,860,2,0,12,3,9,40,7,1
3,728,1,1,3,12,-9,20,10,1
3,585,2,0,12,3,9,40,10,1
3,325,2,1,3,12,-9,34,8,1
3,140,2,1,3,19,-16,38,8,1
4,840,2,0,19,3,16,55,10,1
4,712,1,0,19,3,16,40,10,1
1,890,1,0,0,0,0,46,10,1
1,815,2,0,0,0,0,35,11,1
1,546,1,0,0,7,-7,55,10,1
1,381,2,1,7,3,4,38,6,1
1,180,1,0,3,7,-4,42,20,1
1,130,2,0,3,7,-4,45,17,1
1,61,1,1,7,3,4,30,10,1
2,872,1,0,3,7,-4,35,10,1
2,789,2,0,3,7,-4,49,10,1
2,621,2,1,7,10,-3,22,10,1
2,551,1,1,7,10,-3,37,10,1
2,499,2,1,7,10,-3,26,10,1
2,445,1,1,7,13,-6,8,10,1
2,327,1,1,7,20,-13,23,10,1
2,141,2,0,20,7,13,35,9,1
2,46,2,0,22,7,15,33,10,1
2,40,1,0,22,7,15,9,9,1
3,860,2,1,7,22,-15,33,9,1
3,666,3,1,7,22,-15,7,7,1
3,450,2,0,30,7,23,50,10,1
3,260,1,0,30,7,23,52,10,1
3,211,2,1,7,30,-23,54,14,1
3,1,2,0,30,7,23,35,21,1
4,841,2,0,30,10,20,33,12,1
4,378,1,0,30,10,20,32,10,1
4,342,1,0,30,10,20,45,10,1
4,68,1,1,10,30,-20,35,10,1
1,892,1,1,0,0,0,46,10,1
1,865,1,1,0,0,0,28,10,1
1,816,1,1,0,0,0,15,10,1
1,796,1,1,0,7,-7,38,10,1
1,757,2,1,0,7,-7,42,6,1
1,734,1,0,7,0,7,23,10,1
1,465,1,0,7,7,0,29,10,1
1,423,2,0,7,7,0,48,10,1
1,407,1,1,7,7,0,39,10,1
1,281,1,1,7,10,-3,30,10,1
1,136,1,0,10,7,3,13,10,1
1,95,2,0,10,7,3,19,4,1
1,1,1,1,7,10,-3,49,10,1
2,900,1,1,7,10,-3,29,10,1
2,619,1,0,13,7,6,55,10,1
2,541,1,1,7,13,-6,44,10,1
2,502,1,1,7,13,-6,20,10,1
2,340,1,1,7,20,-13,29,10,1
2,315,2,1,7,20,-13,35,4,1
2,159,2,1,7,20,-13,53,11,1
2,108,2,0,20,7,13,34,10,1
2,100,1,0,20,7,13,50,10,1
2,61,1,1,7,20,-13,32,10,1
2,56,1,1,7,20,-13,44,10,1
2,38,1,1,7,20,-13,55,10,1
2,29,2,0,20,7,13,48,3,1
3,754,2,0,20,7,13,40,10,1
3,502,1,1,7,20,-13,33,10,1
3,348,2,1,7,23,-16,38,10,1
3,310,1,1,7,23,-16,51,10,1
3,108,1,0,23,7,16,51,10,1
4,805,1,1,13,23,-10,34,10,1
4,760,1,1,13,23,-10,15,10,1
4,681,1,1,13,26,-13,35,10,1
4,648,1,1,13,26,-13,50,10,1
4,485,2,0,26,13,13,16,11,1
4,431,2,0,26,13,13,40,8,1
4,372,1,1,13,26,-13,23,10,1
4,238,1,0,26,13,13,44,20,1
4,200,2,0,26,13,13,31,7,1
4,162,3,0,26,13,13,17,10,1
4,94,2,1,15,26,-11,35,10,1
4,87,1,1,15,26,-11,45,10,1
4,81,2,1,15,26,-11,51,4,1
4,60,2,0,26,15,11,44,2,1
4,47,1,0,26,15,11,37,10,1
4,21,3,0,26,15,11,33,6,1
4,1,1,0,26,15,11,11,10,1
1,787,1,0,0,0,0,45,10,1
1,731,1,0,0,0,0,11,10,1
1,663,2,0,0,6,-6,29,7,1
1,590,2,1,6,0,6,26,9,1
1,186,1,0,3,6,-3,26,10,1
1,102,1,1,6,3,3,41,10,1
1,43,1,1,6,3,3,54,10,1
1,1,2,0,3,6,-3,53,7,1
2,900,1,0,3,6,-3,43,10,1
2,650,1,1,13,10,3,47,10,1
2,493,1,0,10,16,-6,18,10,1
2,322,2,0,10,19,-9,52,10,1
2,184,2,1,19,10,9,50,20,1
2,100,1,1,19,10,9,50,10,1
2,77,1,0,10,19,-9,49,10,1
2,19,1,0,10,19,-9,50,10,1
2,1,2,0,10,19,-9,54,6,1
3,885,1,0,13,19,-6,40,10,1
3,820,2,0,13,19,-6,55,8,1
3,800,1,1,19,13,6,30,10,1
3,707,1,1,19,16,3,35,10,1
3,678,2,1,19,16,3,41,4,1
3,576,1,0,16,19,-3,52,10,1
3,532,2,0,16,19,-3,45,3,1
3,502,1,0,16,19,-3,33,10,1
3,307,2,1,19,16,3,52,8,1
3,216,2,0,16,19,-3,39,6,1
3,193,1,0,16,19,-3,32,10,1
3,147,1,0,16,19,-3,21,10,1
3,116,1,0,16,27,-11,47,10,1
4,900,1,1,27,16,11,15,10,1
4,815,1,1,27,23,4,29,10,1
4,783,2,1,27,23,4,38,1,1
4,746,1,1,27,23,4,44,10,1
4,659,2,0,23,27,-4,52,7,1
4,605,2,0,23,27,-4,41,7,1
4,505,2,0,23,30,-7,41,5,1
4,483,1,0,23,30,-7,53,10,1
4,433,2,1,30,23,7,22,10,1
4,351,2,1,30,23,7,9,9,1
4,325,1,1,30,30,0,23,10,1
4,153,1,1,30,30,0,52,10,1
4,102,2,1,30,30,0,25,5,1
4,29,1,1,30,37,-7,33,10,1
4,1,3,1,30,37,-7,45,13,1
1,887,1,1,0,0,0,45,10,1
1,853,2,1,0,0,0,46,9,1
1,654,1,0,0,6,-6,31,10,1
1,621,1,0,0,6,-6,42,10,1
1,583,1,1,6,0,6,50,10,1
1,505,2,1,6,0,6,34,8,1
1,410,1,0,0,6,-6,46,10,1
2,878,2,0,0,6,-6,35,12,1
2,709,1,1,6,0,6,38,10,1
2,533,1,0,5,6,-1,50,10,1
2,342,2,0,5,6,-1,4,4,1
2,152,2,0,5,13,-8,39,11,1
2,67,2,1,13,5,8,30,10,1
3,880,2,0,5,13,-8,27,8,1
3,778,2,0,5,13,-8,46,5,1
3,735,1,1,13,5,8,51,10,1
3,700,2,1,13,5,8,45,4,1
3,513,2,1,13,5,8,13,10,1
3,303,2,1,13,13,0,37,10,1
3,230,2,0,13,13,0,47,8,1
3,144,2,0,13,13,0,41,12,1
3,67,2,0,13,16,-3,30,15,1
3,3,1,1,16,13,3,45,10,1
4,866,1,1,16,13,3,55,10,1
4,819,1,0,13,16,-3,46,10,1
4,765,1,1,16,13,3,33,10,1
4,683,2,1,16,13,3,13,7,1
4,515,1,0,20,16,4,31,10,1
4,202,2,0,20,16,4,7,8,1
4,180,1,0,20,16,4,20,10,1
4,134,2,0,20,16,4,38,6,1
1,852,1,1,0,0,0,17,10,1
1,789,2,1,0,0,0,35,4,1
1,703,2,1,0,0,0,51,3,1
1,563,2,1,0,7,-7,29,6,1
1,523,1,1,0,7,-7,36,10,1
1,485,1,1,0,7,-7,52,10,1
1,326,2,0,7,0,7,30,10,1
1,300,1,0,7,7,0,25,10,1
1,280,1,0,7,7,0,35,10,1
1,244,2,0,7,7,0,39,6,1
1,213,1,0,7,7,0,51,10,1
1,132,2,1,7,7,0,23,10,1
2,774,2,0,15,7,8,21,10,1
2,688,2,0,15,7,8,32,9,1
2,600,1,1,9,15,-6,45,10,1
2,578,2,1,9,15,-6,51,4,1
2,417,1,0,15,10,5,35,10,1
2,355,1,0,15,10,5,35,10,1
2,270,1,0,15,10,5,48,10,1
2,165,2,0,15,10,5,52,8,1
2,137,2,1,10,15,-5,43,8,1
2,105,2,1,10,15,-5,34,10,1
3,890,1,0,18,10,8,20,10,1
3,861,1,0,18,10,8,34,10,1
3,760,1,0,18,10,8,46,10,1
3,654,1,0,18,10,8,16,10,1
3,608,1,0,18,10,8,26,10,1
3,559,1,0,18,10,8,35,15,1
3,529,2,0,18,10,8,41,9,1
3,485,1,1,10,18,-8,29,10,1
3,450,2,1,10,18,-8,25,5,1
3,261,2,1,18,18,0,25,6,1
3,185,1,0,18,18,0,40,10,1
3,127,2,1,18,18,0,50,6,1
3,83,2,1,18,18,0,40,10,1
3,38,2,1,18,18,0,27,10,1
4,900,1,1,18,21,-3,35,10,1
4,742,2,1,18,21,-3,48,6,1
4,569,2,1,18,22,-4,39,6,1
4,534,1,1,18,22,-4,45,10,1
4,446,2,0,22,18,4,12,5,1
4,423,1,0,22,18,4,7,7,1
4,155,1,0,22,21,1,35,10,1
4,151,2,0,22,21,1,41,4,1
4,105,2,0,22,21,1,51,6,1
4,27,3,1,21,23,-2,38,18,1
4,17,1,0,23,21,2,44,10,1
1,887,1,1,0,0,0,23,10,1
1,865,1,1,0,0,0,37,10,1
1,728,1,1,2,0,2,41,10,1
1,624,2,1,2,0,2,29,30,1
1,502,1,1,2,0,2,53,10,1
1,421,1,0,0,2,-2,42,10,1
1,390,1,0,0,2,-2,53,10,1
1,315,3,1,2,1,1,35,10,1
1,282,1,1,2,1,1,54,10,1
1,202,2,0,1,2,-1,43,8,1
1,37,1,1,3,1,2,26,10,1
1,0,1,1,3,7,-4,53,10,1
2,894,1,0,7,10,-3,28,10,1
2,786,1,0,7,10,-3,50,10,1
2,703,1,1,10,7,3,16,5,1
2,610,2,1,10,7,3,52,17,1
2,338,1,0,7,10,-3,44,10,1
2,150,2,1,10,10,0,34,11,1
2,96,1,0,10,10,0,43,20,1
2,88,2,0,10,10,0,46,17,1
3,872,2,0,10,10,0,36,10,1
3,745,2,0,10,10,0,44,13,1
3,520,1,1,10,10,0,54,10,1
3,435,1,0,10,10,0,3,10,1
3,372,1,0,10,16,-6,42,10,1
3,182,2,0,10,16,-6,49,11,1
3,124,2,1,16,10,6,51,18,1
3,77,1,1,16,11,5,35,10,1
3,3,1,1,16,11,5,46,10,1
4,900,2,1,16,11,5,51,5,1
4,797,1,0,11,24,-13,10,10,1
4,661,1,0,11,25,-14,35,10,1
4,518,2,1,25,11,14,45,5,1
4,475,1,1,25,11,14,53,10,1
4,374,1,0,11,25,-14,25,10,1
4,332,1,0,11,25,-14,15,10,1
4,109,1,0,11,26,-15,40,10,1
1,888,1,1,0,0,0,21,10,1
1,769,2,1,0,0,0,40,4,1
1,737,1,1,0,0,0,47,10,1
1,637,1,0,0,0,0,51,10,1
1,539,1,0,0,0,0,13,10,1
1,328,2,1,0,0,0,18,10,1
1,212,2,0,0,0,0,35,9,1
1,176,1,1,0,0,0,50,10,1
1,147,1,1,0,0,0,29,10,1
1,59,2,1,0,0,0,6,6,1
2,900,2,0,7,0,7,53,10,1
2,814,2,0,7,0,7,36,5,1
2,759,2,0,7,7,0,38,5,1
2,737,1,0,7,7,0,47,10,1
2,511,1,1,7,7,0,21,10,1
2,467,2,1,7,7,0,21,10,1
2,399,1,0,7,7,0,35,10,1
2,279,2,0,7,7,0,51,4,1
2,220,2,1,7,7,0,35,7,1
2,180,1,1,7,7,0,26,10,1
2,154,1,1,7,7,0,12,10,1
2,126,1,1,7,15,-8,35,10,1
2,115,2,1,7,15,-8,45,10,1
2,88,1,0,15,7,8,53,10,1
2,70,1,0,15,14,1,52,10,1
2,50,1,1,14,15,-1,31,10,1
3,900,1,1,14,15,-1,45,10,1
3,791,2,0,15,22,-7,33,5,1
3,755,1,0,15,22,-7,42,10,1
3,605,1,0,15,22,-7,54,10,1
3,578,2,0,15,22,-7,50,6,1
3,511,2,0,15,22,-7,37,3,1
3,381,1,0,15,23,-8,35,10,1
3,178,2,1,23,15,8,14,10,1
4,858,2,1,23,23,0,53,7,1
4,827,1,0,23,23,0,47,10,1
4,790,2,0,23,23,0,40,3,1
4,660,2,0,23,23,0,25,15,1
4,599,1,0,23,26,-3,35,10,1
4,554,2,1,26,23,3,32,8,1
4,485,1,1,26,23,3,30,20,1
4,429,2,1,26,23,3,18,8,1
4,409,1,1,26,30,-4,10,10,1
4,326,1,1,26,30,-4,22,10,1
4,256,2,1,26,30,-4,40,6,1
1,865,2,0,0,1,-1,41,4,1
1,834,1,0,0,1,-1,52,10,1
1,787,1,1,1,0,1,19,10,1
1,683,1,1,1,3,-2,35,10,1
1,518,1,0,3,1,2,53,10,1
1,454,2,0,3,1,2,26,10,1
1,375,1,0,3,7,-4,34,10,1
1,351,1,0,3,7,-4,48,10,1
1,305,1,1,7,3,4,51,10,1
1,102,3,1,7,3,4,3,3,1
2,811,1,0,17,7,10,42,10,1
2,785,2,0,17,7,10,46,6,1
2,743,1,1,7,17,-10,35,10,1
2,635,1,1,7,24,-17,28,10,1
2,526,2,1,7,31,-24,40,8,1
2,472,1,0,31,7,24,16,10,1
2,406,1,0,31,7,24,28,15,1
2,299,2,1,7,31,-24,48,10,1
2,236,1,1,7,38,-31,15,10,1
2,180,2,1,7,38,-31,15,10,1
2,83,1,1,7,38,-31,32,10,1
2,78,2,1,7,38,-31,36,6,1
2,73,1,1,7,38,-31,48,10,1
2,47,2,0,38,7,31,44,5,1
3,821,1,0,38,13,25,25,10,1
3,780,2,0,38,13,25,25,10,1
3,742,1,0,38,13,25,36,10,1
3,690,1,1,13,38,-25,23,10,1
3,483,1,1,15,41,-26,38,10,1
3,420,1,1,15,41,-26,48,10,1
3,383,1,0,41,15,26,49,10,1
3,275,1,0,41,18,23,35,10,1
3,62,1,1,18,49,-31,52,10,1
4,900,1,0,49,18,31,33,10,1
4,869,2,0,49,18,31,30,7,1
4,827,1,0,49,18,31,15,10,1
4,674,2,0,49,26,23,31,7,1
4,636,1,0,49,26,23,43,10,1
4,599,2,0,49,26,23,45,8,1
4,481,2,0,49,26,23,53,12,1
4,416,2,1,26,49,-23,37,15,1
4,280,1,1,26,52,-26,40,10,1
4,180,2,0,52,26,26,15,6,1
4,156,1,0,52,26,26,43,10,1
1,870,2,0,0,0,0,10,10,1
1,794,2,0,0,0,0,34,6,1
1,692,2,0,0,0,0,42,9,1
1,546,2,1,0,0,0,19,6,1
1,505,1,1,0,0,0,30,10,1
1,425,1,0,0,0,0,48,10,1
1,374,2,0,0,0,0,32,6,1
1,270,2,0,0,0,0,6,6,1
1,207,2,0,0,7,-7,20,13,1
1,1,2,0,0,7,-7,46,4,1
2,641,1,0,0,7,-7,17,10,1
2,570,1,0,0,10,-10,25,20,1
2,477,1,1,10,0,10,38,10,1
2,287,2,1,10,0,10,23,2,1
2,253,1,0,0,10,-10,51,10,1
2,149,2,0,0,10,-10,23,10,1
2,122,1,0,0,10,-10,6,6,1
2,110,2,0,0,16,-16,31,10,1
2,95,1,1,16,0,16,54,10,1
3,891,1,1,16,0,16,45,10,1
3,716,2,0,0,16,-16,50,6,1
3,510,2,0,0,16,-16,25,5,1
3,435,2,0,0,16,-16,15,5,1
3,383,1,0,0,22,-22,43,10,1
3,356,2,0,0,22,-22,47,6,1
3,336,1,1,22,0,22,45,10,1
3,301,2,1,22,0,22,41,6,1
3,253,2,1,22,0,22,30,20,1
3,80,2,1,22,3,19,48,10,1
4,885,1,0,3,25,-22,35,10,1
4,572,2,1,25,11,14,28,10,1
4,411,1,0,11,25,-14,9,10,1
4,370,1,0,11,25,-14,21,10,1
4,345,2,0,11,25,-14,22,9,1
4,310,1,0,11,25,-14,28,10,1
4,167,2,0,11,28,-17,35,10,1
4,161,3,0,11,28,-17,42,3,1
4,139,2,0,11,28,-17,46,12,1
4,77,1,1,29,11,18,50,10,1
4,61,1,1,29,11,18,39,10,1
1,894,1,1,0,0,0,32,10,1
1,856,1,1,0,0,0,48,10,1
1,805,1,0,0,0,0,48,10,1
1,764,2,0,0,0,0,45,7,1
1,626,1,0,0,0,0,13,10,1
1,585,1,1,0,0,0,47,10,1
1,386,2,1,0,3,-3,40,5,1
1,345,1,1,0,3,-3,50,10,1
1,284,2,0,3,0,3,43,7,1
1,19,2,0,3,0,3,20,7,1
1,1,1,0,3,0,3,31,10,1
2,697,1,0,3,0,3,54,10,1
2,604,1,1,0,3,-3,29,10,1
2,534,2,1,0,3,-3,18,11,1
2,382,1,0,6,0,6,54,10,1
2,375,2,0,6,0,6,50,6,1
2,241,1,0,6,0,6,7,7,1
2,193,2,0,6,7,-1,35,8,1
2,165,1,0,6,7,-1,47,10,1
2,41,1,0,7,7,0,10,20,1
2,34,2,0,7,7,0,20,10,1
2,7,2,1,7,7,0,51,10,1
3,725,2,0,9,10,-1,19,27,1
3,585,1,0,9,10,-1,51,10,1
3,530,1,0,9,10,-1,40,10,1
3,315,2,0,9,13,-4,38,12,1
3,287,1,1,13,9,4,43,10,1
3,217,2,1,13,9,4,26,10,1
3,188,1,1,13,16,-3,42,10,1
3,1,2,0,16,13,3,39,5,1
4,887,1,0,16,13,3,30,10,1
4,871,1,0,16,20,-4,47,10,1
4,716,2,1,20,16,4,31,10,1
4,676,1,1,20,16,4,44,10,1
4,585,1,0,16,20,-4,54,10,1
4,492,2,0,16,20,-4,11,5,1
4,414,2,0,16,27,-11,41,10,1
4,338,1,1,27,16,11,30,10,1
4,206,2,0,16,27,-11,42,10,1
4,153,2,0,16,27,-11,48,8,1
4,95,3,0,16,27,-11,27,4,1
1,820,2,0,0,0,0,51,8,1
1,742,1,1,0,0,0,50,10,1
1,525,1,1,0,3,-3,47,10,1
1,481,1,0,3,0,3,45,10,1
1,427,1,0,3,0,3,33,10,1
1,387,1,0,3,0,3,20,10,1
1,236,2,0,3,3,0,40,10,1
1,78,1,1,3,3,0,42,15,1
1,58,1,1,3,3,0,26,10,1
1,1,2,1,3,3,0,25,9,1
2,900,1,1,3,3,0,14,10,1
2,851,1,1,3,3,0,2,2,1
2,795,2,1,3,10,-7,28,9,1
2,660,2,0,10,3,7,20,8,1
2,610,1,0,10,3,7,53,10,1
2,553,2,0,10,3,7,38,8,1
2,494,2,0,10,3,7,29,10,1
2,257,1,0,10,9,1,35,10,1
2,225,2,0,10,9,1,34,11,1
2,98,1,1,9,10,-1,34,10,1
2,79,2,1,9,10,-1,41,3,1
2,41,1,1,9,10,-1,35,20,1
2,33,1,0,10,9,1,43,10,1
2,23,2,0,10,9,1,35,2,1
2,8,1,0,10,9,1,28,10,1
3,884,1,1,17,10,7,52,10,1
3,856,2,0,10,17,-7,54,6,1
3,817,1,0,10,17,-7,43,10,1
3,633,1,0,10,17,-7,17,20,1
3,583,2,0,10,17,-7,21,21,1
3,503,2,0,10,20,-10,40,5,1
3,464,1,0,10,20,-10,46,10,1
3,297,1,1,20,11,9,35,10,1
3,276,2,1,20,11,9,41,4,1
3,165,1,0,11,21,-10,25,20,1
3,134,2,0,11,21,-10,29,16,1
3,68,1,1,21,11,10,34,10,1
4,900,2,1,21,11,10,40,7,1
4,814,2,1,21,11,10,13,8,1
4,756,2,1,21,11,10,34,10,1
4,658,2,1,21,11,10,52,4,1
4,534,2,1,21,18,3,24,8,1
4,371,1,0,18,21,-3,46,10,1
4,341,2,0,18,21,-3,50,6,1
4,298,1,1,21,18,3,47,10,1
4,137,2,1,21,21,0,53,5,1
4,61,1,0,21,28,-7,30,10,1
4,51,1,1,28,21,7,47,10,1
4,43,2,1,28,21,7,40,3,1
4,17,1,1,28,21,7,25,10,1
4,6,2,1,28,21,7,16,1,1
5,0,1,0,28,28,0,35,10,1
5,0,1,0,28,28,0,9,10,1
5,0,2,1,34,28,6,35,10,1
5,0,1,1,34,28,6,9,9,1
5,0,1,1,34,34,0,11,10,1
5,0,1,0,42,34,8,35,10,1
5,0,1,0,42,34,8,25,10,1
1,876,2,0,0,0,0,27,10,1
1,800,2,0,0,0,0,44,8,1
1,730,2,0,0,0,0,55,10,1
1,516,1,0,0,0,0,51,10,1
1,390,2,0,0,7,-7,21,14,1
1,330,1,0,0,7,-7,32,10,1
1,243,1,0,0,7,-7,9,9,1
1,226,1,0,0,14,-14,35,10,1
2,775,1,0,0,20,-20,53,20,1
2,740,2,0,0,20,-20,43,10,1
2,679,2,0,0,20,-20,15,10,1
2,621,1,0,0,20,-20,2,2,1
2,575,1,0,0,26,-26,33,5,1
2,378,2,0,0,29,-29,35,10,1
2,140,2,1,29,8,21,50,8,1
2,113,2,0,8,29,-21,9,9,1
2,107,1,0,8,36,-28,22,10,1
2,102,2,0,8,36,-28,30,2,1
2,89,1,0,8,36,-28,37,10,1
2,61,1,0,8,36,-28,48,10,1
2,48,3,1,36,8,28,50,10,1
2,43,1,1,36,8,28,38,10,1
3,730,1,1,36,11,25,40,10,1
3,620,2,1,36,11,25,19,3,1
3,548,2,1,36,11,25,13,10,1
3,460,1,0,14,36,-22,39,10,1
3,388,1,0,14,43,-29,38,10,1
3,280,2,1,43,14,29,35,18,1
3,110,1,1,43,14,29,37,10,1
3,80,1,1,43,14,29,23,10,1
3,35,1,1,43,14,29,12,10,1
3,5,2,1,43,14,29,11,9,1
4,777,2,1,43,14,29,26,15,1
4,717,1,1,43,17,26,35,10,1
4,691,1,1,43,17,26,54,10,1
4,494,2,0,17,43,-26,27,10,1
4,400,1,0,17,46,-29,45,10,1
4,60,2,1,46,17,29,10,10,1
1,780,2,1,0,0,0,51,12,1
1,650,2,1,0,0,0,31,7,1
1,555,2,1,0,0,0,13,5,1
1,517,1,1,0,0,0,47,10,1
1,485,2,1,0,0,0,54,3,1
1,261,1,1,3,0,3,53,10,1
1,153,1,0,0,6,-6,35,10,1
1,90,2,0,0,6,-6,54,6,1
1,51,1,1,6,0,6,30,10,1
2,900,1,1,6,0,6,22,10,1
2,789,2,1,6,3,3,38,7,1
2,586,1,0,3,12,-9,30,10,1
2,546,1,0,3,12,-9,47,10,1
2,458,1,1,12,3,9,53,10,1
2,180,1,0,10,12,-2,31,10,1
2,180,2,0,10,12,-2,30,11,1
2,147,1,1,12,10,2,18,10,1
2,121,2,1,12,10,2,24,4,1
2,119,1,1,12,10,2,29,10,1
2,91,1,1,12,10,2,47,10,1
3,893,1,0,10,19,-9,37,10,1
3,813,1,0,10,19,-9,53,10,1
3,773,1,1,19,10,9,22,10,1
3,679,2,1,19,13,6,38,7,1
3,651,1,0,13,19,-6,50,10,1
3,556,1,0,13,19,-6,7,10,1
3,535,2,0,13,19,-6,14,3,1
3,408,1,1,19,13,6,51,10,1
3,369,2,0,13,19,-6,54,5,1
3,295,2,0,13,19,-6,41,6,1
3,183,2,0,13,19,-6,33,9,1
3,91,1,0,13,22,-9,35,10,1
3,46,1,1,22,13,9,32,10,1
3,1,2,1,22,13,9,25,3,1
4,825,1,1,22,20,2,33,10,1
4,740,2,0,20,22,-2,41,4,1
4,701,1,0,20,22,-2,35,10,1
4,598,2,0,20,25,-5,35,10,1
4,433,1,1,25,20,5,40,10,1
4,342,1,0,20,25,-5,24,10,1
4,268,1,0,20,25,-5,52,10,1
4,165,2,1,25,23,2,30,15,1
1,893,1,0,0,0,0,15,10,1
1,863,2,0,0,0,0,22,3,1
1,649,2,1,0,0,0,18,6,1
1,517,1,0,0,0,0,29,10,1
1,487,1,0,0,0,0,41,10,1
1,341,1,1,0,0,0,45,10,1
1,250,1,0,7,0,7,39,10,1
1,234,1,1,0,7,-7,54,10,1
1,173,1,0,7,0,7,35,10,1
1,79,2,0,7,0,7,18,6,1
1,23,1,0,7,3,4,35,10,1
1,1,2,0,7,3,4,41,4,1
2,870,2,0,7,3,4,45,11,1
2,811,1,1,3,7,-4,37,10,1
2,767,1,1,3,7,-4,52,10,1
2,732,1,0,7,3,4,10,10,1
2,651,2,0,7,3,4,11,10,1
2,589,1,0,7,6,1,35,10,1
2,543,2,0,7,6,1,34,11,1
2,509,1,1,6,7,-1,34,10,1
2,436,1,0,7,6,1,13,10,1
2,155,2,0,7,6,1,44,20,1
2,127,1,1,6,7,-1,10,10,1
2,120,2,1,6,7,-1,10,10,1
2,89,1,1,6,7,-1,32,10,1
2,73,2,1,6,7,-1,40,2,1
2,49,2,1,6,7,-1,48,10,1
3,893,1,1,6,7,-1,34,10,1
3,842,2,1,6,7,-1,37,7,1
3,759,1,0,7,6,1,18,10,1
3,613,1,0,7,9,-2,35,10,1
3,501,2,1,9,7,2,33,5,1
3,316,2,1,9,7,2,10,10,1
3,291,1,1,9,15,-6,36,10,1
3,248,1,0,15,9,6,54,10,1
3,203,1,0,15,9,6,39,10,1
3,126,1,0,15,12,3,35,10,1
3,89,1,1,12,15,-3,44,10,1
3,41,2,1,12,15,-3,36,2,1
4,748,2,1,12,22,-10,34,10,1
4,694,1,0,22,12,10,40,10,1
4,600,1,1,12,22,-10,36,20,1
4,565,1,0,22,12,10,50,10,1
4,503,1,0,22,12,10,27,10,1
4,398,2,0,22,12,10,7,3,1
4,287,1,0,22,18,4,54,10,1
4,213,1,1,18,22,-4,20,20,1
4,135,1,1,18,29,-11,30,10,1
4,127,2,1,18,29,-11,37,3,1
4,98,1,0,29,18,11,46,10,1
4,38,2,0,29,26,3,53,15,1
5,0,1,0,32,29,3,35,10,1
5,0,2,0,32,29,3,4,4,1
1,860,2,0,0,0,0,34,5,1
1,762,2,1,0,0,0,5,14,1
1,709,1,1,0,0,0,53,10,1
1,635,1,1,0,0,0,16,10,1
1,572,2,1,0,0,0,34,7,1
1,508,2,0,0,0,0,52,9,1
1,399,1,0,0,0,0,27,10,1
1,370,1,0,0,0,0,43,10,1
1,306,2,1,0,0,0,40,10,1
1,189,2,0,0,0,0,55,9,1
1,121,2,1,0,0,0,42,10,1
1,22,2,1,0,0,0,8,8,1
2,763,1,1,0,7,-7,8,10,1
2,631,1,0,7,0,7,53,20,1
2,487,1,0,7,0,7,3,3,1
2,215,2,1,14,7,7,54,16,1
2,159,1,0,7,14,-7,6,6,1
2,154,1,0,7,21,-14,31,10,1
2,147,1,0,7,21,-14,47,10,1
2,115,2,0,7,21,-14,51,6,1
2,78,2,1,21,14,7,52,8,1
3,890,1,1,22,14,8,33,10,1
3,795,1,1,22,14,8,44,10,1
3,620,1,0,14,22,-8,36,10,1
3,460,1,0,14,22,-8,48,10,1
3,405,2,1,22,14,8,49,10,1
3,344,1,1,22,17,5,35,10,1
3,75,2,1,22,17,5,26,10,1
3,1,1,1,22,17,5,53,10,1
4,860,1,1,22,17,5,44,15,1
4,823,2,1,22,17,5,49,20,1
4,738,2,1,22,20,2,23,22,1
4,390,1,1,22,20,2,25,10,1
4,362,1,1,22,20,2,39,10,1
4,322,1,1,22,20,2,51,10,1
4,159,2,0,20,22,-2,34,10,1
4,124,1,0,20,22,-2,35,25,1
4,116,2,0,20,22,-2,30,20,1
4,87,1,0,20,25,-5,35,10,1
4,73,3,0,20,25,-5,42,2,1
1,889,1,1,0,0,0,54,10,1
1,784,1,0,0,1,-1,35,10,1
1,763,1,1,1,0,1,53,10,1
1,720,2,1,1,0,1,50,7,1
1,656,2,1,1,0,1,10,10,1
1,529,1,0,0,1,-1,23,10,1
1,394,1,1,1,0,1,50,10,1
1,319,2,1,1,0,1,41,19,1
1,277,1,0,0,1,-1,20,10,1
1,157,1,0,0,1,-1,31,10,1
1,91,2,0,0,1,-1,16,7,1
1,41,1,0,0,4,-4,35,10,1
1,5,2,0,0,4,-4,40,5,1
2,883,2,0,0,4,-4,50,10,1
2,825,1,1,4,0,4,39,10,1
2,770,1,1,4,0,4,29,10,1
2,729,2,1,4,0,4,8,4,1
2,663,1,1,4,0,4,3,3,1
2,643,1,1,4,7,-3,21,10,1
2,535,1,0,7,4,3,48,10,1
2,486,1,0,7,4,3,36,10,1
2,304,2,0,7,4,3,1,10,1
2,227,1,0,7,4,3,11,10,1
2,159,2,0,7,4,3,23,9,1
2,132,1,0,7,4,3,54,10,1
2,94,1,0,7,7,0,35,10,1
2,60,1,1,7,7,0,44,10,1
3,877,1,0,10,7,3,6,15,1
3,710,1,1,7,10,-3,23,10,1
3,612,1,1,7,10,-3,45,10,1
3,579,1,0,10,7,3,40,10,1
3,558,1,0,10,7,3,24,10,1
3,519,1,0,10,7,3,14,10,1
3,451,2,0,10,7,3,20,16,1
3,401,2,0,10,14,-4,31,10,1
3,251,2,1,14,10,4,23,10,1
3,240,1,1,14,10,4,35,10,1
3,47,2,0,10,14,-4,34,20,1
3,1,2,0,10,14,-4,52,15,1
4,869,2,1,14,10,4,36,6,1
4,768,1,1,14,13,1,35,10,1
4,738,1,1,14,13,1,52,10,1
4,579,1,0,13,14,-1,54,10,1
4,416,2,0,13,14,-1,37,4,1
4,136,2,0,13,17,-4,45,10,1
4,123,1,0,13,17,-4,10,10,1
4,117,1,0,13,17,-4,20,10,1
4,40,1,0,13,17,-4,23,10,1
1,894,1,0,0,0,0,35,10,1
1,855,2,0,0,0,0,49,10,1
1,685,2,0,2,0,2,50,3,1
1,503,2,1,0,2,-2,15,10,1
1,459,1,0,2,0,2,48,10,1
1,357,2,1,0,2,-2,26,10,1
1,45,1,0,5,0,5,50,10,1
2,900,2,0,5,0,5,55,15,1
2,785,2,1,0,5,-5,19,10,1
2,717,2,1,0,5,-5,46,10,1
2,654,1,1,0,5,-5,25,10,1
2,610,2,1,0,5,-5,38,10,1
2,560,2,1,0,5,-5,50,9,1
2,432,1,0,5,0,5,51,10,1
2,390,2,1,0,5,-5,54,5,1
2,251,1,1,0,8,-8,35,10,1
2,157,1,0,8,0,8,53,10,1
2,103,1,1,0,8,-8,27,10,1
2,94,1,1,0,8,-8,49,10,1
2,89,2,1,0,8,-8,50,9,1
2,60,1,0,8,0,8,49,10,1
2,38,1,0,8,0,8,29,10,1
2,33,1,0,8,0,8,18,10,1
2,30,2,0,8,0,8,12,4,1
3,895,1,1,3,8,-5,38,10,1
3,734,2,0,8,3,5,31,10,1
3,540,2,1,6,8,-2,26,9,1
3,396,1,1,6,11,-5,51,10,1
3,268,1,1,6,11,-5,24,10,1
3,235,2,1,6,11,-5,32,2,1
3,202,1,1,6,11,-5,35,10,1
3,116,1,1,6,11,-5,46,10,1
3,48,1,0,11,6,5,54,10,1
3,1,1,0,11,6,5,41,10,1
4,900,2,0,11,6,5,35,4,1
4,885,1,0,11,6,5,29,10,1
4,835,2,0,11,6,5,22,3,1
4,813,1,0,11,6,5,13,10,1
4,586,1,0,11,12,-1,47,10,1
4,533,2,1,12,17,-5,41,6,1
4,352,1,1,12,17,-5,54,10,1
4,250,1,1,12,20,-8,35,10,1
4,192,2,1,12,20,-8,34,5,1
4,140,1,1,12,23,-11,35,10,1
4,51,2,1,12,23,-11,10,6,1
1,740,1,0,0,0,0,45,10,1
1,610,2,1,0,0,0,8,4,1
1,502,2,1,0,0,0,5,5,1
1,331,1,0,7,0,7,16,10,1
1,248,1,0,7,0,7,26,15,1
1,1,1,0,7,0,7,40,15,1
2,900,2,0,7,0,7,43,12,1
2,817,2,1,0,8,-8,40,5,1
2,771,1,1,0,8,-8,46,10,1
2,727,2,1,0,8,-8,45,11,1
2,378,2,1,3,9,-6,35,10,1
2,330,2,1,3,9,-6,50,10,1
2,142,1,1,4,9,-5,15,10,1
2,105,1,1,4,9,-5,54,10,1
3,827,1,1,4,17,-13,25,20,1
3,723,2,1,4,17,-13,50,10,1
3,576,2,0,17,4,13,17,8,1
3,533,2,0,17,11,6,30,10,1
3,258,2,1,11,20,-9,35,10,1
3,65,1,1,11,20,-9,51,10,1
4,838,2,1,11,27,-16,21,4,1
4,798,1,1,11,27,-16,35,10,1
4,746,2,0,27,11,16,45,10,1
4,618,2,0,27,11,16,35,10,1
4,515,2,0,27,11,16,20,12,1
4,366,2,1,14,27,-13,33,10,1
4,341,1,1,14,27,-13,46,10,1
4,306,2,1,14,27,-13,51,5,1
4,282,1,0,27,14,13,41,10,1
4,99,1,1,17,27,-10,23,10,1
4,91,1,0,27,17,10,38,10,1
4,84,2,0,27,17,10,35,7,1
4,62,2,0,27,17,10,16,10,1
1,631,2,0,1,0,1,35,10,1
1,614,1,1,0,8,-8,19,10,1
1,388,1,1,0,8,-8,24,10,1
1,90,1,0,16,0,16,19,10,1
1,38,1,0,16,8,8,37,10,1
2,881,1,1,8,16,-8,47,10,1
2,841,1,0,16,8,8,43,10,1
2,630,1,0,16,16,0,35,10,1
2,200,2,1,16,16,0,44,10,1
2,142,2,0,16,16,0,11,5,1
2,123,1,0,16,16,0,19,10,1
2,101,1,0,16,16,0,33,10,1
2,89,2,0,16,16,0,39,4,1
2,72,1,0,16,16,0,49,10,1
3,888,1,0,16,16,0,33,10,1
3,731,1,1,16,16,0,44,10,1
3,598,1,0,16,16,0,44,10,1
3,582,2,0,16,16,0,46,8,1
3,374,2,1,16,16,0,54,4,1
3,219,1,0,16,16,0,19,10,1
3,93,2,0,16,23,-7,35,4,1
3,16,1,0,16,23,-7,31,20,1
4,892,1,1,23,22,1,26,10,1
4,805,1,0,22,23,-1,48,10,1
4,775,2,0,22,23,-1,46,12,1
4,685,2,0,22,23,-1,41,27,1
4,478,2,1,23,22,1,44,6,1
4,389,1,1,23,25,-2,25,20,1
4,267,2,1,23,25,-2,49,8,1
4,134,1,0,25,26,-1,35,10,1
4,129,2,0,25,26,-1,42,3,1
4,105,1,1,26,25,1,51,10,1
1,880,2,1,0,0,0,27,10,1
1,603,2,0,0,0,0,39,8,1
1,570,1,0,0,0,0,55,10,1
1,506,1,1,0,0,0,33,10,1
1,439,2,1,0,8,-8,15,17,1
1,269,2,1,0,11,-11,35,10,1
1,240,1,1,0,11,-11,46,10,1
1,175,2,1,0,11,-11,46,20,1
1,121,2,0,11,0,11,37,10,1
1,19,2,0,11,0,11,24,11,1
2,875,2,0,11,8,3,36,10,1
2,755,2,1,8,11,-3,29,6,1
2,678,1,1,8,19,-11,36,10,1
2,435,1,0,19,8,11,30,20,1
2,410,2,0,19,8,11,26,16,1
2,260,1,1,11,19,-8,46,10,1
2,246,1,0,19,11,8,51,10,1
2,210,1,0,19,11,8,16,10,1
2,146,2,0,19,11,8,6,6,1
2,127,2,0,19,17,2,29,10,1
2,55,1,0,19,17,2,26,10,1
3,835,2,0,19,17,2,23,20,1
3,600,1,1,17,19,-2,33,10,1
3,595,2,1,17,19,-2,25,2,1
3,490,2,1,17,22,-5,35,10,1
3,446,1,0,22,17,5,40,10,1
3,355,2,0,22,20,2,37,8,1
3,295,1,0,22,20,2,49,10,1
3,118,2,1,20,23,-3,34,11,1
3,35,2,1,20,23,-3,42,14,1
3,13,1,0,23,20,3,54,10,1
4,675,2,0,23,20,3,45,9,1
4,548,1,1,20,23,-3,21,10,1
4,490,2,1,20,23,-3,26,5,1
4,441,2,0,23,26,-3,24,10,1
4,410,1,0,23,26,-3,34,10,1
4,360,1,0,23,26,-3,47,10,1
4,293,2,1,26,23,3,47,10,1
4,232,1,1,26,26,0,35,10,1
4,205,2,1,26,26,0,40,5,1
4,168,2,1,26,26,0,46,12,1
4,144,1,0,26,26,0,48,10,1
4,127,1,0,26,26,0,36,10,1
4,63,1,0,26,26,0,10,10,1
4,54,1,0,26,26,0,30,10,1
4,37,1,0,26,26,0,40,10,1
1,871,2,1,0,0,0,24,10,1
1,802,1,0,0,0,0,35,10,1
1,700,1,1,0,0,0,54,10,1
1,558,2,1,0,0,0,55,12,1
1,506,2,0,0,0,0,32,7,1
1,468,1,0,0,0,0,23,10,1
1,283,1,1,7,0,7,55,10,1
1,245,1,0,0,7,-7,32,10,1
1,199,2,0,0,7,-7,25,3,1
1,177,1,0,0,14,-14,32,10,1
1,140,2,0,0,14,-14,26,16,1
1,68,1,0,0,14,-14,48,10,1
1,14,2,0,0,14,-14,30,5,1
2,900,1,0,0,14,-14,12,10,1
2,641,1,1,21,0,21,54,10,1
2,597,1,1,21,7,14,24,15,1
2,307,2,1,21,7,14,29,10,1
2,149,1,1,21,7,14,50,10,1
2,100,1,0,7,21,-14,31,10,1
2,85,2,0,7,21,-14,35,6,1
3,894,1,0,7,21,-14,28,10,1
3,850,2,0,7,21,-14,34,4,1
3,808,1,1,21,7,14,44,10,1
3,584,2,0,10,21,-11,30,10,1
3,458,2,1,21,10,11,55,10,1
3,388,1,0,10,21,-11,49,10,1
3,367,2,0,10,21,-11,55,4,1
3,323,1,1,21,10,11,23,10,1
3,300,1,1,21,10,11,11,10,1
3,207,1,1,21,18,3,15,10,1
3,135,1,0,18,21,-3,36,10,1
3,58,1,0,18,21,-3,47,10,1
3,35,2,0,18,21,-3,50,7,1
4,883,1,1,21,18,3,43,10,1
4,801,2,1,21,18,3,44,25,1
4,649,2,0,21,21,0,13,26,1
4,565,2,0,21,21,0,54,5,1
4,445,2,0,21,21,0,35,12,1
4,357,2,0,21,24,-3,35,10,1
4,303,1,1,24,21,3,29,10,1
4,211,1,1,24,21,3,5,5,1
4,142,1,0,27,27,0,35,10,1
4,128,1,1,27,27,0,44,10,1
4,121,2,1,27,27,0,38,4,1
4,46,1,1,27,30,-3,35,10,1
1,895,1,1,0,0,0,30,10,1
1,717,1,1,0,0,0,42,10,1
1,686,2,1,0,0,0,48,4,1
1,635,2,0,0,0,0,39,9,1
1,575,2,0,0,0,0,43,24,1
1,493,2,0,0,0,0,6,10,1
1,453,1,0,0,0,0,16,10,1
1,321,1,0,0,1,-1,35,10,1
1,75,1,1,1,3,-2,30,10,1
2,900,1,0,3,1,2,52,10,1
2,804,2,1,1,3,-2,26,7,1
2,695,2,0,3,1,2,35,8,1
2,598,1,0,3,4,-1,23,10,1
2,533,2,0,3,4,-1,35,10,1
2,417,2,1,4,3,1,23,10,1
2,349,2,0,3,4,-1,29,10,1
2,262,2,1,4,3,1,31,11,1
2,155,1,1,4,3,1,39,10,1
2,22,1,1,4,3,1,38,10,1
3,769,1,1,4,3,1,7,10,1
3,757,1,1,4,3,1,26,10,1
3,742,2,1,4,3,1,33,3,1
3,670,2,1,4,3,1,34,15,1
3,360,2,0,3,11,-8,47,2,1
3,262,2,0,3,11,-8,54,6,1
3,184,2,0,3,11,-8,47,12,1
3,131,1,0,3,11,-8,25,10,1
3,53,2,0,3,18,-15,28,16,1
4,523,2,0,3,18,-15,15,8,1
4,415,3,1,25,3,22,44,10,1
4,290,2,0,3,25,-22,12,12,1
4,155,1,0,3,32,-29,21,10,1
4,149,2,0,3,32,-29,27,4,1
4,135,1,0,3,32,-29,32,10,1
4,118,2,0,3,32,-29,37,5,1
4,107,1,0,3,32,-29,42,10,1
1,839,1,0,0,0,0,53,10,1
1,723,1,1,0,0,0,55,5,1
1,658,2,0,0,0,0,47,7,1
1,588,1,0,0,0,0,36,10,1
1,455,1,0,0,3,-3,52,10,1
1,375,1,1,3,0,3,42,10,1
1,327,2,1,3,7,-4,8,7,1
1,301,1,1,3,7,-4,21,10,1
1,240,2,1,3,7,-4,32,10,1
1,76,1,0,7,3,4,38,10,1
1,1,1,1,3,7,-4,45,20,1
2,806,2,1,3,10,-7,36,9,1
2,751,2,1,3,10,-7,52,10,1
2,725,1,0,10,3,7,40,10,1
2,685,2,0,10,3,7,36,6,1
2,560,1,0,10,6,4,35,10,1
2,481,2,0,10,6,4,51,7,1
2,455,1,1,6,10,-4,49,10,1
2,420,2,1,6,10,-4,49,10,1
2,286,2,1,6,11,-5,41,4,1
2,69,1,1,6,14,-8,46,10,1
2,48,2,0,14,6,8,49,10,1
2,42,1,0,14,6,8,38,10,1
2,25,2,0,14,6,8,30,2,1
2,13,1,0,14,6,8,19,10,1
3,863,1,1,14,14,0,44,10,1
3,829,2,0,14,14,0,51,10,1
3,803,1,0,14,14,0,25,10,1
3,778,2,0,14,14,0,19,4,1
3,651,1,0,14,21,-7,15,10,1
3,456,1,1,21,17,4,35,10,1
3,265,2,0,17,21,-4,23,15,1
3,121,2,1,21,17,4,48,7,1
4,720,1,0,20,21,-1,44,10,1
4,705,1,0,20,21,-1,54,10,1
4,612,2,1,21,20,1,38,11,1
4,462,2,1,21,20,1,18,15,1
4,357,2,1,21,28,-7,26,5,1
4,259,1,0,28,21,7,48,10,1
4,196,2,1,21,28,-7,36,6,1
4,77,2,1,21,31,-10,39,6,1
1,853,2,1,0,0,0,23,6,1
1,828,1,1,0,0,0,31,10,1
1,635,2,0,0,0,0,22,7,1
1,536,1,1,7,0,7,46,10,1
1,297,1,0,3,7,-4,12,10,1
1,225,1,0,3,7,-4,47,10,1
1,155,1,0,3,7,-4,32,20,1
1,66,1,0,3,7,-4,25,10,1
2,826,1,1,7,6,1,30,15,1
2,775,2,1,7,6,1,46,11,1
2,512,1,0,6,7,-1,4,14,1
2,480,2,0,6,7,-1,10,8,1
2,181,1,1,7,6,1,35,10,1
2,163,2,1,7,6,1,28,3,1
2,120,1,1,7,6,1,24,10,1
2,62,1,0,13,7,6,34,20,1
2,15,1,0,13,7,6,40,10,1
3,856,2,0,14,10,4,36,8,1
3,765,1,1,10,14,-4,46,20,1
3,726,2,1,10,14,-4,45,19,1
3,515,2,0,15,10,5,5,9,1
3,402,1,1,10,15,-5,36,10,1
3,225,2,1,10,15,-5,46,10,1
3,155,2,1,10,15,-5,25,17,1
3,98,1,1,10,15,-5,25,10,1
4,869,1,1,10,18,-8,35,10,1
4,620,2,1,10,18,-8,25,10,1
4,503,1,0,18,13,5,35,10,1
4,465,1,0,18,13,5,53,10,1
4,398,1,1,13,18,-5,46,10,1
4,254,2,1,13,18,-5,8,7,1
4,80,1,1,13,18,-5,32,20,1
1,767,3,1,0,0,0,54,10,7
1,727,3,0,0,0,0,12,10,7
1,578,3,0,0,0,0,20,1,7
2,731,3,1,3,7,-4,34,6,7
2,447,3,0,7,3,4,51,11,7
2,196,3,1,3,7,-4,21,10,7
2,147,3,1,3,7,-4,50,5,7
2,74,3,1,3,14,-11,50,5,7
4,534,3,0,24,6,18,50,5,7
4,254,3,0,24,6,18,44,3,7
4,70,3,1,6,24,-18,44,22,7
1,588,3,1,7,0,7,40,20,7
1,230,3,1,7,3,4,44,4,7
2,760,3,1,7,6,1,47,10,7
2,460,3,1,7,16,-9,34,9,7
2,376,3,0,16,7,9,46,7,7
2,125,3,0,16,7,9,43,10,7
2,55,3,0,16,10,6,44,1,7
3,696,3,0,23,10,13,49,10,7
3,514,3,1,12,23,-11,35,15,7
3,426,3,1,12,23,-11,45,10,7
3,361,3,1,12,23,-11,14,5,7
3,84,3,0,26,12,14,55,8,7
4,150,3,1,26,33,-7,48,10,7
4,59,3,1,26,33,-7,53,25,7
1,842,3,1,0,0,0,50,8,7
1,425,3,1,7,0,7,49,4,7
1,225,3,1,7,0,7,28,13,7
1,152,3,0,0,7,-7,50,3,7
1,10,3,1,7,0,7,46,16,7
2,741,3,1,7,0,7,46,3,7
2,340,3,0,7,14,-7,48,5,7
2,150,3,1,14,7,7,47,10,7
3,818,3,0,9,14,-5,38,4,7
1,670,3,1,0,0,0,55,16,7
1,437,3,1,0,3,-3,40,1,7
1,305,3,1,0,3,-3,42,15,7
1,100,3,0,3,7,-4,43,8,7
2,516,3,1,7,11,-4,33,12,7
2,297,3,0,11,7,4,52,19,7
2,88,3,1,14,11,3,30,1,7
2,51,3,0,11,14,-3,45,2,7
3,844,3,0,11,14,-3,40,7,7
3,686,2,1,14,11,3,39,11,7
3,550,3,0,11,14,-3,38,21,7
4,834,3,1,21,14,7,44,15,7
4,768,3,1,21,14,7,27,5,7
4,559,3,1,21,17,4,35,10,7
4,377,3,0,17,21,-4,40,4,7
1,835,3,0,0,0,0,21,5,7
1,754,3,1,0,0,0,55,5,7
1,602,3,0,0,0,0,31,12,7
1,524,3,1,0,0,0,43,6,7
1,426,3,0,0,0,0,55,3,7
2,725,3,1,7,3,4,28,17,7
2,428,3,0,10,7,3,47,8,7
2,264,3,1,7,10,-3,44,2,7
3,489,3,0,18,21,-3,28,22,7
3,220,3,0,18,24,-6,46,10,7
4,536,3,1,31,25,6,48,10,7
4,59,3,0,25,48,-23,36,13,7
1,833,3,1,0,0,0,37,7,7
1,715,3,1,0,0,0,48,10,7
1,511,3,0,0,0,0,37,4,7
1,204,3,1,3,0,3,50,10,7
2,595,3,0,7,10,-3,33,13,7
2,26,3,1,17,14,3,26,26,7
3,836,3,0,17,17,0,43,8,7
3,761,3,1,17,17,0,27,4,7
3,538,3,1,17,17,0,46,8,7
3,461,3,1,17,17,0,12,1,7
3,212,3,1,17,20,-3,29,16,7
3,11,3,1,17,23,-6,32,13,7
4,584,3,0,26,20,6,28,17,7
4,391,3,1,20,26,-6,55,23,7
4,303,3,0,26,20,6,18,16,7
1,603,3,0,0,7,-7,14,7,7
1,393,3,0,0,10,-10,38,19,7
1,290,3,1,10,0,10,22,17,7
1,108,3,0,0,17,-17,29,7,7
2,862,3,0,0,17,-17,51,5,7
2,730,3,0,0,17,-17,30,20,7
2,645,3,1,17,0,17,45,20,7
2,428,3,1,17,0,17,45,1,7
2,130,3,0,7,17,-10,48,9,7
2,96,3,1,17,7,10,35,17,7
2,14,3,0,7,17,-10,53,10,7
3,474,3,0,7,23,-16,43,2,7
4,819,3,0,7,30,-23,40,5,7
4,77,3,1,37,34,3,40,8,7
1,683,3,0,0,1,-1,29,16,7
1,395,3,0,0,1,-1,24,13,7
1,72,3,1,8,0,8,23,3,7
2,110,3,0,10,8,2,37,17,7
2,71,3,1,8,17,-9,24,3,7
2,47,3,0,17,8,9,48,5,7
2,30,3,1,8,17,-9,26,10,7
3,483,3,0,17,8,9,54,6,7
3,282,3,0,17,8,9,46,6,7
4,742,3,1,8,20,-12,17,10,7
4,693,3,0,20,8,12,36,20,7
4,472,3,0,20,9,11,50,5,7
4,301,3,1,9,20,-11,40,8,7
4,17,3,1,9,20,-11,27,10,7
1,864,3,0,0,0,0,38,7,7
1,811,3,1,0,0,0,37,10,7
1,740,3,0,0,0,0,38,2,7
1,678,3,1,0,0,0,36,6,7
1,537,3,0,0,0,0,31,8,7
1,420,3,0,0,0,0,43,8,7
1,285,2,1,2,0,2,47,10,7
2,881,3,1,2,7,-5,43,10,7
2,795,3,0,7,2,5,20,18,7
2,582,3,0,7,9,-2,32,5,7
2,515,3,1,9,7,2,37,5,7
2,147,3,0,10,9,1,16,10,7
2,87,3,0,10,9,1,47,10,7
2,63,3,1,9,10,-1,25,5,7
2,23,3,0,10,9,1,39,5,7
3,482,3,1,10,17,-7,18,10,7
3,123,3,0,17,17,0,46,5,7
3,30,3,1,17,17,0,39,11,7
4,525,3,1,17,17,0,39,27,7
4,118,3,0,20,24,-4,34,7,7
1,812,3,1,0,0,0,24,39,7
1,437,3,0,7,0,7,26,13,7
1,285,3,0,7,0,7,52,4,7
2,900,3,0,7,0,7,35,25,7
2,744,3,0,7,0,7,28,5,7
2,224,3,1,8,10,-2,50,18,7
2,79,3,0,10,9,1,43,2,7
3,826,3,0,10,9,1,35,3,7
3,742,3,1,9,10,-1,37,2,7
3,371,3,0,13,9,4,50,3,7
3,235,3,1,9,13,-4,41,10,7
4,292,3,1,12,19,-7,35,10,7
1,832,3,0,0,0,0,45,6,7
1,473,3,0,0,3,-3,32,7,7
1,203,3,1,3,0,3,44,12,7
2,658,3,0,5,10,-5,32,10,7
2,509,3,0,5,10,-5,25,3,7
2,147,3,1,17,5,12,18,1,7
2,91,3,1,17,5,12,50,2,7
2,50,3,1,17,5,12,19,8,7
3,411,3,0,8,34,-26,40,2,7
3,359,3,1,34,8,26,30,10,7
3,267,3,0,8,34,-26,44,5,7
4,358,3,0,22,34,-12,11,13,7
4,37,3,1,37,29,8,37,6,7
1,609,3,1,7,1,6,35,10,7
1,511,3,0,1,7,-6,32,16,7
2,704,3,0,2,13,-11,44,1,7
2,558,3,1,13,2,11,24,11,7
2,461,3,0,2,13,-11,35,30,7
2,395,3,1,13,2,11,49,4,7
2,104,3,1,13,5,8,42,10,7
2,85,3,0,5,13,-8,35,10,7
3,816,3,0,5,16,-11,39,15,7
3,586,3,1,16,8,8,39,6,7
3,166,3,1,23,21,2,35,10,7
4,819,3,0,28,30,-2,54,2,7
4,721,3,1,30,28,2,30,13,7
1,805,3,0,0,0,0,45,4,7
1,215,3,0,0,7,-7,46,5,7
1,0,3,0,0,7,-7,30,15,7
2,821,3,0,0,14,-14,25,11,7
2,736,3,0,0,14,-14,48,4,7
2,379,3,0,0,14,-14,10,6,7
2,130,3,1,21,0,21,50,10,7
3,123,3,0,0,44,-44,38,7,7
3,40,3,1,44,0,44,40,14,7
4,678,3,1,44,0,44,18,2,7
4,535,3,1,44,0,44,13,4,7
4,90,3,0,0,52,-52,45,10,7
1,226,3,1,7,3,4,4,7,7
2,811,3,1,7,6,1,33,12,7
2,585,3,1,7,9,-2,28,17,7
2,502,3,0,9,7,2,46,5,7
2,422,3,1,7,9,-2,31,11,7
2,318,3,0,9,7,2,34,19,7
3,838,3,0,12,10,2,38,6,7
3,422,3,1,17,13,4,35,10,7
3,352,3,0,13,17,-4,48,12,7
3,159,3,1,17,13,4,55,12,7
4,719,3,1,24,13,11,50,8,7
4,326,3,1,25,13,12,50,15,7
4,242,3,1,25,13,12,8,15,7
1,644,3,0,0,7,-7,38,6,7
1,515,3,1,7,0,7,43,4,7
2,900,3,1,7,10,-3,41,11,7
2,832,3,0,10,7,3,25,6,7
2,724,3,1,7,10,-3,27,24,7
2,683,3,0,10,7,3,45,10,7
2,606,3,1,7,10,-3,23,6,7
2,335,3,0,11,7,4,43,6,7
2,230,3,1,7,11,-4,28,10,7
2,63,3,1,7,14,-7,54,5,7
2,17,3,1,7,14,-7,26,25,7
3,786,3,1,7,14,-7,55,7,7
3,403,3,0,14,16,-2,22,24,7
4,528,3,0,21,23,-2,37,21,7
4,128,3,1,23,24,-1,30,15,7
1,282,3,0,8,3,5,50,3,7
1,196,3,0,8,3,5,8,3,7
2,900,3,0,8,6,2,47,10,7
2,390,3,0,8,13,-5,50,10,7
2,232,3,1,13,8,5,48,11,7
3,842,3,1,13,15,-2,31,4,7
4,742,3,0,22,19,3,43,1,7
4,662,3,1,19,22,-3,35,8,7
4,364,3,1,19,22,-3,17,2,7
1,840,3,0,0,0,0,40,5,7
1,275,3,0,0,8,-8,51,9,7
2,885,3,1,8,7,1,55,11,7
2,506,3,1,8,14,-6,36,6,7
2,152,3,1,8,14,-6,43,18,7
2,109,3,0,14,8,6,33,5,7
3,124,3,0,20,15,5,52,10,7
4,900,3,0,20,15,5,51,2,7
4,753,3,1,15,20,-5,37,15,7
4,455,3,0,27,22,5,44,11,7
4,141,3,0,27,22,5,2,13,7
4,85,3,0,27,22,5,54,4,7
1,475,3,0,0,7,-7,15,18,7
2,793,3,1,17,0,17,37,8,7
2,626,3,0,0,17,-17,48,13,7
2,305,3,0,0,17,-17,43,18,7
2,232,3,1,17,0,17,17,10,7
2,34,3,0,3,24,-21,31,5,7
2,9,3,1,24,3,21,53,3,7
3,654,3,1,24,3,21,24,1,7
4,515,3,1,25,7,18,41,4,7
4,414,3,0,7,25,-18,44,13,7
4,359,3,1,25,7,18,18,4,7
1,856,3,0,0,0,0,41,10,7
1,610,3,1,0,7,-7,38,3,7
1,306,3,0,14,3,11,48,18,7
1,240,3,1,3,14,-11,35,1,7
2,768,3,1,11,14,-3,54,5,7
3,713,3,0,23,20,3,31,8,7
3,631,3,0,23,27,-4,26,19,7
4,900,3,0,24,33,-9,53,7,7
4,767,3,1,33,24,9,53,10,7
4,680,3,1,33,24,9,3,11,7
4,527,3,1,33,31,2,41,2,7
4,199,3,1,33,34,-1,39,6,7
1,237,3,0,11,0,11,50,8,7
1,158,3,0,11,0,11,7,13,7
2,681,3,1,3,11,-8,20,10,7
2,611,3,0,11,3,8,25,23,7
3,782,3,0,12,20,-8,32,5,7
3,433,3,0,12,23,-11,20,25,7
3,195,3,0,12,23,-11,52,15,7
4,810,3,1,23,15,8,30,15,7
4,331,3,1,23,30,-7,37,20,7
1,196,3,1,8,14,-6,39,10,7
2,394,3,0,24,22,2,34,5,7
4,766,3,1,32,34,-2,46,3,7
4,617,3,1,32,34,-2,55,5,7
4,491,3,0,34,32,2,40,10,7
4,39,3,1,39,34,5,42,7,7
1,845,3,0,0,0,0,42,5,7
1,208,3,1,5,0,5,30,9,7
2,94,3,1,15,0,15,49,4,7
3,795,3,0,0,15,-15,26,11,7
3,727,3,1,15,0,15,42,10,7
3,508,3,0,0,15,-15,35,14,7
3,95,3,1,15,7,8,46,5,7
1,384,3,1,7,0,7,50,4,7
1,25,3,0,0,16,-16,46,3,7
2,289,3,0,6,23,-17,23,4,7
2,51,3,0,6,31,-25,53,10,7
3,504,3,1,31,21,10,40,5,7
3,412,3,0,21,31,-10,38,1,7
3,2,3,0,21,38,-17,55,16,7
4,855,3,1,38,21,17,37,6,7
1,410,3,1,7,0,7,54,2,7
1,315,3,1,7,0,7,40,5,7
1,98,3,0,0,14,-14,24,2,7
2,137,3,1,20,4,16,44,1,7
3,765,3,0,11,27,-16,40,7,7
3,672,3,1,27,11,16,40,8,7
3,508,3,0,11,27,-16,55,19,7
3,60,3,1,27,14,13,25,20,7
4,599,3,1,27,17,10,20,4,7
4,122,3,0,24,27,-3,23,10,7
4,84,3,0,24,27,-3,52,2,7
1,395,3,1,0,7,-7,52,3,7
2,900,3,1,0,14,-14,23,3,7
2,732,3,1,0,14,-14,24,5,7
2,410,3,0,15,1,14,38,7,7
2,209,3,0,15,1,14,48,12,7
2,83,3,1,1,15,-14,29,18,7
2,46,3,1,1,15,-14,52,9,7
3,822,3,1,1,22,-21,12,8,7
3,391,3,0,36,4,32,27,4,7
4,572,3,0,39,6,33,33,23,7
4,172,3,0,39,12,27,24,3,7
4,60,3,0,39,15,24,39,6,7
1,721,3,1,0,0,0,46,9,7
2,673,3,1,3,7,-4,35,4,7
2,249,3,0,8,3,5,32,15,7
2,14,3,1,3,8,-5,37,16,7
3,811,3,1,3,8,-5,29,12,7
3,600,3,1,3,8,-5,48,13,7
3,533,3,0,8,3,5,23,10,7
3,448,3,1,3,8,-5,43,13,7
3,355,3,0,8,3,5,40,1,7
3,298,3,1,3,8,-5,15,18,7
3,33,3,0,8,4,4,31,14,7
4,873,3,1,4,8,-4,34,15,7
4,562,3,0,9,4,5,20,10,7
4,273,3,1,4,16,-12,33,17,7
4,213,3,0,16,4,12,45,6,7
4,88,3,0,16,11,5,53,11,7
1,835,3,0,0,0,0,38,8,7
1,501,3,0,0,0,0,21,4,7
1,294,3,0,0,7,-7,42,1,7
2,700,3,0,0,10,-10,34,6,7
2,62,3,0,3,14,-11,47,10,7
2,38,3,1,14,3,11,21,10,7
2,3,3,1,14,3,11,50,4,7
3,820,3,1,14,3,11,22,15,7
3,733,3,0,3,14,-11,43,15,7
3,215,3,0,3,17,-14,50,9,7
1,207,3,1,3,7,-4,9,10,7
2,751,3,0,14,3,11,49,3,7
2,663,3,0,14,3,11,14,2,7
3,639,3,0,21,17,4,36,1,7
3,192,3,0,21,20,1,48,7,7
4,705,3,0,21,28,-7,39,4,7
2,702,3,1,7,16,-9,24,8,7
2,210,3,0,16,10,6,52,7,7
2,164,3,0,16,10,6,16,8,7
3,357,3,1,13,23,-10,38,10,7
3,282,3,0,23,13,10,42,2,7
4,900,3,1,13,23,-10,41,10,7
4,272,3,0,30,20,10,50,5,7
4,119,3,0,30,20,10,48,6,7
2,568,3,0,7,10,-3,38,13,7
2,114,3,1,10,10,0,43,5,7
2,48,3,0,10,10,0,32,13,7
3,549,3,1,13,16,-3,31,21,7
3,97,3,0,19,13,6,49,9,7
4,565,3,0,19,22,-3,25,12,7
4,311,3,0,19,25,-6,30,15,7
1,564,3,0,0,3,-3,51,8,7
2,822,3,0,7,11,-4,44,13,7
2,726,3,1,11,7,4,35,7,7
2,378,3,1,11,14,-3,29,3,7
2,94,3,0,14,11,3,39,10,7
2,71,3,1,11,14,-3,32,12,7
3,530,3,1,14,22,-8,47,8,7
3,241,3,0,29,14,15,52,6,7
4,509,3,0,32,21,11,40,5,7
4,459,3,1,21,32,-11,29,10,7
1,847,3,1,0,0,0,19,18,7
1,781,3,1,0,0,0,53,10,7
2,813,3,1,11,8,3,42,3,7
2,180,3,1,18,15,3,53,5,7
4,900,3,0,25,25,0,43,7,7
4,727,3,0,25,25,0,29,17,7
4,227,3,0,32,26,6,40,5,7
4,135,3,1,26,32,-6,33,14,7
1,850,3,0,0,0,0,39,10,7
1,261,3,1,7,0,7,40,10,7
2,900,3,1,7,3,4,43,2,7
2,543,3,1,7,6,1,39,6,7
2,59,3,0,13,7,6,52,16,7
3,831,3,1,7,13,-6,42,5,7
4,886,3,1,7,19,-12,52,4,7
4,167,3,0,19,14,5,33,9,7
1,346,3,1,7,15,-8,44,11,7
1,58,3,0,15,7,8,21,11,7
1,1,3,1,7,15,-8,55,10,7
2,631,3,1,7,15,-8,29,7,7
2,173,3,1,7,25,-18,24,11,7
2,48,3,0,33,14,19,43,4,7
3,830,3,0,33,14,19,44,5,7
3,549,3,1,14,40,-26,34,10,7
3,474,3,0,40,14,26,40,11,7
4,891,3,1,14,47,-33,8,15,7
4,741,3,1,14,47,-33,43,18,7
4,540,3,1,14,50,-36,36,9,7
4,187,3,1,17,50,-33,9,6,7
1,617,3,0,0,7,-7,39,15,7
2,660,3,1,9,6,3,36,12,7
2,319,3,1,9,6,3,38,16,7
3,675,3,0,13,14,-1,28,17,7
3,579,3,1,14,13,1,55,10,7
3,517,3,0,13,14,-1,19,10,7
3,80,3,0,13,17,-4,47,10,7
4,139,3,1,25,20,5,45,10,7
4,105,3,0,20,25,-5,26,20,7
1,841,3,1,0,0,0,50,11,7
1,752,3,0,0,0,0,32,1,7
1,673,3,1,0,0,0,35,6,7
1,91,3,0,0,3,-3,47,6,7
2,734,3,1,3,0,3,53,15,7
2,550,3,1,3,0,3,52,14,7
2,318,3,1,3,0,3,50,12,7
3,119,3,1,3,15,-12,53,7,7
4,840,3,1,3,15,-12,41,12,7
4,597,3,1,3,15,-12,49,3,7
4,206,3,0,17,3,14,35,10,7
4,86,3,0,17,3,14,25,7,7
1,606,3,0,0,0,0,50,13,7
1,184,3,0,0,1,-1,29,16,7
2,533,3,1,1,14,-13,47,14,7
2,311,3,0,14,1,13,49,13,7
2,215,3,1,1,14,-13,40,4,7
3,830,3,0,17,4,13,31,7,7
3,765,3,1,4,17,-13,49,8,7
4,651,3,0,34,11,23,30,1,7
4,132,3,0,35,11,24,52,5,7
2,803,3,0,7,6,1,41,2,7
2,710,3,1,6,7,-1,41,4,7
2,586,3,0,7,6,1,44,3,7
2,378,3,1,6,14,-8,28,10,7
2,170,3,1,6,14,-8,28,3,7
2,50,3,1,6,21,-15,28,2,7
3,170,3,1,6,31,-25,36,9,7
1,712,3,0,0,0,0,51,6,7
2,575,3,1,1,3,-2,40,8,7
2,465,3,0,3,1,2,28,22,7
2,170,3,1,1,3,-2,55,8,7
2,129,3,0,3,1,2,32,7,7
2,75,3,1,1,3,-2,45,16,7
2,36,3,0,3,1,2,18,15,7
3,502,3,0,4,4,0,19,7,7
4,313,3,0,12,14,-2,43,10,7
4,122,3,0,12,17,-5,39,6,7
4,95,3,1,17,12,5,41,6,7
1,835,3,0,0,0,0,37,9,7
1,763,3,1,0,0,0,38,7,7
1,303,3,1,0,10,-10,43,2,7
1,104,3,1,0,17,-17,13,15,7
2,130,3,0,24,10,14,30,2,7
3,812,3,1,19,24,-5,43,13,7
3,482,3,0,24,22,2,51,10,7
4,198,3,0,27,38,-11,30,10,7
4,152,3,1,38,27,11,46,6,7
1,244,3,1,0,3,-3,28,19,7
1,172,3,0,3,0,3,43,6,7
2,720,3,0,3,3,0,30,15,7
2,89,3,0,10,10,0,45,2,7
3,577,3,0,10,17,-7,25,16,7
4,703,3,1,24,13,11,53,2,7
4,324,3,1,24,14,10,54,4,7
1,542,2,1,0,3,-3,53,8,7
1,469,3,0,3,0,3,26,9,7
1,278,3,0,3,0,3,40,6,7
1,223,3,0,3,0,3,9,10,7
1,158,3,0,3,0,3,49,8,7
1,70,3,0,3,0,3,32,9,7
2,823,3,0,3,1,2,27,18,7
2,699,3,0,3,1,2,51,9,7
2,41,3,0,6,2,4,17,17,7
3,856,3,0,6,9,-3,28,10,7
3,80,3,1,12,21,-9,47,10,7
3,1,2,0,21,12,9,20,3,7
4,770,2,0,21,12,9,26,9,7
4,500,3,1,15,21,-6,54,8,7
4,342,3,1,15,21,-6,30,6,7
4,258,3,0,21,15,6,35,18,7
4,179,3,1,15,21,-6,41,6,7
4,107,3,0,21,15,6,47,10,7
1,804,3,0,0,0,0,21,10,7
1,503,3,0,0,0,0,35,1,7
2,159,3,0,0,13,-13,39,18,7
2,118,3,1,13,0,13,46,10,7
2,65,3,0,0,13,-13,34,5,7
3,807,3,0,0,16,-16,32,1,7
3,716,3,0,0,16,-16,22,11,7
3,617,3,1,16,0,16,54,22,7
3,546,3,1,16,0,16,24,5,7
3,271,3,0,0,16,-16,55,20,7
4,603,3,0,0,30,-30,36,10,7
4,213,3,0,0,37,-37,46,4,7
1,839,3,1,0,0,0,50,3,7
1,357,3,1,3,3,0,39,17,7
2,717,3,1,10,3,7,40,7,7
2,206,3,0,6,13,-7,27,3,7
3,736,3,0,6,20,-14,42,32,7
3,621,3,1,20,6,14,34,4,7
3,542,3,1,20,13,7,26,8,7
3,463,3,0,13,20,-7,51,9,7
3,162,3,0,13,23,-10,41,4,7
4,473,3,0,27,26,1,45,10,7
1,400,3,0,1,0,1,54,3,7
2,813,3,0,8,7,1,21,28,7
2,609,3,0,8,14,-6,42,6,7
2,545,3,1,14,8,6,30,10,7
2,384,3,1,14,11,3,43,2,7
2,53,3,1,14,14,0,30,15,7
4,52,3,1,24,37,-13,44,9,7
1,642,3,0,0,3,-3,17,6,7
1,383,3,0,0,10,-10,50,9,7
1,316,3,1,10,0,10,9,21,7
1,43,3,1,10,3,7,45,7,7
2,197,3,1,17,19,-2,27,19,7
2,110,3,1,17,26,-9,38,1,7
2,69,3,0,26,17,9,32,11,7
3,839,3,0,26,17,9,28,19,7
3,567,3,1,17,29,-12,50,10,7
3,383,3,0,29,17,12,53,10,7
4,246,3,1,20,32,-12,47,15,7
1,755,3,0,0,0,0,46,20,7
2,118,3,1,14,6,8,54,16,7
2,55,3,1,14,6,8,28,6,7
3,821,3,1,14,6,8,37,9,7
4,238,3,0,12,24,-12,50,5,7
1,848,3,0,0,0,0,36,10,7
1,464,3,1,1,0,1,45,3,7
1,395,3,1,1,0,1,12,10,7
2,161,3,0,1,15,-14,35,10,7
2,15,3,1,15,1,14,52,10,7
3,860,3,1,15,1,14,39,10,7
3,242,3,0,4,22,-18,53,10,7
3,144,3,0,4,22,-18,19,4,7
4,526,3,1,22,19,3,39,17,7
4,165,3,1,22,27,-5,22,10,7
2,900,3,0,3,3,0,47,18,7
2,314,3,1,6,10,-4,46,4,7
2,15,3,0,17,6,11,46,4,7
3,559,3,1,8,17,-9,34,10,7
4,675,3,1,15,27,-12,44,8,7
4,502,3,0,27,15,12,55,3,7
4,26,3,0,30,28,2,23,13,7
1,499,3,0,7,0,7,47,11,7
1,165,3,1,0,8,-8,38,7,7
2,728,3,1,3,8,-5,43,10,7
2,326,3,1,3,15,-12,46,4,7
2,187,3,0,15,3,12,54,20,7
3,274,3,0,22,16,6,50,4,7
3,69,3,1,16,22,-6,54,13,7
4,321,3,1,19,30,-11,30,3,7
1,605,3,0,0,3,-3,42,4,7
1,513,3,1,3,0,3,34,1,7
2,69,3,0,16,17,-1,48,3,7
2,32,3,0,16,17,-1,26,7,7
3,829,3,1,17,16,1,45,6,7
3,703,3,0,16,17,-1,40,10,7
3,513,3,1,17,16,1,39,17,7
3,59,3,0,17,17,0,12,13,7
4,815,3,0,17,17,0,10,6,7
4,726,3,0,17,17,0,47,4,7
1,644,3,1,0,0,0,53,7,7
1,550,3,0,0,0,0,20,12,7
1,252,3,0,0,3,-3,53,10,7
1,50,3,1,3,0,3,50,12,7
2,793,3,1,3,0,3,40,14,7
2,67,3,1,3,15,-12,48,11,7
3,449,3,0,23,10,13,54,14,7
3,383,3,0,23,10,13,31,3,7
3,300,3,1,10,23,-13,41,11,7
4,865,3,0,25,10,15,49,10,7
4,800,3,1,10,25,-15,34,10,7
4,698,3,0,25,10,15,34,14,7
1,573,3,1,0,7,-7,41,10,7
1,60,3,1,0,21,-21,43,10,7
3,161,3,1,3,32,-29,48,10,7
3,67,3,0,32,3,29,37,1,7
4,782,3,0,32,10,22,26,6,7
4,169,3,1,13,35,-22,33,12,7
1,654,3,0,0,7,-7,25,9,7
1,183,3,0,0,13,-13,40,14,7
2,486,3,0,7,16,-9,47,2,7
2,366,3,0,7,16,-9,38,5,7
2,110,3,0,7,23,-16,46,10,7
3,665,3,1,26,10,16,35,10,7
3,392,3,1,26,17,9,45,6,7
3,293,3,0,17,26,-9,49,10,7
3,205,3,1,26,17,9,9,20,7
4,885,3,1,26,20,6,51,8,7
4,776,3,0,20,26,-6,25,8,7
4,706,3,1,26,20,6,55,6,7
2,503,3,1,3,21,-18,46,10,7
2,433,3,0,21,3,18,31,9,7
2,355,3,1,3,21,-18,48,2,7
2,67,3,1,3,31,-28,41,10,7
2,29,3,0,31,3,28,32,3,7
3,811,3,0,31,3,28,38,10,7
3,715,3,0,31,3,28,54,4,7
3,625,3,0,31,3,28,30,5,7
4,812,3,1,3,39,-36,25,10,7
1,565,3,0,3,0,3,54,8,7
2,351,3,1,7,10,-3,53,10,7
2,257,3,1,7,10,-3,37,2,7
3,615,3,0,17,7,10,55,14,7
3,276,3,1,7,17,-10,22,1,7
4,845,3,0,24,8,16,35,10,7
4,132,3,1,18,34,-16,54,12,7
1,519,3,0,0,3,-3,38,7,7
2,813,3,0,3,17,-14,49,13,7
2,553,3,0,3,18,-15,54,10,7
2,417,3,0,3,18,-15,46,6,7
2,62,3,0,4,25,-21,38,10,7
2,29,3,0,4,25,-21,54,3,7
3,43,3,1,35,11,24,32,1,7
4,900,3,0,11,35,-24,43,17,7
4,682,3,0,11,38,-27,40,5,7
4,604,3,1,38,11,27,44,3,7
4,538,3,0,11,38,-27,27,10,7
4,464,3,1,38,11,27,39,4,7
4,291,3,0,11,38,-27,43,8,7
1,687,3,1,0,0,0,51,7,7
1,296,3,0,3,7,-4,39,11,7
2,174,3,1,8,7,1,55,10,7
2,120,3,0,7,8,-1,43,10,7
3,235,3,1,9,11,-2,39,11,7
4,41,3,0,21,21,0,34,10,7
1,390,3,0,0,3,-3,15,10,7
2,27,3,0,11,19,-8,16,10,7
3,848,3,0,11,19,-8,30,10,7
3,736,3,0,11,19,-8,52,10,7
3,658,3,0,11,19,-8,10,3,7
3,226,3,1,26,18,8,17,8,7
3,143,3,0,18,26,-8,54,12,7
4,234,3,1,33,26,7,50,8,7
4,123,3,1,33,26,7,32,19,7
1,597,3,0,0,7,-7,55,5,7
1,441,3,0,0,7,-7,26,18,7
2,828,3,0,7,14,-7,55,11,7
2,713,3,1,14,7,7,21,3,7
2,141,3,0,16,21,-5,38,6,7
2,84,3,0,16,21,-5,47,4,7
2,28,3,0,16,21,-5,32,4,7
3,779,3,0,16,21,-5,42,11,7
3,692,3,1,21,16,5,26,15,7
3,632,3,0,16,21,-5,49,10,7
3,473,3,1,21,16,5,35,5,7
3,413,3,0,16,21,-5,38,10,7
3,138,3,1,21,19,2,55,4,7
3,62,3,0,19,21,-2,29,6,7
4,615,3,1,24,19,5,49,22,7
1,672,3,1,0,0,0,47,1,7
1,350,3,1,0,3,-3,29,16,7
1,295,3,0,3,0,3,31,25,7
2,496,3,0,3,14,-11,29,6,7
2,355,3,0,3,14,-11,40,5,7
2,1,1,1,14,3,11,53,10,7
3,703,3,1,14,4,10,32,13,7
3,616,3,0,4,14,-10,47,9,7
3,523,3,1,14,4,10,27,2,7
3,452,3,0,4,14,-10,43,7,7
3,354,3,1,14,4,10,9,13,7
3,10,3,0,9,14,-5,50,2,7
4,317,3,0,9,14,-5,47,6,7
1,367,3,0,3,7,-4,47,3,7
1,49,3,1,7,6,1,43,2,7
2,416,3,1,14,9,5,47,3,7
3,828,3,0,16,17,-1,42,9,7
3,519,3,0,16,24,-8,20,15,7
3,401,3,0,16,24,-8,42,10,7
3,81,3,0,16,33,-17,54,11,7
4,574,3,1,33,17,16,32,13,7
1,583,3,1,0,3,-3,36,9,7
1,440,3,0,3,0,3,40,8,7
1,140,3,0,3,0,3,40,7,7
2,726,3,0,10,0,10,29,8,7
2,112,3,0,10,14,-4,33,10,7
4,881,3,0,24,23,1,53,6,7
4,407,3,1,26,31,-5,45,7,7
4,348,3,0,31,26,5,36,7,7
4,85,3,1,27,31,-4,54,8,7
1,832,3,0,0,0,0,25,20,7
1,145,3,1,0,12,-12,20,19,7
1,78,3,1,0,12,-12,50,8,7
2,900,3,1,0,12,-12,16,10,7
2,68,3,1,7,15,-8,25,12,7
3,87,3,0,28,24,4,45,7,7
4,317,3,0,38,33,5,30,15,7
4,188,3,0,38,36,2,33,12,7
4,134,3,0,38,36,2,22,5,7
1,412,3,1,7,0,7,51,2,7
1,280,3,1,7,2,5,53,8,7
2,671,3,1,7,7,0,27,8,7
2,345,3,1,7,14,-7,50,9,7
2,243,3,0,14,7,7,27,7,7
2,22,3,0,21,14,7,46,4,7
3,734,3,0,21,14,7,18,2,7
3,641,3,0,21,14,7,51,9,7
3,459,3,0,21,14,7,45,11,7
3,248,3,1,14,21,-7,37,24,7
4,566,3,1,14,29,-15,38,3,7
4,482,3,0,29,14,15,44,9,7
2,707,3,1,9,1,8,40,10,7
2,135,3,0,1,16,-15,35,6,7
3,567,3,0,8,23,-15,39,4,7
4,768,3,0,11,24,-13,43,6,7
4,251,3,0,18,24,-6,48,14,7
1,628,3,0,0,7,-7,40,5,7
3,849,3,1,24,6,18,29,17,7
3,487,3,0,7,24,-17,44,18,7
3,325,3,0,7,24,-17,30,9,7
3,223,3,0,7,24,-17,43,7,7
4,725,3,1,27,7,20,16,3,7
4,605,3,1,27,14,13,48,1,7
4,356,3,0,14,27,-13,21,16,7
1,513,3,1,3,3,0,26,19,7
1,351,3,1,3,3,0,35,1,7
1,260,3,0,3,3,0,33,4,7
1,165,3,1,3,3,0,28,16,7
2,508,3,0,6,10,-4,40,6,7
2,144,3,1,10,9,1,40,5,7
4,874,3,0,22,24,-2,44,10,7
1,784,3,1,0,0,0,45,6,7
1,603,3,1,0,0,0,30,9,7
1,493,3,0,0,0,0,43,8,7
1,370,3,1,0,0,0,45,2,7
1,297,3,1,0,0,0,16,4,7
2,900,3,0,3,0,3,35,10,7
2,499,3,1,3,10,-7,36,10,7
3,646,3,0,20,10,10,20,6,7
3,555,3,0,20,10,10,50,4,7
3,290,3,0,20,10,10,55,7,7
3,155,3,1,10,20,-10,43,10,7
1,152,3,1,3,3,0,25,10,7
2,900,3,1,3,10,-7,34,7,7
2,615,3,1,3,17,-14,37,2,7
2,532,3,0,17,3,14,30,13,7
3,450,3,0,23,10,13,46,11,7
3,354,3,1,10,23,-13,33,10,7
3,274,3,0,23,10,13,36,3,7
4,462,3,0,23,17,6,50,13,7
4,392,3,0,23,17,6,22,2,7
1,831,3,0,0,0,0,43,4,7
1,453,3,1,0,7,-7,38,10,7
2,355,3,0,7,27,-20,47,5,7
2,235,3,1,27,7,20,45,6,7
2,113,3,0,7,28,-21,38,8,7
3,356,3,1,31,14,17,26,7,7
3,262,3,1,31,14,17,47,6,7
3,28,3,1,31,14,17,55,13,7
4,863,3,0,14,31,-17,34,2,7
4,79,3,0,14,35,-21,35,10,7
4,39,3,1,35,14,21,48,7,7
1,681,3,0,0,0,0,25,28,7
1,618,3,0,0,0,0,50,4,7
1,518,3,0,0,0,0,29,4,7
1,330,3,0,0,7,-7,18,26,7
1,4,3,1,14,0,14,31,10,7
2,467,3,1,21,3,18,48,8,7
2,308,3,1,21,3,18,41,10,7
2,230,3,0,3,21,-18,43,2,7
2,147,3,0,3,24,-21,38,7,7
3,151,3,1,34,3,31,40,7,7
4,612,3,1,34,5,29,52,4,7
4,83,3,1,36,5,31,25,6,7
1,796,3,1,0,0,0,52,3,7
1,705,3,1,0,0,0,52,10,7
1,479,3,0,0,7,-7,24,10,7
3,840,3,0,17,21,-4,48,11,7
3,577,3,0,17,21,-4,25,6,7
3,294,3,0,17,24,-7,35,10,7
4,798,3,1,27,20,7,50,8,7
1,805,3,1,0,7,-7,35,10,7
1,722,3,0,7,0,7,55,10,7
1,643,3,1,0,7,-7,24,4,7
1,292,3,0,10,0,10,28,2,7
2,733,3,1,1,12,-11,35,4,7
2,540,3,1,1,12,-11,45,6,7
2,427,3,0,12,1,11,52,6,7
2,353,3,1,1,12,-11,39,10,7
3,720,3,0,15,22,-7,35,9,7
3,625,3,1,22,15,7,50,10,7
3,563,3,0,15,22,-7,24,12,7
3,35,3,1,29,15,14,45,15,7
1,684,3,0,0,0,0,53,8,7
1,185,3,1,0,14,-14,49,3,7
2,153,3,1,0,16,-16,48,6,7
3,832,3,0,16,3,13,43,9,7
3,240,3,0,23,10,13,47,3,7
3,4,3,0,23,10,13,47,4,7
4,43,3,0,24,27,-3,47,5,7
1,438,3,0,3,0,3,40,6,7
1,119,3,0,3,3,0,42,3,7
1,36,3,1,3,3,0,30,6,7
2,881,3,0,3,3,0,14,25,7
2,574,3,1,10,3,7,48,7,7
2,384,3,1,10,6,4,35,10,7
2,299,3,0,6,10,-4,55,19,7
2,160,3,1,10,6,4,27,9,7
4,880,3,1,19,18,1,44,22,7
4,784,3,0,18,19,-1,26,5,7
4,560,3,0,18,22,-4,44,1,7
4,479,3,1,22,18,4,31,6,7
1,844,3,1,0,0,0,37,17,7
1,45,3,0,0,10,-10,37,8,7
2,852,3,1,10,0,10,51,12,7
2,127,3,1,11,15,-4,32,13,7
2,73,3,0,15,11,4,49,3,7
2,28,3,1,11,15,-4,20,14,7
3,802,3,0,15,11,4,48,4,7
3,302,3,0,15,17,-2,36,8,7
3,175,3,0,15,17,-2,17,10,7
3,95,3,0,15,17,-2,53,11,7
4,810,3,0,15,19,-4,52,3,7
4,711,3,1,19,15,4,34,10,7
1,422,3,1,0,3,-3,53,8,7
2,734,3,0,4,7,-3,43,10,7
2,671,3,0,4,7,-3,15,7,7
2,408,3,0,4,10,-6,50,6,7
2,129,3,0,4,17,-13,47,8,7
2,57,3,1,17,4,13,33,12,7
2,19,3,0,4,17,-13,23,28,7
3,821,3,1,17,4,13,35,13,7
3,759,3,0,4,17,-13,45,5,7
3,642,3,1,17,4,13,44,5,7
3,463,2,0,4,17,-13,54,11,7
3,335,3,1,17,4,13,26,10,7
3,66,3,0,7,17,-10,50,2,7
4,579,3,0,7,20,-13,32,13,7
4,324,3,0,7,23,-16,40,5,7
4,247,3,1,23,7,16,37,5,7
4,180,3,0,7,23,-16,46,4,7
1,836,3,1,0,0,0,30,7,7
1,660,3,0,0,0,0,52,5,7
1,339,3,1,3,0,3,24,10,7
1,1,3,1,3,3,0,41,6,7
2,214,3,0,10,6,4,51,12,7
2,133,3,1,6,10,-4,14,10,7
3,676,3,1,6,20,-14,52,10,7
3,428,3,1,6,27,-21,42,2,7
3,340,3,0,27,6,21,32,4,7
4,641,3,0,30,7,23,37,8,7
4,345,3,0,30,7,23,13,2,7
4,177,3,1,7,37,-30,45,4,7
4,65,3,1,7,37,-30,43,8,7
1,849,3,0,0,0,0,47,6,7
1,789,3,1,0,0,0,13,10,7
1,581,3,1,0,0,0,30,7,7
2,779,3,1,3,10,-7,36,5,7
2,535,3,1,3,10,-7,52,2,7
2,129,3,1,10,13,-3,43,2,7
2,91,3,0,13,10,3,24,3,7
2,1,3,0,13,10,3,52,6,7
3,197,3,1,13,16,-3,38,7,7
4,66,3,1,26,23,3,33,5,7
1,746,3,0,0,0,0,53,17,7
2,655,3,1,0,2,-2,40,5,7
2,92,3,1,0,2,-2,45,6,7
3,601,3,1,3,2,1,51,10,7
3,531,3,0,2,3,-1,20,9,7
4,900,3,0,9,6,3,15,8,7
4,809,3,1,6,9,-3,48,5,7
4,749,3,0,9,6,3,51,3,7
4,689,3,1,6,9,-3,23,10,7
4,474,3,1,6,10,-4,46,10,7
4,358,3,1,6,10,-4,50,10,7
1,707,3,0,0,0,0,48,4,7
1,367,3,1,0,0,0,54,4,7
3,550,3,1,16,24,-8,35,6,7
3,319,3,1,16,24,-8,51,21,7
4,629,3,0,25,23,2,55,5,7
4,187,3,1,26,25,1,48,6,7
1,646,3,1,0,0,0,44,9,7
1,498,3,0,0,0,0,38,9,7
2,107,3,1,6,22,-16,47,10,7
2,70,3,0,22,6,16,35,4,7
3,720,3,0,22,6,16,32,8,7
3,286,3,1,13,22,-9,42,10,7
3,134,3,0,22,13,9,38,1,7
3,52,3,1,13,22,-9,43,6,7
4,374,3,1,13,25,-12,46,10,7
1,399,3,0,3,7,-4,26,18,7
1,312,3,1,7,3,4,46,5,7
2,735,3,0,10,14,-4,24,10,7
2,615,3,1,14,10,4,48,6,7
2,494,3,0,10,14,-4,30,1,7
3,571,3,1,24,24,0,55,3,7
3,344,3,0,24,24,0,31,6,7
3,279,3,1,24,24,0,44,5,7
4,822,3,1,24,27,-3,55,10,7
4,433,3,1,24,27,-3,40,2,7
1,840,3,0,0,0,0,49,1,7
1,774,3,1,0,0,0,18,17,7
1,285,3,0,3,7,-4,48,10,7
1,115,3,1,7,3,4,31,11,7
1,53,3,0,3,7,-4,42,10,7
2,375,3,0,3,17,-14,14,4,7
3,819,3,0,6,31,-25,36,5,7
3,721,3,0,6,31,-25,53,5,7
3,598,3,0,6,31,-25,40,10,7
3,518,3,1,31,6,25,44,2,7
3,95,3,1,31,13,18,45,10,7
4,832,3,1,31,16,15,44,1,7
4,684,3,0,16,31,-15,45,4,7
1,39,3,0,7,3,4,42,10,7
2,273,3,0,14,10,4,36,12,7
2,158,3,0,14,13,1,35,2,7
2,54,3,0,14,13,1,36,7,7
3,746,3,1,13,14,-1,35,12,7
3,524,3,0,14,13,1,35,5,7
3,470,3,1,13,14,-1,27,10,7
3,284,3,1,13,14,-1,12,10,7
3,211,3,1,13,14,-1,52,10,7
3,133,3,1,13,14,-1,17,9,7
4,884,3,1,13,17,-4,29,10,7
4,781,3,0,17,13,4,36,14,7
1,715,3,1,0,0,0,46,13,7
1,592,3,1,0,0,0,27,2,7
1,525,3,0,0,0,0,46,5,7
2,900,3,1,7,3,4,55,1,7
2,691,3,0,3,7,-4,49,5,7
2,639,3,0,3,7,-4,20,10,7
2,593,3,0,3,7,-4,52,10,7
2,483,3,0,3,7,-4,35,1,7
3,602,3,0,4,10,-6,45,16,7
3,535,3,0,4,10,-6,24,4,7
3,246,3,0,4,11,-7,36,9,7
3,3,3,0,4,11,-7,20,15,7
4,851,3,1,11,4,7,44,15,7
4,780,3,0,4,11,-7,28,10,7
4,697,3,1,11,4,7,40,26,7
4,414,3,1,11,4,7,40,7,7
4,100,3,1,11,11,0,51,7,7
1,846,3,0,0,0,0,40,3,7
1,786,3,1,0,0,0,41,4,7
2,775,3,1,7,7,0,37,10,7
2,684,3,0,7,7,0,43,3,7
2,573,2,1,7,7,0,35,13,7
2,161,3,1,7,10,-3,39,10,7
4,503,3,0,23,21,2,50,10,7
4,437,3,0,23,21,2,13,16,7
4,240,3,0,23,28,-5,40,10,7
4,161,3,1,28,23,5,24,12,7
4,112,3,0,23,28,-5,33,9,7
4,31,3,1,28,23,5,47,5,7
1,829,3,0,0,0,0,37,9,7
1,725,3,0,0,7,-7,39,9,7
1,489,3,0,0,7,-7,37,0,7
1,153,3,0,0,10,-10,42,1,7
1,67,3,1,10,0,10,15,10,7
2,478,3,1,10,14,-4,23,9,7
2,297,3,1,10,14,-4,48,10,7
2,81,3,1,10,14,-4,41,4,7
2,40,3,0,14,10,4,29,4,7
3,809,3,0,14,10,4,50,18,7
3,550,3,1,10,21,-11,31,2,7
3,381,3,1,10,21,-11,40,4,7
4,840,3,0,21,17,4,44,17,7
4,721,3,1,17,21,-4,43,5,7
4,600,3,0,21,17,4,33,18,7
4,389,3,1,17,21,-4,38,12,7
4,153,3,1,17,21,-4,45,3,7
1,400,3,1,7,0,7,46,3,7
1,238,3,0,0,7,-7,20,15,7
3,537,3,1,17,10,7,31,1,7
4,222,3,1,17,20,-3,37,10,7
4,79,3,0,20,20,0,38,18,7
1,302,3,0,3,7,-4,28,17,7
2,481,3,1,21,6,15,49,10,7
2,345,3,0,6,21,-15,27,10,7
2,98,3,1,21,6,15,38,10,7
3,781,3,0,13,21,-8,54,10,7
3,391,3,1,28,13,15,49,21,7
3,42,3,0,13,35,-22,36,3,7
4,798,3,1,35,13,22,28,15,7
4,444,3,0,16,35,-19,50,5,7
4,133,3,0,23,38,-15,29,16,7
4,44,3,0,23,41,-18,26,19,7
1,820,3,0,0,0,0,48,5,7
1,672,3,0,0,0,0,47,10,7
1,601,3,0,0,0,0,23,1,7
1,360,3,0,0,1,-1,43,2,7
1,284,3,1,1,0,1,29,5,7
2,208,3,0,15,4,11,45,9,7
2,158,3,0,15,4,11,22,6,7
3,837,3,1,7,22,-15,36,14,7
3,293,3,0,23,10,13,41,5,7
3,208,3,1,10,23,-13,32,7,7
4,553,3,0,26,10,16,44,13,7
4,476,3,1,10,26,-16,44,7,7
4,360,3,0,26,10,16,45,9,7
4,32,3,0,26,10,16,55,9,7
1,808,3,1,0,0,0,32,11,7
1,675,3,0,0,0,0,22,19,7
1,424,3,1,0,0,0,47,25,7
1,122,3,1,0,0,0,54,9,7
1,68,3,0,0,0,0,13,10,7
2,724,3,1,7,0,7,30,13,7
3,667,3,1,14,9,5,47,21,7
3,283,3,0,16,14,2,50,9,7
4,761,3,0,16,14,2,25,10,7
4,700,3,1,14,16,-2,53,10,7
4,541,3,1,14,16,-2,27,8,7
4,411,3,0,16,14,2,54,6,7
4,337,3,1,14,16,-2,33,1,7
1,779,3,0,0,0,0,48,9,7
1,696,3,1,0,0,0,29,18,7
1,501,3,0,0,7,-7,45,10,7
1,320,3,0,0,14,-14,51,10,7
2,482,3,1,18,3,15,41,4,7
3,385,3,0,13,24,-11,20,4,7
3,32,3,0,13,31,-18,52,5,7
4,591,3,0,13,37,-24,43,2,7
4,375,3,0,13,37,-24,43,8,7
4,270,3,0,13,37,-24,16,19,7
4,118,3,0,13,37,-24,14,7,7
4,66,3,1,37,13,24,50,16,7
1,490,3,1,7,0,7,22,3,7
1,153,3,0,0,14,-14,18,20,7
2,784,3,0,0,17,-17,48,7,7
2,523,3,0,0,17,-17,28,8,7
2,356,3,0,0,17,-17,47,5,7
2,46,3,0,7,24,-17,38,12,7
3,846,3,0,7,24,-17,32,5,7
4,342,3,0,14,45,-31,34,26,7
4,213,3,1,45,14,31,33,2,7
2,756,3,1,11,0,11,45,10,7
2,630,3,0,0,11,-11,25,19,7
2,494,3,0,0,11,-11,41,6,7
2,435,3,0,0,11,-11,8,10,7
2,364,3,1,11,0,11,42,14,7
2,128,3,1,11,0,11,51,18,7
3,472,3,1,14,0,14,39,11,7
4,706,3,0,1,22,-21,27,10,7
4,300,3,0,1,29,-28,22,20,7
4,162,3,0,1,29,-28,46,6,7
4,130,3,0,1,29,-28,18,10,7
4,91,3,0,1,29,-28,40,4,7
1,295,3,1,7,7,0,43,8,7
2,634,3,1,14,10,4,26,11,7
2,384,3,1,14,13,1,36,2,7
2,294,3,0,13,14,-1,37,6,7
3,825,3,0,13,17,-4,41,5,7
3,672,3,1,17,13,4,48,9,7
3,321,3,0,13,17,-4,25,10,7
4,750,3,1,17,20,-3,39,3,7
4,482,3,1,17,27,-10,38,19,7
4,359,3,0,27,17,10,41,20,7
4,166,3,0,27,20,7,43,2,7
4,38,3,0,27,20,7,40,3,7
1,610,3,0,0,3,-3,28,17,7
2,716,3,0,0,19,-19,37,1,7
2,248,3,0,1,21,-20,43,10,7
2,116,3,0,1,21,-20,22,13,7
2,26,3,1,24,1,23,54,5,7
3,816,3,0,1,24,-23,34,19,7
3,393,3,1,31,1,30,52,19,7
3,102,3,0,3,31,-28,48,7,7
4,346,3,1,31,10,21,12,3,7
4,157,3,1,31,10,21,16,26,7
4,118,3,0,10,31,-21,49,12,7
4,78,3,1,31,10,21,39,3,7
1,832,3,1,0,0,0,29,15,7
1,575,3,1,0,7,-7,12,17,7
2,692,3,0,21,7,14,49,6,7
2,110,3,1,14,21,-7,46,16,7
2,51,3,0,21,14,7,33,6,7
3,823,3,0,21,17,4,40,5,7
3,305,3,1,20,22,-2,38,7,7
3,239,3,0,22,20,2,33,10,7
4,900,3,1,20,25,-5,43,2,7
4,346,3,0,28,26,2,30,20,7
4,127,3,0,28,33,-5,32,23,7
1,825,3,1,0,0,0,34,5,7
1,485,3,1,0,0,0,42,6,7
1,374,3,0,0,7,-7,27,15,7
1,24,3,0,0,14,-14,24,20,7
2,126,3,0,0,17,-17,48,8,7
2,96,3,1,17,0,17,29,9,7
2,76,3,0,0,17,-17,30,17,7
3,494,3,1,20,3,17,23,10,7
3,177,3,0,3,20,-17,41,4,7
4,427,3,0,3,21,-18,49,11,7
1,813,3,0,0,0,0,25,13,7
1,643,3,0,0,0,0,42,10,7
2,900,3,1,7,7,0,48,7,7
2,729,3,0,7,7,0,45,3,7
2,668,3,0,7,7,0,15,15,7
2,400,3,0,7,10,-3,45,12,7
2,313,3,1,10,7,3,16,24,7
2,114,3,1,10,10,0,36,9,7
2,87,3,0,10,10,0,28,10,7
3,856,3,1,10,10,0,23,4,7
3,270,3,1,13,17,-4,42,5,7
3,131,3,0,17,13,4,48,10,7
3,62,3,1,13,17,-4,28,6,7
4,237,3,0,24,22,2,33,23,7
1,841,3,1,0,0,0,35,3,7
1,283,3,1,7,0,7,18,7,7
1,138,3,1,7,0,7,42,8,7
2,541,3,0,0,17,-17,44,7,7
2,464,3,1,17,0,17,28,13,7
2,155,3,0,1,17,-16,52,2,7
3,826,3,0,1,17,-16,44,2,7
3,452,3,0,1,24,-23,29,11,7
3,200,3,1,25,8,17,38,5,7
4,715,3,0,15,28,-13,54,18,7
4,400,3,0,15,34,-19,17,19,7
2,767,3,1,10,10,0,47,18,7
2,622,3,1,10,10,0,50,6,7
3,582,3,0,19,20,-1,41,16,7
3,494,3,1,20,19,1,30,10,7
4,583,3,0,22,30,-8,45,7,7
4,425,3,1,30,28,2,29,6,7
4,359,3,0,28,30,-2,42,6,7
1,735,3,1,0,0,0,44,6,7
1,685,3,0,0,0,0,31,10,7
1,602,3,1,0,0,0,35,4,7
1,16,3,0,0,1,-1,41,4,7
2,820,3,1,1,0,1,33,6,7
2,743,3,0,0,1,-1,32,22,7
2,694,3,1,1,0,1,35,10,7
2,583,3,0,0,1,-1,34,10,7
2,274,3,0,7,1,6,43,10,7
3,703,3,0,7,10,-3,29,16,7
3,332,3,0,7,11,-4,54,1,7
3,238,3,1,11,7,4,6,7,7
4,238,3,0,11,25,-14,45,10,7
4,144,3,1,25,11,14,45,9,7
4,99,3,1,27,11,16,34,11,7
1,231,3,0,3,6,-3,36,9,7
2,410,3,0,17,6,11,54,2,7
2,165,3,0,17,6,11,51,7,7
3,106,3,0,31,15,16,42,3,7
4,900,3,1,15,31,-16,31,11,7
4,112,3,1,15,34,-19,53,6,7
1,368,3,1,0,1,-1,10,20,7
1,61,3,1,0,4,-4,46,10,7
2,598,3,0,11,3,8,40,5,7
2,283,3,0,11,6,5,41,9,7
2,48,3,1,13,11,2,49,8,7
3,716,3,0,14,13,1,53,28,7
4,900,3,1,13,16,-3,29,9,7
4,613,3,1,13,19,-6,25,20,7
4,94,3,1,13,26,-13,25,20,7
4,51,3,1,13,26,-13,52,4,7
1,530,3,0,0,0,0,52,25,7
1,436,3,1,0,7,-7,31,7,7
1,252,3,0,7,0,7,6,18,7
1,175,3,1,0,7,-7,45,9,7
1,102,3,0,7,0,7,27,13,7
1,1,3,1,0,7,-7,51,1,7
2,409,3,1,0,10,-10,35,10,7
2,56,3,0,13,3,10,38,7,7
3,776,3,0,13,3,10,30,16,7
3,525,3,1,3,13,-10,47,4,7
3,89,3,0,13,3,10,20,8,7
4,361,3,1,3,23,-20,29,16,7
4,139,3,1,3,26,-23,30,15,7
1,462,3,0,3,0,3,10,7,7
1,200,3,0,3,3,0,36,5,7
1,126,3,1,3,3,0,48,10,7
2,163,3,0,7,6,1,45,10,7
3,802,3,1,9,7,2,38,18,7
3,535,3,0,7,9,-2,36,10,7
3,449,3,1,9,7,2,26,19,7
4,563,3,0,14,12,2,47,17,7
1,830,3,1,0,1,-1,40,5,7
1,736,3,1,0,1,-1,52,12,7
1,528,3,1,0,1,-1,51,12,7
1,457,3,1,0,1,-1,17,8,7
1,380,3,1,0,1,-1,49,9,7
2,900,3,1,0,4,-4,49,8,7
2,121,3,1,7,4,3,47,10,7
2,87,3,0,4,7,-3,20,3,7
3,710,3,1,7,4,3,45,10,7
3,531,3,1,7,4,3,53,9,7
3,406,3,0,4,7,-3,28,3,7
3,286,3,1,7,4,3,6,21,7
4,673,3,1,7,7,0,53,4,7
4,31,3,0,7,10,-3,43,4,7
1,660,3,0,0,3,-3,31,10,7
2,548,3,0,3,10,-7,45,4,7
2,57,3,0,3,20,-17,33,6,7
3,856,3,0,3,20,-17,25,9,7
3,670,3,0,3,20,-17,39,3,7
3,265,3,0,3,27,-24,22,25,7
3,208,3,1,27,3,24,50,4,7
4,600,3,0,3,41,-38,54,4,7
4,530,3,1,41,3,38,22,7,7
4,390,3,1,41,3,38,51,17,7
4,10,3,1,41,5,36,35,3,7
1,510,3,0,3,3,0,35,11,7
1,203,3,0,10,3,7,43,2,7
2,801,3,0,10,10,0,24,6,7
2,390,3,0,10,10,0,40,28,7
2,46,3,0,13,13,0,55,10,7
3,834,3,1,13,20,-7,37,6,7
3,749,3,0,20,13,7,29,6,7
3,638,3,1,13,20,-7,47,14,7
3,364,3,1,20,20,0,21,13,7
4,255,3,0,26,20,6,27,15,7
4,187,3,1,20,26,-6,46,10,7
4,128,3,0,26,20,6,28,7,7
4,100,3,1,20,26,-6,44,9,7
1,833,3,0,0,0,0,43,7,7
1,672,3,1,0,0,0,36,12,7
1,432,3,1,0,3,-3,33,2,7
2,889,3,0,6,0,6,50,11,7
2,503,3,1,0,9,-9,49,10,7
4,584,3,1,6,23,-17,24,20,7
4,492,3,0,23,6,17,47,15,7
4,284,3,1,6,23,-17,54,13,7
1,180,3,1,14,7,7,13,6,7
2,638,3,1,14,14,0,36,14,7
3,786,3,0,17,20,-3,50,10,7
3,716,3,1,20,17,3,25,2,7
3,318,2,0,20,23,-3,41,9,7
3,75,3,0,20,23,-3,17,7,7
3,13,3,0,20,23,-3,50,5,7
4,566,3,1,23,23,0,40,5,7
1,510,3,0,0,14,-14,34,4,7
1,9,3,1,14,6,8,28,17,7
2,871,3,0,6,14,-8,48,2,7
2,642,3,0,6,14,-8,37,2,7
2,578,3,1,14,6,8,38,2,7
2,464,3,0,6,14,-8,23,4,7
2,147,3,0,6,21,-15,42,13,7
3,831,3,1,28,6,22,39,7,7
3,18,3,0,9,31,-22,51,2,7
4,873,3,0,9,31,-22,15,5,7
4,358,3,1,37,9,28,29,11,7
1,580,3,1,0,3,-3,35,10,7
1,434,3,0,3,0,3,55,6,7
1,334,3,1,0,3,-3,13,15,7
2,703,3,0,6,6,0,55,7,7
2,479,3,0,6,6,0,18,8,7
2,386,3,1,6,6,0,52,9,7
2,60,3,1,6,13,-7,22,17,7
2,7,3,1,6,13,-7,52,11,7
3,377,3,0,20,13,7,27,14,7
3,306,3,1,13,20,-7,19,20,7
3,245,3,1,13,20,-7,53,10,7
4,765,3,0,20,20,0,30,9,7
4,157,3,0,20,29,-9,16,4,7
4,110,3,1,29,20,9,47,8,7
1,695,3,0,0,1,-1,42,3,7
2,554,3,1,5,3,2,43,12,7
2,490,3,0,3,5,-2,16,14,7
2,359,3,1,5,3,2,46,10,7
2,274,3,0,3,5,-2,23,10,7
2,135,3,1,5,3,2,25,10,7
3,615,3,0,17,5,12,48,12,7
3,500,3,0,17,5,12,22,10,7
3,372,3,0,17,5,12,39,10,7
3,282,3,1,5,17,-12,15,20,7
3,147,3,0,17,5,12,52,23,7
3,30,3,1,5,17,-12,23,12,7
4,372,3,1,5,21,-16,48,10,7
4,176,3,1,5,21,-16,11,22,7
1,837,3,1,0,0,0,31,3,7
1,685,3,0,0,0,0,48,2,7
1,549,3,1,0,0,0,50,6,7
1,409,3,0,0,0,0,42,6,7
1,95,3,0,7,7,0,27,8,7
1,21,3,1,7,7,0,43,10,7
2,750,3,0,7,7,0,39,1,7
2,688,3,1,7,7,0,36,1,7
2,432,3,1,7,10,-3,20,25,7
2,283,3,0,10,14,-4,47,5,7
3,745,3,0,10,21,-11,54,6,7
3,534,3,0,10,21,-11,55,10,7
4,900,3,1,21,13,8,47,2,7
4,259,3,0,19,24,-5,48,2,7
4,181,3,1,24,19,5,38,1,7
4,34,3,0,25,24,1,50,8,7
1,174,3,1,0,17,-17,48,5,7
2,675,3,0,24,0,24,48,13,7
3,706,3,0,32,7,25,55,10,7
3,615,3,1,7,32,-25,34,2,7
3,284,3,1,7,35,-28,45,14,7
3,216,3,0,35,7,28,32,2,7
4,792,3,0,35,7,28,41,0,7
4,179,3,1,14,38,-24,44,3,7
4,64,3,1,14,38,-24,27,13,7
1,405,3,1,0,3,-3,37,3,7
1,307,3,0,3,0,3,24,7,7
1,21,3,0,3,3,0,37,8,7
2,801,3,1,3,3,0,55,13,7
2,721,3,0,3,3,0,50,9,7
2,111,3,1,10,3,7,5,13,7
2,46,3,1,10,3,7,54,4,7
2,1,3,0,3,10,-7,29,4,7
3,816,3,0,3,10,-7,36,5,7
3,568,3,0,3,10,-7,51,10,7
3,398,3,0,3,10,-7,38,5,7
3,195,3,0,3,10,-7,43,15,7
4,177,3,1,17,16,1,54,4,7
1,835,3,1,0,0,0,30,9,7
2,123,3,1,8,27,-19,32,6,7
3,735,3,0,30,8,22,35,10,7
3,240,3,0,30,11,19,50,10,7
4,615,3,0,30,14,16,40,5,7
4,563,3,0,30,14,16,50,10,7
4,349,3,0,30,14,16,54,5,7
4,161,3,0,30,17,13,43,2,7
1,616,3,0,0,3,-3,36,9,7
1,243,3,0,3,10,-7,47,10,7
2,664,3,1,17,6,11,45,4,7
2,540,3,1,17,6,11,50,5,7
2,426,3,1,17,6,11,45,10,7
2,304,3,1,17,13,4,36,12,7
3,837,3,0,19,17,2,40,4,7
3,709,3,0,19,17,2,53,5,7
3,467,3,1,20,19,1,43,23,7
3,33,3,1,27,26,1,35,8,7
1,837,3,0,0,0,0,36,8,7
1,652,3,0,0,0,0,35,7,7
1,342,3,0,0,7,-7,28,1,7
1,154,3,0,0,7,-7,19,10,7
2,132,3,0,0,21,-21,31,6,7
3,723,3,0,7,28,-21,45,6,7
1,725,3,1,0,0,0,43,4,7
1,409,3,1,0,7,-7,44,6,7
1,258,3,1,0,7,-7,53,7,7
2,481,3,0,7,7,0,45,7,7
2,325,3,1,7,7,0,35,6,7
2,47,3,0,14,14,0,18,17,7
3,814,3,0,14,21,-7,24,2,7
3,670,3,1,21,14,7,54,4,7
3,315,3,0,21,21,0,40,8,7
4,704,3,0,21,28,-7,7,37,7
4,460,3,0,21,31,-10,33,12,7
4,49,3,1,38,21,17,40,4,7
1,355,3,1,1,0,1,55,6,7
2,338,3,0,4,8,-4,54,4,7
2,128,3,0,4,8,-4,11,7,7
2,90,3,1,8,4,4,51,11,7
3,395,3,1,8,4,4,54,10,7
3,161,3,1,8,7,1,41,4,7
4,838,3,0,7,8,-1,53,4,7
1,701,3,1,0,0,0,42,23,7
2,892,3,1,7,10,-3,47,8,7
2,712,3,1,7,10,-3,42,3,7
2,133,3,1,7,17,-10,50,14,7
2,55,3,0,17,7,10,51,10,7
2,13,3,0,17,7,10,53,10,7
4,790,3,1,17,20,-3,53,13,7
4,700,3,1,17,20,-3,13,8,7
4,171,3,1,20,23,-3,46,7,7
1,852,3,1,0,0,0,35,7,7
2,228,3,1,4,4,0,42,16,7
2,82,3,1,4,4,0,39,1,7
3,837,3,0,4,4,0,30,25,7
3,380,3,0,4,5,-1,51,3,7
3,221,3,0,4,5,-1,47,4,7
3,161,3,1,5,4,1,35,10,7
3,76,3,0,4,5,-1,24,8,7
4,773,3,1,12,4,8,45,6,7
1,838,3,0,0,0,0,50,3,7
1,413,3,1,0,7,-7,19,17,7
1,131,3,1,0,10,-10,53,9,7
1,1,3,0,10,0,10,27,20,7
2,613,3,0,10,3,7,36,9,7
2,292,3,0,10,6,4,42,8,7
2,214,3,1,6,10,-4,26,12,7
2,97,3,1,6,13,-7,32,13,7
3,836,3,1,9,13,-4,50,13,7
3,640,3,1,9,13,-4,46,1,7
3,461,3,1,9,13,-4,36,2,7
3,380,3,0,13,9,4,35,1,7
4,669,3,1,17,16,1,40,5,7
4,518,3,1,17,19,-2,28,8,7
4,142,3,0,26,17,9,51,6,7
1,838,3,1,0,0,0,37,4,7
1,749,3,0,0,0,0,39,5,7
1,682,3,1,0,0,0,28,7,7
1,600,3,0,0,0,0,37,16,7
1,263,3,0,0,1,-1,50,5,7
1,179,3,1,1,0,1,7,9,7
2,587,3,1,1,0,1,12,5,7
2,117,3,1,1,3,-2,39,7,7
3,325,3,1,8,6,2,55,2,7
4,750,3,0,13,11,2,35,10,7
1,776,3,0,0,0,0,31,16,7
1,609,3,1,0,0,0,52,7,7
2,900,3,0,7,7,0,16,19,7
2,850,3,0,7,7,0,49,10,7
2,624,3,0,7,14,-7,21,17,7
2,288,3,0,7,24,-17,25,13,7
2,147,3,0,7,24,-17,8,23,7
3,633,3,1,31,13,18,42,3,7
3,380,3,1,31,16,15,22,23,7
3,1,3,1,31,23,8,49,4,7
4,485,3,0,24,34,-10,38,7,7
4,434,3,1,34,24,10,22,10,7
4,278,3,1,34,24,10,41,7,7
4,45,3,0,27,34,-7,54,14,7
1,625,3,0,0,7,-7,52,3,7
1,116,3,1,7,7,0,15,2,7
2,566,3,0,8,7,1,39,2,7
2,156,3,0,8,7,1,32,10,7
2,103,3,0,8,7,1,54,7,7
2,49,3,0,8,7,1,47,10,7
3,158,3,1,7,11,-4,42,3,7
3,69,3,0,11,7,4,35,7,7
4,851,3,0,11,7,4,53,8,7
4,274,3,1,7,18,-11,30,15,7
4,41,3,0,32,7,25,45,26,7
1,645,3,0,0,3,-3,27,17,7
1,415,3,1,10,0,10,45,6,7
1,171,3,0,0,10,-10,43,10,7
2,814,3,1,10,3,7,35,6,7
2,678,3,1,10,3,7,47,6,7
3,844,3,0,9,13,-4,24,10,7
3,502,3,1,16,12,4,36,9,7
3,425,3,0,12,16,-4,37,9,7
4,698,3,0,19,16,3,53,4,7
4,544,3,0,19,16,3,47,10,7
4,378,3,0,19,16,3,21,19,7
4,293,3,0,19,16,3,43,5,7
4,109,3,1,16,20,-4,35,10,7
4,40,3,0,20,16,4,50,2,7
1,561,3,1,0,3,-3,53,7,7
1,488,3,0,3,0,3,31,4,7
2,721,3,0,3,8,-5,41,4,7
2,196,3,0,3,8,-5,17,24,7
3,517,3,1,9,3,6,46,6,7
3,432,3,0,3,9,-6,41,1,7
3,2,3,0,3,13,-10,35,10,7
4,728,3,0,3,13,-10,32,10,7
4,550,3,1,13,3,10,54,8,7
4,163,3,0,10,20,-10,49,20,7
4,144,3,1,20,10,10,35,2,7
4,28,3,1,20,10,10,29,10,7
1,360,3,1,0,7,-7,44,7,7
1,270,3,0,7,0,7,35,5,7
2,569,3,1,2,7,-5,50,5,7
2,222,3,0,7,11,-4,32,3,7
3,178,3,1,21,14,7,18,10,7
3,72,3,1,21,21,0,32,13,7
1,158,3,1,10,1,9,47,16,7
1,55,3,0,3,10,-7,48,7,7
2,769,3,1,10,3,7,22,17,7
2,496,3,1,10,3,7,45,13,7
2,425,3,0,3,10,-7,20,5,7
2,119,3,1,13,3,10,40,16,7
3,614,3,0,12,13,-1,48,18,7
3,483,3,0,12,13,-1,20,17,7
3,305,3,0,12,13,-1,36,9,7
3,78,3,0,12,13,-1,31,19,7
4,900,3,1,13,12,1,33,7,7
4,460,3,1,13,12,1,49,7,7
1,551,3,0,0,8,-8,20,25,7
1,342,3,1,8,7,1,36,1,7
1,42,3,0,7,8,-1,52,19,7
2,761,3,0,7,8,-1,50,8,7
2,153,3,1,15,10,5,35,10,7
2,87,3,0,10,15,-5,52,5,7
3,566,3,0,10,18,-8,43,2,7
3,485,3,1,18,10,8,36,8,7
3,339,3,0,10,18,-8,45,15,7
3,111,3,1,18,10,8,50,12,7
3,1,3,1,18,10,8,53,6,7
1,615,3,0,0,3,-3,41,15,7
1,525,3,1,3,0,3,32,9,7
1,396,3,0,0,3,-3,51,10,7
1,275,3,1,3,0,3,38,12,7
1,165,3,0,0,3,-3,39,4,7
2,900,3,1,3,0,3,55,3,7
2,796,3,0,0,3,-3,9,19,7
2,111,3,0,3,5,-2,52,15,7
3,795,3,0,6,5,1,40,8,7
3,728,3,1,5,6,-1,26,15,7
3,648,3,0,6,5,1,51,4,7
3,243,3,1,5,7,-2,37,8,7
3,67,3,1,5,7,-2,48,3,7
4,814,3,0,7,5,2,36,4,7
4,555,3,0,7,5,2,24,20,7
4,57,3,1,5,7,-2,42,17,7
1,726,3,0,0,0,0,52,4,7
1,301,3,1,0,3,-3,15,22,7
1,204,3,1,0,3,-3,45,4,7
1,35,3,1,0,3,-3,18,17,7
2,880,3,0,3,0,3,45,5,7
2,778,3,1,0,3,-3,43,10,7
2,94,3,1,7,17,-10,46,3,7
2,70,3,0,17,7,10,30,7,7
3,736,3,0,17,10,7,55,9,7
3,583,3,0,24,10,14,49,10,7
3,138,3,0,31,10,21,53,10,7
3,14,3,0,31,10,21,17,7,7
4,734,3,0,31,13,18,43,2,7
4,671,3,1,13,31,-18,21,10,7
4,584,3,1,13,31,-18,44,6,7
4,199,3,0,34,20,14,15,16,7
1,694,3,1,7,0,7,49,4,7
1,632,3,1,7,0,7,21,7,7
1,320,3,1,7,10,-3,25,12,7
2,524,3,0,17,7,10,50,7,7
2,361,3,1,7,17,-10,26,20,7
3,431,3,1,10,24,-14,41,5,7
3,186,3,0,24,17,7,47,4,7
4,809,3,0,24,24,0,32,3,7
4,743,3,0,24,31,-7,39,6,7
4,702,3,1,31,24,7,23,4,7
4,436,3,1,31,24,7,40,6,7
1,792,3,0,0,0,0,50,13,7
2,595,3,0,8,8,0,37,8,7
2,38,3,1,8,20,-12,25,15,7
3,1,3,1,16,30,-14,49,1,7
4,806,3,1,16,30,-14,38,6,7
4,736,3,0,30,16,14,31,11,7
4,508,3,1,17,30,-13,53,10,7
4,410,3,1,17,30,-13,37,10,7
4,327,3,0,30,17,13,41,6,7
4,61,3,0,30,24,6,41,12,7
1,849,3,0,0,0,0,38,10,7
1,781,3,1,0,0,0,29,7,7
1,709,3,0,0,0,0,36,15,7
1,346,3,1,2,0,2,42,17,7
1,245,3,0,0,2,-2,41,6,7
2,272,3,0,3,6,-3,43,2,7
2,50,3,1,6,3,3,6,9,7
3,671,3,0,6,9,-3,44,1,7
4,328,3,0,16,26,-10,41,5,7
1,44,3,0,15,3,12,25,3,7
2,888,3,1,3,15,-12,36,10,7
2,783,3,0,15,3,12,41,9,7
2,121,3,0,29,3,26,25,12,7
3,834,3,1,10,29,-19,9,8,7
3,170,3,0,32,25,7,36,3,7
3,83,3,1,25,32,-7,34,10,7
4,665,3,1,25,33,-8,37,8,7
4,227,3,0,33,33,0,17,26,7
1,749,3,1,0,0,0,44,5,7
1,498,3,1,0,0,0,31,13,7
2,472,3,0,3,6,-3,40,6,7
2,294,3,0,3,6,-3,51,3,7
3,716,3,0,3,15,-12,28,3,7
4,823,3,1,16,6,10,13,4,7
4,354,3,1,19,9,10,48,5,7
1,633,3,0,0,3,-3,43,2,7
1,115,3,1,6,0,6,33,4,7
1,22,3,0,0,6,-6,29,16,7
2,728,3,0,0,13,-13,46,2,7
2,635,3,1,13,0,13,31,5,7
2,485,3,1,13,0,13,17,8,7
2,141,3,1,13,3,10,41,4,7
2,120,3,0,3,13,-10,28,18,7
3,833,3,0,3,13,-10,20,12,7
3,458,3,0,3,13,-10,21,14,7
3,330,3,0,3,20,-17,45,11,7
3,8,3,0,3,20,-17,19,16,7
4,787,3,0,3,20,-17,46,9,7
4,626,3,0,3,20,-17,51,1,7
4,529,3,0,3,20,-17,31,5,7
4,165,3,0,3,27,-24,11,14,7
1,548,3,1,0,1,-1,34,11,7
1,290,3,1,0,4,-4,43,2,7
1,197,3,1,0,4,-4,49,10,7
2,213,3,0,18,8,10,44,4,7
3,735,3,1,9,21,-12,31,9,7
3,482,3,1,9,28,-19,9,19,7
3,385,3,0,28,9,19,55,11,7
3,228,3,1,9,28,-19,40,8,7
4,900,3,1,9,28,-19,49,7,7
1,774,3,1,0,0,0,25,12,7
1,550,3,1,0,0,0,44,13,7
1,310,3,0,0,0,0,23,9,7
2,666,3,1,3,1,2,41,4,7
2,608,3,0,1,3,-2,45,10,7
2,470,3,1,3,1,2,22,24,7
2,336,3,0,1,3,-2,49,19,7
2,99,3,1,3,15,-12,45,5,7
3,557,3,0,15,6,9,48,13,7
3,208,3,0,15,7,8,39,6,7
4,485,3,0,15,17,-2,51,6,7
1,806,3,1,0,0,0,50,4,7
1,728,3,1,0,0,0,11,13,7
1,646,3,1,0,0,0,45,5,7
1,546,3,1,0,0,0,19,10,7
1,470,3,1,0,0,0,51,4,7
1,345,3,1,0,0,0,34,6,7
1,216,3,1,0,0,0,54,10,7
2,746,3,0,0,7,-7,46,2,7
3,853,3,1,15,8,7,27,10,7
3,511,3,0,15,15,0,48,4,7
4,900,3,0,15,18,-3,27,4,7
4,429,3,0,15,28,-13,39,6,7
4,314,3,1,28,15,13,48,6,7
4,105,3,0,15,31,-16,40,4,7
4,57,3,0,15,31,-16,36,9,7
1,120,3,0,7,3,4,36,5,7
1,36,3,1,3,7,-4,30,8,7
2,811,3,1,3,8,-5,44,1,7
2,306,3,1,3,15,-12,52,10,7
2,182,3,0,15,3,12,30,7,7
2,131,3,0,15,10,5,49,6,7
2,74,0,0,15,10,5,23,0,7
3,853,3,1,10,22,-12,45,1,7
3,390,3,1,17,29,-12,44,5,7
3,1,3,0,29,17,12,25,11,7
4,712,3,0,29,24,5,47,10,7
4,267,3,1,24,29,-5,25,20,7
4,34,3,0,32,32,0,40,8,7
1,850,3,1,0,0,0,50,5,7
1,726,3,0,0,0,0,37,10,7
2,467,3,1,0,7,-7,46,20,7
3,689,3,1,7,11,-4,39,6,7
3,396,3,0,12,7,5,20,10,7
3,231,3,0,12,7,5,46,6,7
4,900,3,1,7,12,-5,50,15,7
4,695,3,1,7,12,-5,46,1,7
4,320,3,1,7,15,-8,37,8,7
4,242,3,0,15,7,8,38,5,7
4,113,3,0,15,7,8,49,8,7
1,844,3,1,0,0,0,42,3,7
1,630,3,0,0,7,-7,48,1,7
2,465,3,1,13,0,13,34,2,7
2,323,3,1,13,0,13,52,2,7
2,48,3,1,14,0,14,50,4,7
3,830,3,0,0,14,-14,26,18,7
3,545,3,0,0,17,-17,50,10,7
3,350,3,1,17,0,17,48,6,7
3,163,3,1,17,0,17,37,10,7
3,58,3,0,0,17,-17,50,2,7
4,900,3,1,17,0,17,20,5,7
4,789,3,0,0,17,-17,51,11,7
4,408,3,1,17,0,17,45,10,7
4,331,3,1,17,0,17,17,4,7
1,626,3,1,0,3,-3,19,6,7
1,548,3,0,3,0,3,55,12,7
1,402,3,1,0,3,-3,42,8,7
1,331,3,0,3,0,3,25,9,7
2,882,3,0,3,0,3,47,5,7
2,174,3,0,10,5,5,55,5,7
2,127,3,1,5,10,-5,34,4,7
2,16,3,1,5,10,-5,24,17,7
2,1,1,1,5,10,-5,50,10,7
3,685,3,1,5,13,-8,25,20,7
3,359,3,0,13,5,8,45,6,7
3,302,3,1,5,13,-8,22,9,7
3,1,3,1,5,13,-8,41,9,7
4,576,3,0,16,5,11,47,10,7
4,134,3,0,16,11,5,51,6,7
1,439,3,1,0,7,-7,51,4,7
1,143,3,0,7,0,7,34,8,7
1,68,3,1,0,7,-7,50,3,7
2,321,3,0,7,3,4,42,3,7
2,59,3,1,3,7,-4,44,3,7
3,774,3,0,7,3,4,38,1,7
3,410,3,0,7,8,-1,30,15,7
3,61,3,0,7,11,-4,44,11,7
4,878,3,0,7,11,-4,53,4,7
4,799,3,0,7,11,-4,16,6,7
4,528,3,0,7,14,-7,48,12,7
4,361,3,1,14,7,7,42,10,7
4,191,3,0,7,14,-7,54,13,7
4,130,3,1,14,7,7,26,1,7
1,768,3,0,0,7,-7,38,3,7
1,326,3,0,7,7,0,37,3,7
2,712,3,0,10,7,3,31,4,7
2,1,0,0,17,28,-11,35,0,7
3,81,3,0,20,39,-19,40,5,7
4,631,3,0,20,42,-22,49,6,7
4,434,3,1,42,20,22,26,10,7
1,807,3,0,0,0,0,43,2,7
2,814,3,1,0,2,-2,54,8,7
2,158,3,1,0,9,-9,51,19,7
3,380,3,1,0,17,-17,22,3,7
3,61,3,0,24,8,16,35,6,7
4,240,3,0,24,24,0,51,1,7
1,764,3,0,0,0,0,48,4,7
1,719,3,0,0,0,0,6,9,7
1,527,3,0,0,7,-7,24,13,7
2,874,3,0,7,17,-10,42,8,7
2,36,3,0,21,20,1,42,9,7
3,351,3,0,21,23,-2,35,10,7
1,667,3,1,0,0,0,49,4,7
1,573,3,1,0,0,0,45,7,7
1,436,3,1,0,0,0,52,10,7
2,65,3,0,10,9,1,35,10,7
3,740,3,1,9,10,-1,45,1,7
3,313,3,1,12,10,2,24,10,7
3,1,3,0,17,12,5,47,5,7
4,728,3,1,12,17,-5,39,10,7
4,615,3,0,17,12,5,48,4,7
4,350,3,1,14,17,-3,45,14,7
4,52,3,1,19,17,2,55,6,7
1,410,3,1,0,7,-7,41,14,7
1,326,3,0,7,0,7,35,16,7
2,884,3,1,0,10,-10,43,2,7
2,736,3,0,10,0,10,55,5,7
2,655,3,1,0,10,-10,13,21,7
4,690,3,0,30,20,10,45,5,7
1,750,3,0,0,0,0,54,9,7
1,305,3,1,3,0,3,44,10,7
1,207,3,1,3,0,3,37,4,7
1,6,3,1,3,0,3,41,9,7
2,801,3,1,3,0,3,26,16,7
2,654,3,1,3,0,3,53,15,7
3,43,3,1,27,3,24,50,8,7
4,147,3,0,3,41,-38,38,7,7
4,107,3,1,41,3,38,26,0,7
1,149,3,1,0,7,-7,39,6,7
2,508,3,0,7,7,0,41,1,7
2,179,3,0,7,14,-7,20,8,7
2,132,3,1,14,7,7,55,8,7
2,83,3,0,7,14,-7,20,3,7
2,30,3,0,7,14,-7,42,6,7
3,187,3,0,7,31,-24,29,9,7
4,869,3,1,34,7,27,32,10,7
1,808,3,0,0,0,0,40,9,7
1,736,3,1,0,0,0,34,4,7
1,640,3,0,0,0,0,26,10,7
2,715,3,0,0,11,-11,38,7,7
2,268,3,0,0,21,-21,10,8,7
2,86,3,1,30,0,30,53,3,7
2,51,3,0,0,30,-30,33,2,7
4,44,3,1,41,9,32,50,4,7
1,140,3,1,4,0,4,40,1,7
2,783,3,0,0,4,-4,45,20,7
2,530,3,1,4,1,3,53,12,7
2,406,3,0,1,4,-3,30,19,7
2,262,3,1,4,1,3,45,7,7
3,687,3,1,7,1,6,49,11,7
3,195,3,1,7,3,4,35,14,7
4,775,3,0,6,15,-9,35,10,7
4,662,3,0,6,15,-9,53,3,7
4,581,3,0,6,15,-9,19,12,7
1,745,3,0,0,0,0,39,11,7
1,255,3,1,3,3,0,43,1,7
2,555,3,0,10,6,4,47,10,7
2,288,3,0,10,6,4,22,3,7
2,56,3,0,10,6,4,32,5,7
3,738,3,1,6,10,-4,44,8,7
3,687,3,1,6,10,-4,4,10,7
3,323,3,1,6,13,-7,52,20,7
3,166,3,1,6,13,-7,16,10,7
4,729,3,1,6,20,-14,55,7,7
4,158,3,0,20,12,8,40,5,7
4,34,3,1,12,20,-8,49,6,7
1,501,3,1,0,7,-7,36,10,7
2,95,3,1,6,16,-10,47,9,7
2,65,3,1,6,16,-10,47,5,7
3,306,3,0,23,7,16,25,10,7
3,227,3,1,7,23,-16,55,5,7
4,385,3,0,26,23,3,51,10,7
4,275,3,1,23,26,-3,38,7,7
1,47,3,1,3,0,3,49,9,7
2,612,3,1,3,3,0,36,9,7
2,160,3,0,4,3,1,34,6,7
3,729,3,0,11,13,-2,48,7,7
3,663,3,0,11,13,-2,20,4,7
3,222,3,1,13,14,-1,43,2,7
3,82,3,0,14,13,1,48,3,7
4,756,3,1,13,17,-4,35,10,7
4,325,3,1,13,24,-11,55,10,7
2,821,3,0,7,7,0,43,8,7
2,605,3,0,7,7,0,53,10,7
2,168,3,1,7,10,-3,22,23,7
4,665,3,0,23,17,6,34,11,7
4,551,3,0,23,17,6,53,1,7
4,165,3,1,17,23,-6,49,10,7
4,124,3,1,17,23,-6,17,3,7
1,418,3,0,0,1,-1,54,10,7
2,812,3,0,3,8,-5,30,3,7
2,411,3,1,8,10,-2,33,9,7
2,161,3,1,8,13,-5,42,3,7
3,817,3,0,20,15,5,43,3,7
3,715,3,1,15,20,-5,38,3,7
3,413,3,1,15,27,-12,36,10,7
3,282,3,0,27,15,12,42,15,7
3,120,3,1,15,27,-12,40,20,7
3,62,3,0,27,15,12,24,10,7
1,525,3,0,0,5,-5,44,11,7
1,245,3,0,0,8,-8,35,10,7
2,824,3,0,0,15,-15,17,29,7
2,586,3,0,0,15,-15,43,7,7
2,500,3,1,15,0,15,27,1,7
2,204,3,1,15,7,8,49,11,7
2,115,3,1,15,7,8,33,10,7
2,92,3,0,7,15,-8,26,3,7
2,58,3,1,15,7,8,42,21,7
3,438,3,0,14,15,-1,50,12,7
4,638,3,0,21,18,3,40,5,7
1,760,3,0,0,0,0,20,15,7
1,619,3,0,0,3,-3,35,10,7
1,291,3,1,4,7,-3,26,14,7
1,207,3,0,7,4,3,50,7,7
1,83,3,1,4,7,-3,38,13,7
2,900,3,0,7,4,3,30,11,7
2,736,3,0,7,4,3,42,8,7
2,599,3,0,7,4,3,40,7,7
2,380,3,0,7,7,0,24,13,7
3,650,3,0,13,14,-1,40,25,7
4,819,3,0,13,17,-4,22,7,7
4,741,3,1,17,13,4,48,22,7
4,665,3,0,13,17,-4,20,15,7
4,493,3,1,17,20,-3,38,18,7
4,323,3,1,17,21,-4,29,16,7
4,24,3,0,28,23,5,53,22,7
1,827,3,1,0,0,0,52,6,7
1,642,3,0,0,0,0,28,19,7
1,332,3,0,0,1,-1,43,2,7
2,857,3,1,8,0,8,42,20,7
2,377,3,1,15,14,1,41,4,7
3,315,3,0,17,22,-5,54,1,7
3,151,3,1,22,24,-2,19,10,7
3,16,3,1,22,24,-2,14,29,7
1,168,3,1,7,0,7,46,6,7
2,518,3,1,10,3,7,40,12,7
2,385,3,0,3,10,-7,48,4,7
3,818,3,0,3,10,-7,47,3,7
3,392,3,0,9,11,-2,30,15,7
3,286,3,1,11,9,2,47,12,7
4,770,3,1,11,9,2,36,24,7
1,824,3,0,0,0,0,35,11,7
1,606,3,0,0,3,-3,43,2,7
2,534,3,0,3,17,-14,47,4,7
2,384,3,1,17,3,14,40,4,7
2,41,3,0,3,20,-17,46,3,7
3,818,3,1,20,3,17,30,3,7
3,698,3,0,3,20,-17,35,15,7
4,882,3,0,3,30,-27,46,10,7
4,410,3,1,37,3,34,43,10,7
4,134,3,0,3,37,-34,26,10,7
1,774,3,0,0,0,0,46,10,7
1,424,3,0,0,0,0,22,17,7
1,379,3,1,0,0,0,36,10,7
1,76,3,0,3,0,3,38,10,7
2,870,3,0,3,0,3,23,18,7
2,567,3,0,3,7,-4,48,3,7
2,175,3,0,4,7,-3,52,6,7
2,133,3,1,7,4,3,25,0,7
3,728,3,1,7,11,-4,49,14,7
3,625,3,1,7,11,-4,25,12,7
3,465,3,1,7,11,-4,46,4,7
4,656,3,0,14,10,4,41,10,7
4,463,3,0,14,17,-3,36,5,7
4,403,3,1,17,14,3,47,10,7
4,286,3,0,14,17,-3,40,10,7
4,197,3,1,17,14,3,51,7,7
1,810,3,0,0,0,0,42,14,7
1,427,3,0,0,14,-14,25,15,7
2,793,3,1,17,0,17,52,5,7
2,705,3,1,17,0,17,15,7,7
2,624,3,1,17,0,17,53,11,7
2,450,3,1,17,0,17,35,5,7
2,157,3,0,0,20,-20,29,16,7
2,85,3,1,20,0,20,47,8,7
3,623,3,0,1,20,-19,27,17,7
3,460,3,0,1,20,-19,45,11,7
4,395,3,0,5,23,-18,30,15,7
4,299,3,1,23,5,18,49,24,7
4,146,3,1,23,5,18,11,6,7
4,88,3,0,5,23,-18,51,9,7
1,261,3,1,3,3,0,43,11,7
3,687,3,0,24,13,11,48,13,7
3,614,3,0,24,13,11,24,5,7
3,543,3,0,24,13,11,51,16,7
3,477,3,0,24,13,11,18,11,7
4,96,3,1,16,33,-17,36,19,7
4,47,3,0,33,16,17,39,3,7
1,665,3,0,0,3,-3,35,10,7
1,357,3,0,0,4,-4,43,13,7
2,781,3,0,0,4,-4,30,15,7
2,615,3,0,0,4,-4,40,5,7
2,131,3,1,11,6,5,42,3,7
2,56,3,0,6,11,-5,43,8,7
3,851,3,0,6,11,-5,39,3,7
3,694,0,1,11,6,5,41,0,7
3,535,3,0,6,14,-8,35,10,7
3,288,3,1,14,6,8,55,13,7
3,212,3,0,6,14,-8,27,6,7
1,185,3,0,1,0,1,53,15,7
2,656,3,1,7,1,6,29,5,7
2,165,3,0,4,10,-6,35,10,7
2,131,3,1,10,4,6,47,9,7
3,770,3,1,16,4,12,47,10,7
3,166,3,0,7,23,-16,20,3,7
4,611,3,1,24,7,17,50,7,7
4,310,3,1,24,10,14,28,18,7
4,84,3,0,17,24,-7,36,3,7
4,9,2,0,17,24,-7,31,10,7
1,633,3,1,0,0,0,51,17,7
1,547,3,1,0,0,0,37,7,7
1,193,3,0,0,1,-1,49,10,7
1,30,3,1,1,0,1,50,2,7
2,650,3,1,1,0,1,50,3,7
2,581,3,0,0,1,-1,27,9,7
2,52,3,0,3,15,-12,22,10,7
2,28,3,0,3,15,-12,47,3,7
4,352,3,0,3,50,-47,37,3,7
4,226,3,1,50,3,47,20,9,7
4,95,3,1,50,11,39,36,14,7
1,764,3,0,0,0,0,18,9,7
1,584,3,0,0,7,-7,49,3,7
1,349,3,1,7,1,6,41,4,7
1,14,3,1,7,1,6,48,13,7
2,600,3,0,1,15,-14,41,4,7
2,388,3,0,1,22,-21,42,8,7
2,297,3,1,22,1,21,33,3,7
3,826,3,0,4,29,-25,35,2,7
3,288,3,1,36,11,25,23,2,7
3,112,3,1,36,18,18,33,7,7
4,885,3,0,18,36,-18,48,18,7
4,719,3,1,36,18,18,44,6,7
4,452,3,0,18,36,-18,29,8,7
1,691,3,0,0,0,0,54,7,7
1,599,3,1,0,0,0,17,15,7
1,229,3,0,0,7,-7,27,12,7
2,726,3,0,0,14,-14,50,7,7
2,52,3,1,17,7,10,48,1,7
3,773,3,0,7,17,-10,54,4,7
3,665,3,0,7,17,-10,55,7,7
3,179,3,0,7,20,-13,37,8,7
3,41,3,1,20,7,13,28,8,7
4,279,3,1,20,13,7,38,7,7
1,640,3,0,0,3,-3,40,5,7
1,560,3,1,3,0,3,41,6,7
2,749,3,0,0,7,-7,43,9,7
2,390,3,0,0,10,-10,38,8,7
2,101,3,0,0,17,-17,52,10,7
2,71,3,1,17,0,17,16,10,7
3,824,3,1,17,7,10,45,10,7
3,660,3,1,17,7,10,50,5,7
3,33,3,1,18,10,8,30,15,7
4,697,3,0,10,18,-8,50,10,7
4,517,3,1,18,10,8,33,1,7
4,466,3,0,10,18,-8,35,15,7
4,119,3,0,10,18,-8,50,26,7
1,344,3,1,0,7,-7,38,12,7
1,24,3,0,7,3,4,36,5,7
2,26,3,0,14,13,1,50,10,7
3,555,3,1,20,14,6,42,1,7
4,900,3,1,27,17,10,37,7,7
4,822,3,0,17,27,-10,50,9,7
4,245,3,0,24,30,-6,41,4,7
1,803,3,1,0,0,0,49,2,7
1,716,3,1,0,0,0,24,4,7
1,607,3,1,0,0,0,50,2,7
1,15,3,1,7,0,7,45,15,7
2,799,3,0,0,7,-7,35,10,7
2,451,3,0,0,10,-10,42,4,7
3,710,3,0,0,27,-27,22,20,7
3,452,3,0,0,34,-34,26,9,7
4,518,3,0,7,37,-30,35,4,7
4,422,3,1,37,7,30,36,10,7
4,292,3,0,7,37,-30,49,2,7
4,190,3,1,37,7,30,10,13,7
4,94,3,1,37,10,27,43,2,7
1,845,3,1,0,0,0,33,6,7
1,234,3,0,0,6,-6,48,6,7
2,217,3,1,6,6,0,36,6,7
2,158,3,0,6,6,0,46,10,7
3,839,3,0,13,6,7,28,6,7
3,656,3,0,13,7,6,31,14,7
3,554,3,1,7,13,-6,36,8,7
3,55,3,1,14,20,-6,48,4,7
4,200,3,0,34,20,14,30,12,7
4,7,3,1,27,34,-7,47,5,7
2,620,3,1,6,3,3,42,10,7
2,540,3,0,3,6,-3,49,6,7
2,446,3,1,6,3,3,44,3,7
2,366,3,0,3,6,-3,26,7,7
3,659,3,0,6,9,-3,16,21,7
3,332,3,0,6,12,-6,39,6,7
3,103,3,1,12,6,6,30,18,7
1,632,3,0,0,0,0,33,12,7
1,715,3,0,0,0,0,37,5,7
1,354,3,0,0,0,0,6,9,7
1,270,3,1,0,0,0,50,20,7
1,90,3,1,0,1,-1,44,1,7
1,1,3,0,1,0,1,40,9,7
2,338,3,0,4,0,4,47,4,7
2,129,3,0,4,3,1,26,24,7
3,752,3,0,12,3,9,53,14,7
3,633,3,1,3,12,-9,34,7,7
3,457,3,0,12,3,9,29,35,7
3,386,3,1,3,12,-9,38,10,7
3,35,3,1,3,19,-16,49,9,7
2,747,3,0,3,7,-4,54,5,7
2,195,3,1,7,20,-13,42,4,7
3,167,3,0,30,7,23,50,8,7
3,80,3,0,30,7,23,5,10,7
4,412,3,1,10,30,-20,39,5,7
4,152,3,1,10,30,-20,20,10,7
2,664,3,1,7,13,-6,45,7,7
2,262,3,1,7,20,-13,39,10,7
2,135,3,0,20,7,13,50,4,7
3,667,3,1,7,20,-13,52,6,7
3,599,3,1,7,20,-13,19,8,7
3,384,0,1,7,23,-16,35,0,7
3,199,3,0,23,7,16,47,10,7
4,547,3,0,26,13,13,46,10,7
4,384,3,0,26,13,13,47,1,7
1,290,3,0,3,6,-3,30,5,7
1,130,3,0,3,6,-3,32,4,7
3,357,3,0,16,19,-3,22,10,7
4,295,3,1,30,30,0,24,9,7
1,429,3,1,6,0,6,27,10,7
1,273,3,1,6,0,6,50,7,7
1,203,3,1,6,0,6,14,6,7
1,203,3,1,6,0,6,14,6,7
1,117,3,0,0,6,-6,46,10,7
2,168,3,1,13,5,8,29,7,7
2,38,3,1,13,5,8,45,10,7
4,538,3,1,16,20,-4,34,10,7
4,352,3,0,20,16,4,40,25,7
1,165,3,0,7,7,0,47,14,7
1,55,3,1,7,7,0,29,4,7
2,825,3,1,7,15,-8,31,27,7
3,778,3,0,18,10,8,27,17,7
3,212,3,1,18,18,0,30,1,7
4,202,3,0,22,18,4,14,15,7
1,593,3,1,2,0,2,34,25,7
1,528,3,0,0,2,-2,17,10,7
2,737,3,0,7,10,-3,55,5,7
2,132,3,1,10,10,0,42,3,7
2,62,3,0,10,10,0,50,13,7
3,283,3,0,10,16,-6,32,20,7
4,129,3,1,26,11,15,36,7,7
1,562,3,0,0,0,0,48,7,7
1,354,3,0,0,0,0,42,26,7
1,292,3,1,0,0,0,26,2,7
2,602,3,1,7,7,0,38,8,7
2,37,3,1,14,15,-1,39,2,7
4,900,3,0,23,23,0,28,1,7
4,171,3,1,26,30,-4,55,3,7
1,0,3,1,7,10,-3,22,19,7
2,828,3,1,7,17,-10,27,20,7
2,491,3,1,7,31,-24,45,3,7
2,160,3,1,7,38,-31,21,4,7
2,109,3,0,38,7,31,48,18,7
3,166,3,0,41,18,23,46,19,7
4,224,3,0,52,26,26,52,10,7
1,590,3,1,0,0,0,54,10,7
1,50,3,0,0,7,-7,44,29,7
2,900,3,0,0,7,-7,47,5,7
2,769,3,0,0,7,-7,19,18,7
2,506,3,0,0,10,-10,40,5,7
1,229,3,0,3,0,3,40,4,7
1,129,3,0,3,0,3,13,15,7
1,78,3,0,3,0,3,42,10,7
2,725,3,1,0,3,-3,16,9,7
2,70,3,1,7,7,0,52,11,7
2,30,3,0,7,7,0,27,3,7
3,680,3,0,9,10,-1,26,20,7
4,359,3,0,16,27,-11,41,10,7
2,640,3,0,10,3,7,18,10,7
2,124,3,0,10,9,1,54,5,7
3,96,3,0,11,21,-10,43,2,7
1,542,3,1,0,0,0,28,7,7
1,371,3,0,0,7,-7,31,4,7
2,815,3,0,0,20,-20,15,15,7
2,504,3,0,0,26,-26,41,10,7
2,344,3,0,0,29,-29,40,5,7
3,850,3,1,36,11,25,32,6,7
3,330,3,0,14,43,-29,42,6,7
3,253,3,1,43,14,29,37,15,7
3,192,3,0,14,43,-29,42,10,7
4,360,3,0,17,46,-29,50,5,7
4,159,3,1,46,17,29,29,6,7
1,833,3,1,0,0,0,18,8,7
1,287,3,0,0,3,-3,37,18,7
2,59,3,1,12,10,2,54,3,7
3,569,3,0,13,19,-6,44,20,7
3,439,3,0,13,19,-6,33,3,7
4,564,3,0,20,25,-5,40,5,7
4,143,3,1,25,23,2,40,5,7
1,742,3,1,0,0,0,46,4,7
1,530,3,1,0,0,0,36,11,7
1,269,3,1,0,7,-7,40,4,7
2,833,3,0,7,3,4,51,5,7
2,453,3,1,6,7,-1,38,6,7
2,148,3,0,7,6,1,50,14,7
2,24,3,1,6,7,-1,38,30,7
3,562,3,0,7,9,-2,40,5,7
4,647,3,0,22,12,10,43,7,7
1,730,3,1,0,0,0,13,6,7
1,655,3,1,0,0,0,49,6,7
1,274,3,1,0,0,0,40,10,7
2,874,3,1,0,7,-7,22,6,7
2,288,3,0,7,14,-7,15,3,7
3,489,3,1,22,14,8,24,15,7
3,177,3,0,17,22,-5,46,11,7
3,41,3,1,22,17,5,31,5,7
4,690,3,1,22,20,2,30,15,7
4,624,3,0,20,22,-2,32,15,7
1,687,3,1,1,0,1,46,3,7
1,547,3,1,1,0,1,43,12,7
1,409,3,0,0,1,-1,34,10,7
1,289,3,1,1,0,1,45,15,7
2,571,3,1,4,7,-3,26,5,7
2,146,3,0,7,4,3,26,6,7
3,733,3,0,10,7,3,45,10,7
3,306,3,1,14,10,4,45,10,7
3,140,3,0,10,14,-4,52,10,7
4,675,3,0,13,14,-1,51,3,7
4,589,3,0,13,14,-1,8,24,7
4,131,3,0,13,17,-4,39,4,7
4,69,3,0,13,17,-4,42,10,7
1,824,3,0,0,0,0,52,7,7
1,486,3,1,0,2,-2,17,8,7
1,203,3,1,0,5,-5,38,7,7
1,74,3,1,0,5,-5,22,10,7
2,886,3,1,0,5,-5,43,3,7
2,523,3,0,5,0,5,53,2,7
3,434,3,1,6,11,-5,35,10,7
1,419,3,0,7,0,7,49,6,7
1,87,3,1,0,7,-7,47,3,7
2,50,3,0,9,4,5,55,2,7
4,404,3,0,27,14,13,36,9,7
4,128,3,0,27,17,10,41,4,7
1,837,3,1,0,1,-1,40,5,7
1,559,3,1,0,8,-8,22,7,7
2,900,3,0,16,8,8,39,8,7
2,370,3,1,16,16,0,11,17,7
2,48,3,1,16,16,0,54,3,7
3,792,3,0,16,16,0,47,8,7
3,535,3,0,16,16,0,51,3,7
4,830,3,1,23,22,1,30,6,7
4,61,3,1,26,25,1,23,4,7
1,797,3,1,0,0,0,46,6,7
1,734,3,0,0,0,0,43,10,7
1,662,3,1,0,0,0,28,10,7
2,616,3,1,8,19,-11,43,3,7
2,285,3,0,19,11,8,30,15,7
2,63,3,1,17,19,-2,51,10,7
3,733,3,1,17,19,-2,52,8,7
3,670,3,1,17,19,-2,4,10,7
4,578,3,0,23,20,3,54,10,7
4,8,3,0,26,26,0,47,15,7
1,823,3,1,0,0,0,33,1,7
1,88,3,0,0,14,-14,26,16,7
2,421,3,0,7,21,-14,51,21,7
2,265,3,1,21,7,14,36,3,7
2,123,3,1,21,7,14,55,5,7
2,35,3,0,7,21,-14,29,12,7
3,614,3,1,21,10,11,36,9,7
3,540,3,0,10,21,-11,34,6,7
3,158,3,1,21,18,3,19,6,7
4,691,3,1,21,21,0,35,10,7
1,531,3,0,0,0,0,47,28,7
2,851,3,1,1,3,-2,54,6,7
2,445,3,0,3,4,-1,39,25,7
2,382,3,1,4,3,1,30,3,7
2,322,3,0,3,4,-1,35,4,7
2,239,3,1,4,3,1,35,7,7
2,49,3,0,3,4,-1,37,4,7
3,780,3,0,3,4,-1,52,10,7
3,581,3,0,3,4,-1,17,10,7
3,525,3,0,3,4,-1,52,9,7
3,457,3,0,3,4,-1,9,15,7
4,870,3,0,3,18,-15,54,3,7
4,796,3,1,18,3,15,26,7,7
4,629,3,0,3,18,-15,42,6,7
4,163,3,0,3,32,-29,40,6,7
4,69,3,0,3,32,-29,47,18,7
1,118,3,1,3,7,-4,37,16,7
2,169,3,1,6,11,-5,49,10,7
3,346,3,1,21,17,4,43,18,7
3,50,3,0,17,21,-4,54,15,7
4,760,3,1,21,20,1,18,27,7
1,248,3,0,3,7,-4,15,7,7
2,381,3,0,6,7,-1,29,3,7
2,79,3,1,7,13,-6,38,15,7
3,258,3,1,10,15,-5,30,29,7
4,108,0,1,13,18,-5,50,0,7
1,894,1,1,0,0,0,44,10,4
1,854,2,1,0,0,0,51,3,4
1,710,1,0,0,0,0,37,10,4
1,644,1,0,0,0,0,11,10,4
1,621,2,0,0,0,0,18,3,4
1,344,1,1,0,0,0,21,10,4
1,309,2,1,0,0,0,28,3,4
1,27,1,0,0,3,-3,50,10,4
2,842,2,1,3,0,3,21,1,4
2,791,1,1,3,0,3,20,10,4
2,670,2,0,7,3,4,49,3,4
2,631,1,1,3,7,-4,8,10,4
2,558,1,1,3,7,-4,47,10,4
2,475,2,0,7,3,4,50,10,4
2,423,1,0,7,3,4,12,10,4
2,395,1,0,7,3,4,23,10,4
2,85,2,1,3,14,-11,48,5,4
2,46,1,0,14,3,11,23,10,4
3,894,1,0,14,3,11,35,10,4
3,850,2,0,14,3,11,39,6,4
3,832,1,0,14,3,11,54,10,4
3,804,2,1,3,14,-11,46,0,4
3,704,1,1,3,14,-11,5,5,4
3,626,1,1,3,17,-14,32,10,4
3,587,2,1,3,17,-14,34,8,4
3,485,3,0,17,3,14,52,14,4
3,208,1,0,17,6,11,35,10,4
3,175,1,0,17,6,11,49,10,4
3,97,2,1,6,17,-11,30,10,4
4,894,1,1,6,24,-18,33,10,4
4,837,1,0,24,6,18,24,10,4
4,740,1,0,24,6,18,3,3,4
4,662,3,0,24,6,18,6,6,4
4,597,1,0,24,6,18,45,10,4
4,584,1,0,24,6,18,45,10,4
4,512,1,1,6,24,-18,35,10,4
4,464,2,1,6,24,-18,40,5,4
4,376,2,1,6,24,-18,48,2,4
4,341,3,1,6,24,-18,49,1,4
4,292,2,0,24,6,18,44,3,4
4,155,3,0,24,6,18,18,1,4
4,122,1,0,24,6,18,50,10,4
4,23,1,0,24,6,18,55,10,4
4,16,2,0,24,6,18,55,10,4
4,14,3,1,6,24,-18,49,4,4
1,834,1,0,0,0,0,28,10,4
1,753,1,0,0,0,0,1,1,4
1,701,2,0,0,7,-7,31,15,4
1,383,1,1,7,3,4,25,10,4
1,212,1,0,3,7,-4,42,10,4
1,190,1,0,3,7,-4,54,10,4
2,860,1,1,7,6,1,37,10,4
2,680,1,0,13,7,6,53,10,4
2,608,1,1,7,13,-6,32,10,4
2,359,1,1,7,16,-9,30,10,4
2,5,1,1,10,23,-13,30,10,4
3,770,1,0,23,10,13,49,10,4
3,654,1,0,23,10,13,4,10,4
3,269,1,1,12,26,-14,35,10,4
3,229,2,1,12,26,-14,43,2,4
3,138,1,0,26,12,14,53,10,4
3,70,1,1,12,26,-14,22,10,4
4,900,1,1,12,26,-14,54,10,4
4,817,1,1,12,26,-14,1,1,4
4,705,1,0,33,19,14,32,10,4
4,512,2,1,19,33,-14,33,10,4
4,449,2,1,19,33,-14,43,10,4
4,395,3,1,19,33,-14,52,1,4
4,319,1,0,33,19,14,38,10,4
4,116,1,0,33,26,7,51,5,4
1,573,1,0,0,0,0,6,6,4
1,416,1,1,7,0,7,19,10,4
1,374,2,1,7,0,7,28,1,4
1,341,3,1,7,0,7,28,1,4
1,208,1,0,0,7,-7,43,10,4
2,900,1,1,7,0,7,8,10,4
2,775,2,1,7,0,7,46,3,4
2,651,1,0,0,7,-7,42,10,4
2,325,1,1,14,7,7,21,10,4
2,240,1,1,14,7,7,33,10,4
2,19,2,1,14,7,7,4,15,4
3,850,2,0,9,14,-5,38,4,4
3,682,1,0,9,14,-5,5,5,4
3,451,2,1,21,9,12,44,2,4
3,344,1,1,21,9,12,4,4,4
3,253,1,1,21,9,12,1,1,4
3,236,1,1,21,16,5,30,10,4
3,91,3,1,21,16,5,52,0,4
3,76,1,1,21,16,5,52,10,4
3,1,1,0,16,21,-5,47,10,4
4,748,2,0,16,22,-6,46,1,4
4,545,1,0,19,22,-3,47,10,4
4,360,1,0,19,22,-3,2,2,4
4,126,2,0,19,29,-10,46,0,4
4,84,3,1,29,19,10,32,1,4
1,852,1,1,0,0,0,26,10,4
1,830,3,1,0,0,0,36,0,4
1,720,1,0,0,0,0,49,10,4
1,633,1,1,0,0,0,54,10,4
1,618,2,1,0,0,0,46,2,4
1,585,1,1,0,0,0,41,10,4
1,370,1,1,0,3,-3,47,20,4
1,264,1,1,0,3,-3,55,10,4
1,157,1,0,3,7,-4,41,10,4
2,861,1,0,10,7,3,5,15,4
2,767,1,1,7,10,-3,49,10,4
2,708,1,1,7,10,-3,24,10,4
2,573,1,1,7,11,-4,35,10,4
2,498,1,0,11,7,4,35,10,4
2,430,1,0,11,7,4,48,10,4
2,397,2,0,11,7,4,52,6,4
2,380,1,1,7,11,-4,49,10,4
2,264,2,1,7,11,-4,19,10,4
2,162,1,0,11,14,-3,48,10,4
2,1,2,0,11,14,-3,36,13,4
3,893,1,0,11,14,-3,37,10,4
3,755,1,1,14,11,3,32,10,4
3,721,2,1,14,11,3,31,11,4
3,659,1,0,11,14,-3,31,10,4
3,605,1,0,11,14,-3,49,10,4
3,395,1,1,14,11,3,25,10,4
3,266,2,1,14,14,0,33,2,4
3,220,1,1,14,14,0,35,10,4
3,77,1,0,14,14,0,7,10,4
4,900,1,1,21,14,7,39,10,4
4,681,1,1,21,14,7,24,10,4
4,485,2,0,17,21,-4,27,5,4
4,442,1,0,17,21,-4,34,10,4
4,280,2,0,17,21,-4,51,3,4
4,249,1,0,17,21,-4,33,10,4
4,156,1,1,24,17,7,49,10,4
4,97,1,1,24,17,7,1,1,4
4,85,2,1,24,17,7,1,1,4
4,49,1,1,24,24,0,33,10,4
1,892,1,0,0,0,0,16,10,4
1,809,1,1,0,0,0,50,10,4
1,735,1,0,0,0,0,18,10,4
1,713,2,0,0,0,0,22,6,4
1,582,1,1,0,0,0,39,10,4
1,455,2,1,0,0,0,54,2,4
1,369,1,0,2,0,2,37,10,4
1,342,2,0,2,0,2,43,4,4
1,116,1,0,2,0,2,17,10,4
1,45,1,0,2,0,2,3,3,4
2,875,1,1,7,2,5,40,10,4
2,665,1,1,7,3,4,4,4,4
2,599,2,1,7,3,4,1,1,4
2,566,1,1,7,10,-3,37,10,4
2,536,2,1,7,10,-3,47,0,4
2,498,1,1,7,10,-3,49,10,4
2,482,1,0,10,7,3,49,10,4
2,402,1,0,10,7,3,16,10,4
2,121,1,1,7,10,-3,6,6,4
2,116,1,1,7,17,-10,43,10,4
2,78,2,0,17,14,3,44,1,4
3,891,1,1,14,18,-4,34,10,4
3,661,1,0,18,14,4,1,1,4
3,462,1,0,18,21,-3,54,10,4
3,421,2,0,18,21,-3,45,1,4
3,340,1,0,18,24,-6,35,10,4
3,310,2,0,18,24,-6,44,1,4
3,154,1,1,24,18,6,30,10,4
3,87,3,1,24,18,6,39,1,4
3,1,2,1,24,18,6,50,2,4
4,900,3,1,24,18,6,51,1,4
4,675,2,1,31,18,13,46,3,4
4,617,2,1,31,25,6,43,2,4
4,520,1,0,25,31,-6,30,10,4
4,455,1,0,25,31,-6,43,10,4
4,441,1,0,25,31,-6,21,10,4
4,400,1,0,25,31,-6,10,10,4
4,250,1,0,25,38,-13,23,10,4
4,138,1,0,25,41,-16,10,10,4
4,118,1,0,25,48,-23,28,10,4
4,112,2,0,25,48,-23,30,8,4
4,38,1,1,48,25,23,21,10,4
4,30,2,1,48,25,23,30,1,4
1,878,1,1,0,0,0,34,10,4
1,648,2,0,0,0,0,28,2,4
1,609,3,0,0,0,0,29,1,4
1,568,1,0,0,0,0,31,10,4
1,552,2,0,0,0,0,31,10,4
1,494,1,0,0,0,0,53,10,4
1,470,2,0,0,0,0,48,5,4
1,308,1,0,0,3,-3,46,10,4
1,71,1,1,3,0,3,24,10,4
2,859,1,1,3,7,-4,50,10,4
2,672,1,0,7,10,-3,36,10,4
2,563,1,0,7,10,-3,53,10,4
2,293,1,0,7,10,-3,28,10,4
2,226,3,0,7,10,-3,38,0,4
2,193,1,0,7,10,-3,37,10,4
2,173,1,0,7,10,-3,26,10,4
2,154,2,0,7,10,-3,19,3,4
2,140,3,0,7,10,-3,16,0,4
2,66,1,1,17,14,3,37,15,4
3,739,1,0,17,17,0,38,10,4
3,665,1,1,17,17,0,10,10,4
3,440,1,1,17,17,0,47,10,4
3,421,2,1,17,17,0,45,8,4
3,287,1,1,17,20,-3,35,10,4
3,193,1,0,20,17,3,42,10,4
3,141,1,1,17,20,-3,17,10,4
3,80,1,1,17,23,-6,35,10,4
4,869,1,1,17,23,-6,5,5,4
4,820,2,1,17,23,-6,2,2,4
4,718,1,0,26,17,9,31,10,4
4,535,1,0,26,20,6,54,10,4
4,501,2,0,26,20,6,46,2,4
4,210,1,0,26,20,6,1,1,4
1,895,1,1,0,0,0,34,10,4
1,808,1,0,0,0,0,48,10,4
1,697,1,0,0,0,0,1,1,4
1,675,1,0,0,7,-7,11,10,4
1,465,1,0,0,10,-10,47,10,4
1,232,1,0,0,10,-10,38,10,4
1,85,1,1,17,0,17,27,10,4
1,6,1,1,17,0,17,54,10,4
2,900,2,1,17,0,17,55,9,4
2,838,1,0,0,17,-17,20,10,4
2,536,2,1,17,0,17,27,3,4
2,525,1,1,17,0,17,36,10,4
2,347,3,1,17,0,17,4,1,4
2,299,1,1,17,0,17,2,2,4
2,190,1,0,7,17,-10,37,10,4
2,152,2,0,7,17,-10,38,19,4
2,42,2,0,7,17,-10,49,2,4
3,807,2,0,7,20,-13,35,10,4
3,742,1,0,7,20,-13,43,10,4
3,683,1,0,7,20,-13,33,10,4
3,625,1,0,7,20,-13,1,1,4
3,548,1,0,7,23,-16,35,10,4
3,521,2,0,7,23,-16,40,5,4
3,444,1,1,23,7,16,25,10,4
3,190,1,1,30,7,23,32,10,4
3,150,2,1,30,7,23,37,5,4
3,1,1,0,7,30,-23,11,10,4
4,799,1,1,30,7,23,25,10,4
4,767,2,1,30,7,23,33,2,4
4,725,1,1,30,7,23,39,10,4
4,526,2,1,37,7,30,41,2,4
4,459,1,1,37,13,24,47,10,4
4,393,1,0,13,37,-24,47,10,4
4,359,2,0,13,37,-24,55,2,4
4,305,2,1,37,13,24,20,1,4
4,249,1,1,37,20,17,48,10,4
4,118,1,1,37,34,3,38,10,4
4,37,2,0,34,37,-3,50,10,4
1,882,1,1,0,0,0,49,10,4
1,785,2,0,0,0,0,26,6,4
1,741,1,0,0,1,-1,35,10,4
1,670,0,0,0,1,-1,40,0,4
1,543,3,0,0,1,-1,13,12,4
1,375,1,0,0,1,-1,52,10,4
1,211,1,0,0,8,-8,36,10,4
1,135,1,1,8,0,8,16,10,4
1,52,1,0,0,8,-8,42,10,4
2,900,1,1,8,0,8,54,10,4
2,871,2,1,8,0,8,45,1,4
2,833,1,1,8,0,8,25,10,4
2,767,1,1,8,0,8,7,7,4
2,599,1,1,8,3,5,45,10,4
2,498,1,1,8,3,5,42,10,4
2,413,1,1,8,3,5,29,10,4
2,320,2,1,8,10,-2,15,1,4
2,281,3,1,8,10,-2,16,0,4
2,157,3,0,10,8,2,42,0,4
2,35,2,1,8,17,-9,26,10,4
3,889,1,0,17,8,9,35,10,4
3,866,2,0,17,8,9,40,5,4
3,792,1,1,8,17,-9,53,10,4
3,746,1,1,8,17,-9,17,10,4
3,618,1,0,17,8,9,36,10,4
3,552,1,0,17,8,9,50,10,4
3,510,2,1,8,17,-9,54,4,4
3,463,1,1,8,17,-9,24,10,4
3,428,2,1,8,17,-9,27,7,4
3,343,1,0,17,8,9,42,10,4
3,152,1,0,17,8,9,36,10,4
4,900,1,1,8,17,-9,45,10,4
4,869,1,1,8,17,-9,16,10,4
4,830,2,1,8,17,-9,10,4,4
4,532,1,0,20,9,11,45,10,4
4,422,1,1,9,20,-11,27,10,4
4,282,1,0,20,9,11,23,10,4
4,159,2,1,9,20,-11,51,3,4
4,151,1,1,9,20,-11,47,10,4
4,131,2,1,9,20,-11,45,8,4
4,125,3,1,9,20,-11,37,0,4
4,104,1,1,9,20,-11,35,10,4
4,80,2,1,9,20,-11,30,5,4
4,48,3,1,9,20,-11,32,7,4
1,894,1,0,0,0,0,35,10,4
1,721,1,1,0,0,0,32,10,4
1,598,1,0,0,0,0,29,10,4
1,478,1,1,0,0,0,46,10,4
1,444,1,0,0,0,0,45,10,4
1,343,1,1,2,0,2,41,10,4
1,257,1,0,0,2,-2,7,10,4
2,857,1,0,7,2,5,33,10,4
2,646,1,0,7,9,-2,27,10,4
2,568,1,1,9,7,2,32,10,4
2,461,2,1,9,7,2,16,2,4
2,411,1,1,9,7,2,8,8,4
2,324,1,1,9,10,-1,35,10,4
2,285,2,1,9,10,-1,41,4,4
2,249,1,1,9,10,-1,47,10,4
3,871,2,1,9,10,-1,37,0,4
3,834,1,0,10,9,1,42,10,4
3,698,1,0,10,10,0,46,10,4
3,456,1,0,17,10,7,54,10,4
3,368,1,0,17,10,7,54,10,4
3,335,2,0,17,10,7,50,6,4
3,295,1,0,17,10,7,41,10,4
3,210,2,0,17,10,7,1,1,4
3,181,1,0,17,17,0,41,10,4
3,86,1,1,17,17,0,40,10,4
3,9,1,0,17,17,0,15,10,4
4,900,2,0,17,17,0,25,0,4
4,877,1,0,17,17,0,28,10,4
4,681,1,1,17,17,0,44,10,4
4,650,2,1,17,17,0,54,0,4
4,611,1,0,17,17,0,54,10,4
4,384,1,1,17,17,0,37,10,4
4,340,2,1,17,17,0,31,4,4
4,258,2,1,17,20,-3,44,1,4
4,104,1,1,24,20,4,54,10,4
4,99,2,0,20,24,-4,49,3,4
4,78,1,0,20,24,-4,45,10,4
4,72,2,0,20,24,-4,36,1,4
4,46,1,0,20,24,-4,32,10,4
1,892,1,1,0,0,0,29,10,4
1,727,1,1,0,0,0,21,10,4
1,657,1,1,0,7,-7,30,10,4
1,613,2,1,0,7,-7,27,13,4
1,413,1,1,0,7,-7,40,10,4
1,376,2,1,0,7,-7,47,3,4
1,345,1,1,0,7,-7,52,10,4
1,267,1,0,7,0,7,15,10,4
1,236,1,0,7,0,7,25,10,4
1,193,2,0,7,0,7,32,3,4
1,155,1,0,7,0,7,37,10,4
1,108,2,0,7,0,7,42,5,4
1,66,1,0,7,0,7,50,10,4
2,717,1,1,0,7,-7,50,10,4
2,664,1,0,7,0,7,28,10,4
2,505,1,0,7,1,6,8,8,4
2,474,2,0,7,1,6,1,1,4
2,455,1,0,7,8,-1,33,10,4
2,410,2,0,7,8,-1,39,4,4
2,166,1,0,10,8,2,33,10,4
2,149,1,0,10,8,2,19,10,4
2,63,1,1,9,10,-1,54,10,4
3,893,1,0,10,9,1,28,10,4
3,853,2,0,10,9,1,33,5,4
3,803,1,1,9,10,-1,29,10,4
3,784,2,1,9,10,-1,37,2,4
3,405,1,1,9,13,-4,53,10,4
3,371,1,0,13,9,4,21,10,4
4,883,1,1,9,16,-7,35,10,4
4,748,1,0,16,9,7,50,10,4
4,662,1,0,16,9,7,20,10,4
4,607,1,0,16,9,7,10,10,4
4,536,1,0,16,12,4,35,10,4
4,465,1,1,12,16,-4,38,10,4
4,275,1,0,19,12,7,49,10,4
4,230,1,1,12,19,-7,45,10,4
4,210,2,1,12,19,-7,38,3,4
4,172,1,1,12,19,-7,44,20,4
4,80,1,1,12,22,-10,48,10,4
4,60,2,1,12,22,-10,41,3,4
4,47,1,1,12,22,-10,16,10,4
4,35,2,1,12,22,-10,16,10,4
1,817,1,1,0,0,0,42,10,4
1,709,3,0,0,0,0,44,1,4
1,651,1,0,0,0,0,20,10,4
1,525,1,0,0,3,-3,29,10,4
2,633,2,1,10,5,5,48,12,4
2,369,1,0,5,17,-12,30,10,4
2,256,1,1,17,5,12,43,15,4
2,241,2,1,17,5,12,41,13,4
2,161,2,1,17,5,12,16,3,4
2,80,1,1,17,5,12,17,10,4
2,28,1,1,17,5,12,4,4,4
3,467,1,0,8,34,-26,32,10,4
3,324,1,0,8,34,-26,39,10,4
3,298,2,0,8,34,-26,43,6,4
3,147,1,1,34,8,26,42,10,4
3,120,2,1,34,8,26,36,4,4
4,857,1,1,34,8,26,1,1,4
4,332,1,0,22,34,-12,38,10,4
4,308,2,0,22,34,-12,29,1,4
4,243,1,0,22,37,-15,35,10,4
4,111,1,1,37,29,8,22,10,4
4,104,2,1,37,29,8,30,2,4
4,79,3,1,37,29,8,31,1,4
4,66,1,1,37,29,8,33,10,4
4,61,2,1,37,29,8,37,6,4
1,690,1,1,7,1,6,35,10,4
1,661,2,1,7,1,6,42,3,4
1,575,1,0,1,7,-6,38,10,4
1,435,1,0,1,7,-6,48,10,4
1,403,2,0,1,7,-6,43,5,4
1,380,3,0,1,7,-6,38,0,4
1,345,1,0,1,7,-6,36,10,4
1,127,2,0,1,10,-9,45,1,4
1,98,1,0,1,10,-9,46,10,4
1,72,1,1,10,1,9,46,10,4
2,846,1,0,2,10,-8,27,10,4
2,612,1,1,13,2,11,25,10,4
2,446,1,1,13,2,11,43,10,4
2,369,1,0,2,13,-11,20,10,4
2,263,1,0,2,13,-11,50,10,4
2,198,1,1,13,2,11,43,10,4
2,89,2,0,5,13,-8,30,15,4
3,642,1,1,16,8,8,35,10,4
3,597,2,1,16,8,8,30,15,4
3,567,1,0,8,16,-8,32,10,4
3,418,1,0,8,16,-8,1,1,4
3,327,1,1,23,8,15,21,10,4
4,750,2,1,30,28,2,23,20,4
4,640,1,1,30,28,2,44,10,4
4,414,2,1,30,29,1,24,10,4
4,213,1,1,30,30,0,35,10,4
4,166,1,1,30,30,0,22,10,4
4,140,2,1,30,30,0,23,11,4
4,121,1,1,30,30,0,11,10,4
1,670,1,0,0,0,0,29,10,4
1,563,1,0,0,0,0,12,10,4
1,527,1,0,0,0,0,1,1,4
1,437,2,0,0,0,0,1,1,4
1,412,1,0,0,7,-7,27,10,4
1,83,1,0,0,7,-7,35,10,4
2,793,1,0,0,14,-14,54,10,4
2,579,3,0,0,14,-14,54,1,4
2,446,1,0,0,14,-14,8,8,4
2,52,2,1,28,0,28,31,1,4
2,20,1,1,28,0,28,5,10,4
3,863,2,0,0,35,-35,53,1,4
3,799,2,0,0,35,-35,41,5,4
3,524,1,1,38,0,38,20,10,4
3,414,1,0,0,38,-38,43,10,4
3,179,1,0,0,44,-44,35,10,4
3,22,1,0,0,44,-44,38,10,4
4,878,2,1,44,0,44,53,1,4
4,725,1,1,44,0,44,10,10,4
4,598,1,1,44,0,44,7,10,4
4,426,1,0,0,44,-44,33,10,4
4,239,1,0,0,51,-51,30,10,4
4,148,2,0,0,52,-52,41,4,4
4,77,1,1,52,0,52,25,10,4
4,65,2,1,52,0,52,27,8,4
1,865,1,1,0,0,0,30,15,4
1,777,1,1,0,0,0,38,10,4
1,706,1,1,0,0,0,24,10,4
1,648,1,1,0,0,0,14,10,4
1,598,2,1,0,0,0,11,7,4
1,528,2,1,0,0,0,1,1,4
1,450,2,0,3,7,-4,41,2,4
1,323,1,1,7,3,4,26,10,4
1,277,1,1,7,3,4,1,10,4
1,178,2,1,7,3,4,36,6,4
1,127,1,1,7,3,4,25,15,4
1,82,2,1,7,3,4,15,5,4
1,55,3,1,7,3,4,10,0,4
1,21,1,1,7,3,4,9,9,4
2,787,1,0,6,7,-1,53,10,4
2,644,1,1,7,9,-2,35,10,4
2,563,1,0,9,7,2,41,10,4
2,395,1,0,9,7,2,30,10,4
2,292,1,1,7,9,-2,30,20,4
2,271,2,1,7,9,-2,46,4,4
2,153,1,0,9,10,-1,35,10,4
3,893,1,0,12,10,2,34,10,4
3,773,0,0,12,10,2,41,0,4
3,690,1,0,12,10,2,21,10,4
3,613,1,0,12,10,2,3,3,4
3,585,1,1,17,12,5,50,10,4
3,335,1,1,17,13,4,20,10,4
3,301,2,1,17,13,4,22,8,4
3,201,1,0,13,17,-4,53,10,4
3,141,1,0,13,17,-4,21,10,4
3,35,1,0,13,17,-4,45,10,4
3,1,2,0,13,17,-4,37,2,4
4,900,1,0,13,17,-4,33,10,4
4,787,1,0,13,17,-4,3,3,4
4,765,1,1,24,13,11,52,10,4
4,692,1,1,24,13,11,18,10,4
4,371,1,1,25,13,12,45,10,4
4,309,1,1,25,13,12,13,10,4
4,158,1,1,25,13,12,40,10,4
4,151,2,1,25,13,12,40,10,4
4,76,1,0,13,25,-12,53,10,4
1,842,1,0,0,0,0,24,10,4
1,787,1,0,0,0,0,13,10,4
1,767,1,0,0,0,0,2,2,4
1,714,2,0,0,0,0,1,1,4
1,693,1,0,0,7,-7,34,10,4
1,555,2,1,7,0,7,41,6,4
1,485,1,0,0,7,-7,39,10,4
1,454,2,0,0,7,-7,44,5,4
1,249,3,1,7,3,4,38,1,4
1,177,1,1,7,3,4,32,5,4
1,110,1,1,7,10,-3,30,10,4
2,884,1,0,10,7,3,21,10,4
2,661,1,1,7,10,-3,19,10,4
2,510,1,1,7,11,-4,35,10,4
2,438,1,0,11,7,4,23,10,4
2,392,1,0,11,7,4,39,10,4
2,309,1,1,7,11,-4,28,10,4
2,205,1,1,7,11,-4,52,10,4
2,172,2,1,7,11,-4,47,5,4
2,117,2,1,7,14,-7,15,30,4
2,89,3,0,14,7,7,50,1,4
3,768,1,0,14,7,7,3,10,4
3,503,1,0,14,9,5,12,10,4
3,327,2,0,14,16,-2,54,1,4
3,220,1,0,14,23,-9,49,10,4
3,186,2,1,23,14,9,54,3,4
3,143,3,1,23,14,9,53,2,4
3,96,2,1,23,14,9,26,2,4
4,859,1,1,23,14,9,1,1,4
4,817,1,0,21,23,-2,53,10,4
4,773,2,0,21,23,-2,46,3,4
4,753,3,0,21,23,-2,44,1,4
4,726,1,0,21,23,-2,41,10,4
4,611,1,0,21,23,-2,47,10,4
4,378,1,0,21,23,-2,36,10,4
4,243,1,1,23,21,2,45,10,4
4,230,1,1,23,21,2,29,10,4
4,80,1,1,23,24,-1,48,10,4
4,57,1,1,23,24,-1,35,10,4
4,29,2,1,23,24,-1,34,9,4
4,3,3,1,23,24,-1,32,7,4
1,763,1,1,0,7,-7,44,10,4
1,704,2,1,0,7,-7,41,13,4
1,473,1,0,7,3,4,54,10,4
1,431,2,0,7,3,4,47,17,4
1,373,1,1,3,8,-5,35,10,4
1,260,1,0,8,3,5,1,10,4
1,186,1,0,8,3,5,44,10,4
1,145,1,0,8,3,5,28,10,4
2,880,1,0,8,6,2,24,10,4
2,772,1,0,8,6,2,13,10,4
2,733,1,0,8,6,2,35,10,4
2,628,1,1,6,8,-2,30,10,4
2,474,1,0,8,13,-5,44,5,4
2,371,1,1,13,8,5,23,10,4
2,289,1,1,13,8,5,49,10,4
2,244,2,1,13,8,5,45,14,4
2,96,1,1,13,8,5,25,10,4
2,45,1,1,13,8,5,12,10,4
3,745,1,1,13,15,-2,50,10,4
3,695,1,0,15,13,2,31,10,4
3,458,1,1,13,22,-9,24,10,4
3,69,1,0,22,16,6,49,10,4
3,41,1,0,22,16,6,39,10,4
4,900,2,0,22,16,6,19,1,4
4,807,1,0,22,19,3,35,10,4
4,727,1,1,19,22,-3,34,10,4
4,617,1,1,19,22,-3,47,10,4
4,432,1,1,19,22,-3,9,10,4
4,291,1,1,19,22,-3,24,10,4
4,46,1,0,22,26,-4,42,10,4
1,885,1,0,0,0,0,35,10,4
1,447,1,0,0,8,-8,35,10,4
1,368,3,0,0,8,-8,44,1,4
1,244,1,1,8,0,8,16,10,4
1,159,1,1,8,0,8,1,1,4
1,97,2,1,8,0,8,1,1,4
1,2,1,0,7,8,-1,54,10,4
2,867,1,0,7,8,-1,17,10,4
2,747,3,0,7,8,-1,40,1,4
2,649,1,0,7,8,-1,51,20,4
2,579,1,1,8,14,-6,32,10,4
2,486,1,0,14,8,6,33,10,4
2,442,2,0,14,8,6,42,1,4
2,135,1,0,14,8,6,28,10,4
2,133,2,0,14,8,6,29,9,4
2,71,2,1,8,14,-6,45,5,4
2,38,2,0,14,8,6,31,10,4
2,21,1,1,8,14,-6,10,10,4
3,895,1,1,8,17,-9,40,10,4
3,631,1,0,17,8,9,19,10,4
3,379,1,1,15,17,-2,5,5,4
3,248,2,1,15,20,-5,55,2,4
3,223,3,0,20,15,5,54,1,4
3,183,1,0,20,15,5,52,10,4
3,112,1,0,20,15,5,21,10,4
3,48,1,0,20,15,5,43,10,4
4,656,1,1,15,27,-12,46,10,4
4,576,1,0,27,22,5,29,10,4
4,518,1,0,27,22,5,45,10,4
4,385,1,0,27,22,5,48,10,4
4,330,1,0,27,22,5,35,10,4
4,271,1,0,27,22,5,14,10,4
4,165,1,0,27,22,5,5,10,4
4,113,1,0,27,22,5,48,10,4
4,108,2,1,22,27,-5,54,2,4
1,851,2,1,0,0,0,36,1,4
1,774,1,0,0,0,0,38,10,4
1,702,1,0,0,0,0,36,10,4
1,450,1,1,7,0,7,55,10,4
1,403,2,0,0,7,-7,44,10,4
1,377,1,0,0,7,-7,28,10,4
1,158,2,0,0,10,-10,27,10,4
1,76,1,0,0,17,-17,29,10,4
1,40,2,0,0,17,-17,36,3,4
1,1,1,0,0,17,-17,39,10,4
2,900,2,0,0,17,-17,47,2,4
2,769,1,0,0,17,-17,23,10,4
2,600,1,1,17,0,17,26,10,4
2,583,2,1,17,0,17,31,5,4
2,542,1,1,17,0,17,42,10,4
2,451,1,0,0,17,-17,41,10,4
2,203,1,1,17,0,17,46,10,4
2,164,1,1,17,0,17,15,10,4
2,106,2,1,17,3,14,40,5,4
2,18,2,1,24,3,21,52,4,4
3,817,1,0,3,24,-21,44,10,4
3,729,1,1,24,3,21,15,10,4
3,350,1,0,3,24,-21,50,10,4
3,283,1,1,24,3,21,45,10,4
3,88,2,1,24,4,20,44,1,4
4,674,1,1,25,4,21,37,10,4
4,577,1,1,25,7,18,35,10,4
4,545,2,1,25,7,18,40,5,4
4,395,1,1,25,7,18,12,10,4
4,336,1,1,25,7,18,50,10,4
4,290,2,1,25,7,18,42,2,4
4,234,2,1,25,7,18,28,1,4
4,198,3,1,25,7,18,27,0,4
4,156,2,1,25,7,18,18,2,4
4,108,1,1,25,7,18,43,10,4
4,89,2,1,25,7,18,44,9,4
4,75,1,1,25,7,18,54,10,4
4,60,2,1,25,7,18,55,9,4
4,25,1,0,7,25,-18,15,10,4
1,811,1,1,0,0,0,40,10,4
1,715,1,1,0,0,0,3,3,4
1,664,2,1,0,7,-7,34,7,4
1,382,1,1,3,14,-11,54,10,4
1,295,1,1,3,14,-11,26,10,4
1,148,1,0,14,3,11,3,3,4
1,90,1,0,14,10,4,29,10,4
2,865,1,0,14,11,3,35,10,4
2,829,1,0,14,11,3,51,10,4
2,693,1,1,11,14,-3,28,10,4
2,536,2,1,11,17,-6,27,3,4
2,159,1,0,20,13,7,44,10,4
2,113,1,1,13,20,-7,51,10,4
2,83,1,1,13,20,-7,32,10,4
2,35,1,1,13,20,-7,22,10,4
2,12,1,1,13,20,-7,5,5,4
3,799,1,0,23,20,3,29,10,4
3,543,1,0,23,27,-4,20,10,4
3,280,2,1,30,24,6,43,2,4
3,252,1,1,30,24,6,46,10,4
4,872,1,1,33,24,9,13,10,4
4,420,1,1,33,31,2,42,10,4
4,312,2,1,33,31,2,28,6,4
4,268,1,1,33,34,-1,35,10,4
4,185,1,0,34,33,1,43,10,4
4,159,1,1,33,34,-1,46,10,4
4,114,1,1,33,34,-1,30,10,4
4,84,1,1,33,37,-4,43,10,4
4,79,2,1,33,37,-4,40,7,4
1,862,1,0,0,0,0,42,10,4
1,768,1,1,0,1,-1,35,10,4
1,628,1,1,0,1,-1,1,1,4
1,604,1,1,0,8,-8,44,10,4
1,393,1,1,0,11,-11,35,10,4
1,343,1,1,0,11,-11,45,10,4
1,214,1,0,11,0,11,10,10,4
2,839,1,0,11,3,8,12,10,4
2,500,2,0,11,3,8,42,3,4
2,465,3,0,11,3,8,39,0,4
2,49,1,0,12,20,-8,5,10,4
2,44,2,0,12,20,-8,14,1,4
3,830,1,0,12,20,-8,27,10,4
3,670,1,0,12,20,-8,16,10,4
3,596,3,0,12,20,-8,7,1,4
3,564,1,0,12,20,-8,6,6,4
3,512,2,0,12,20,-8,2,2,4
3,262,1,0,12,23,-11,47,10,4
3,44,1,1,23,12,11,28,10,4
4,552,1,1,23,23,0,28,10,4
4,478,1,1,23,23,0,2,2,4
4,211,1,0,30,23,7,42,5,4
4,180,1,0,30,23,7,53,10,4
4,156,2,1,23,30,-7,48,1,4
4,126,1,1,23,30,-7,46,10,4
4,107,1,1,23,30,-7,33,10,4
4,83,2,1,23,30,-7,31,8,4
4,33,1,0,31,23,8,20,10,4
1,895,1,1,0,0,0,27,10,4
1,413,1,1,8,7,1,35,10,4
1,385,1,1,8,7,1,19,10,4
1,350,1,1,8,7,1,6,6,4
1,5,2,1,8,21,-13,44,2,4
2,900,1,1,8,21,-13,46,10,4
2,839,2,1,8,21,-13,53,3,4
2,829,1,0,21,15,6,45,10,4
2,727,2,1,15,21,-6,50,10,4
2,619,1,1,15,21,-6,24,10,4
2,285,1,0,24,22,2,42,10,4
2,255,2,0,24,22,2,35,3,4
2,180,1,0,24,25,-1,24,10,4
2,121,1,1,25,24,1,34,10,4
2,46,2,1,25,31,-6,36,17,4
3,827,1,1,25,31,-6,35,10,4
3,572,1,0,34,32,2,38,10,4
3,541,2,0,34,32,2,47,1,4
3,421,2,1,32,34,-2,42,1,4
3,378,1,1,32,34,-2,30,10,4
3,142,1,1,32,34,-2,53,10,4
4,689,1,1,32,34,-2,50,10,4
4,576,2,0,34,32,2,38,1,4
4,436,1,0,34,32,2,25,10,4
4,285,1,0,34,39,-5,41,10,4
4,255,2,0,34,39,-5,50,1,4
4,153,1,1,39,34,5,28,10,4
4,108,3,1,39,34,5,37,1,4
4,87,1,1,39,34,5,39,10,4
1,835,1,0,0,0,0,6,10,4
1,747,1,1,2,0,2,53,10,4
1,679,1,0,0,2,-2,42,10,4
1,531,1,0,0,5,-5,35,10,4
1,515,2,0,0,5,-5,43,2,4
1,358,1,1,5,0,5,17,10,4
1,93,1,1,5,0,5,52,10,4
1,1,1,1,5,0,5,7,10,4
2,809,1,1,5,0,5,31,10,4
2,571,1,0,0,8,-8,35,10,4
2,545,2,0,0,8,-8,42,3,4
2,480,1,1,8,0,8,14,10,4
2,435,2,1,8,0,8,23,1,4
2,399,3,1,8,0,8,24,0,4
2,296,1,1,8,0,8,36,10,4
2,29,1,0,0,15,-15,28,10,4
3,819,2,0,0,15,-15,26,11,4
3,431,1,1,15,0,15,38,10,4
3,310,2,1,15,0,15,8,5,4
3,256,1,1,15,0,15,2,2,4
3,161,1,1,15,7,8,41,10,4
3,0,1,0,7,15,-8,1,1,4
4,698,3,0,7,22,-15,14,0,4
4,523,2,0,7,22,-15,14,14,4
4,393,1,1,29,14,15,46,10,4
4,313,1,0,14,29,-15,45,10,4
4,191,2,0,14,29,-15,25,10,4
4,46,1,0,14,36,-22,53,10,4
4,39,2,0,14,36,-22,52,9,4
1,894,1,1,0,0,0,35,10,4
1,855,2,1,0,0,0,43,2,4
1,750,1,0,0,0,0,50,10,4
1,685,2,0,0,0,0,20,3,4
1,640,1,0,0,0,0,11,10,4
1,565,1,0,0,7,-7,30,10,4
1,522,2,0,0,7,-7,39,1,4
1,469,1,1,7,0,7,33,10,4
1,418,2,1,7,0,7,44,10,4
1,338,1,0,0,7,-7,29,10,4
1,301,0,1,7,0,7,31,0,4
1,122,1,1,16,0,16,41,10,4
2,900,1,0,0,16,-16,20,10,4
2,806,2,0,0,16,-16,29,13,4
2,688,1,1,16,0,16,21,10,4
2,574,1,1,16,6,10,36,10,4
2,495,1,0,6,16,-10,48,10,4
2,374,1,0,6,16,-10,1,1,4
2,273,1,1,23,6,17,51,10,4
2,42,1,1,31,6,25,18,10,4
2,35,2,1,31,6,25,27,1,4
3,723,1,1,31,6,25,40,10,4
3,577,1,1,31,21,10,35,10,4
3,442,2,0,21,31,-10,37,2,4
3,348,2,1,31,21,10,33,3,4
3,313,1,1,31,21,10,38,10,4
3,252,1,0,21,31,-10,32,10,4
3,197,1,0,21,31,-10,18,10,4
3,131,2,0,21,31,-10,11,3,4
3,69,1,1,38,21,17,49,10,4
4,900,1,1,38,21,17,33,10,4
4,531,2,0,24,38,-14,46,4,4
4,479,1,0,24,38,-14,41,10,4
4,432,2,0,24,38,-14,34,3,4
4,283,1,0,24,41,-17,47,10,4
4,219,1,0,24,41,-17,28,10,4
4,180,2,0,24,41,-17,22,4,4
4,136,1,0,24,44,-20,35,10,4
4,130,1,0,24,44,-20,46,10,4
4,110,2,0,24,44,-20,54,2,4
1,858,2,1,0,0,0,41,1,4
1,824,3,1,0,0,0,41,1,4
1,583,1,0,0,0,0,1,1,4
1,157,1,0,0,14,-14,16,10,4
1,132,2,0,0,14,-14,25,1,4
1,86,1,1,14,0,14,42,10,4
1,43,1,0,0,14,-14,11,10,4
2,817,1,0,0,17,-17,46,10,4
2,782,2,0,0,17,-17,52,4,4
2,570,1,1,20,0,20,41,10,4
2,413,1,1,20,3,17,35,10,4
2,287,1,1,20,3,17,49,10,4
3,734,1,1,27,11,16,38,10,4
3,698,2,1,27,11,16,38,10,4
3,624,2,0,11,27,-16,45,0,4
3,575,2,0,11,27,-16,55,2,4
3,452,1,1,27,11,16,31,10,4
3,344,2,0,11,27,-16,36,1,4
3,271,1,0,11,27,-16,19,10,4
3,139,1,1,27,14,13,35,10,4
3,30,1,0,14,27,-13,55,10,4
4,900,3,1,27,14,13,45,0,4
4,866,1,1,27,14,13,43,10,4
4,471,3,1,27,17,10,42,2,4
4,348,1,1,27,17,10,1,1,4
4,331,1,1,27,24,3,34,10,4
4,308,2,1,27,24,3,43,1,4
4,254,1,0,24,27,-3,45,10,4
4,188,1,0,24,27,-3,28,10,4
4,118,1,1,27,24,3,50,10,4
4,110,2,1,27,24,3,53,7,4
5,900,1,1,27,27,0,9,9,4
1,830,1,0,0,0,0,47,10,4
1,748,1,1,0,0,0,23,10,4
1,710,2,1,0,0,0,14,1,4
1,625,1,1,0,0,0,19,19,4
1,602,1,1,0,7,-7,20,10,4
1,518,1,1,0,7,-7,34,10,4
1,467,1,1,0,7,-7,45,10,4
1,415,2,1,0,7,-7,44,11,4
1,300,1,1,0,7,-7,42,5,4
1,252,2,1,0,7,-7,39,2,4
1,230,1,1,0,7,-7,34,10,4
1,41,1,1,0,14,-14,15,10,4
2,818,1,1,0,14,-14,6,10,4
2,709,1,0,14,0,14,45,10,4
2,563,2,0,15,0,15,29,10,4
2,379,1,1,1,15,-14,25,10,4
2,328,1,1,1,15,-14,50,10,4
2,309,2,0,15,1,14,51,1,4
2,263,1,0,15,1,14,46,10,4
2,191,1,0,15,1,14,14,10,4
2,167,2,0,15,1,14,22,2,4
2,19,1,1,1,15,-14,8,10,4
3,812,1,1,1,22,-21,53,10,4
3,635,1,1,1,29,-28,30,10,4
3,543,1,1,1,36,-35,32,10,4
3,463,1,0,36,4,32,21,10,4
3,370,1,1,4,36,-32,39,10,4
3,241,1,0,36,4,32,7,10,4
3,116,1,1,6,36,-30,53,10,4
3,74,2,1,6,36,-30,45,2,4
4,900,1,1,6,36,-30,18,10,4
4,716,1,0,39,6,33,27,10,4
4,643,1,0,39,6,33,46,10,4
4,239,1,0,39,12,27,17,10,4
4,201,2,0,39,12,27,21,6,4
4,91,1,0,39,15,24,35,10,4
4,85,2,0,39,15,24,36,9,4
4,46,1,0,39,15,24,51,10,4
1,843,1,0,0,0,0,38,5,4
1,825,2,0,0,0,0,42,1,4
1,750,1,1,0,0,0,45,10,4
1,590,2,0,0,0,0,12,2,4
1,549,1,0,0,0,0,9,9,4
1,502,1,0,0,3,-3,35,10,4
1,385,2,1,3,0,3,30,3,4
1,291,1,1,3,0,3,16,10,4
1,150,1,0,0,3,-3,5,10,4
2,900,1,1,3,0,3,15,10,4
2,876,2,1,3,0,3,7,2,4
2,820,3,1,3,0,3,5,0,4
2,762,1,1,3,0,3,4,4,4
2,722,2,1,3,7,-4,36,3,4
2,579,2,1,3,7,-4,47,5,4
2,551,3,1,3,7,-4,43,1,4
2,332,1,0,8,3,5,37,10,4
2,234,1,1,3,8,-5,42,10,4
2,177,1,0,8,3,5,52,10,4
2,169,1,0,8,3,5,41,10,4
2,97,1,0,8,3,5,10,10,4
2,93,2,0,8,3,5,16,4,4
2,5,1,1,3,8,-5,39,10,4
2,1,2,1,3,8,-5,36,13,4
3,787,1,0,8,3,5,41,10,4
3,763,1,1,3,8,-5,52,10,4
3,704,1,1,3,8,-5,51,10,4
3,515,1,1,3,8,-5,46,10,4
3,424,1,0,8,3,5,31,10,4
3,279,1,1,3,8,-5,49,10,4
3,113,1,0,8,4,4,35,10,4
4,709,1,1,4,9,-5,35,10,4
4,696,1,1,4,9,-5,45,10,4
4,522,1,0,9,4,5,50,10,4
4,363,1,1,4,9,-5,1,1,4
4,121,1,0,16,11,5,36,10,4
4,112,1,0,16,11,5,54,10,4
4,67,1,1,11,16,-5,23,10,4
4,60,2,1,11,16,-5,22,9,4
1,667,1,0,0,0,0,4,10,4
1,484,1,1,0,0,0,53,10,4
1,422,1,0,0,0,0,8,8,4
1,355,1,0,0,7,-7,33,10,4
1,244,1,1,7,0,7,34,10,4
1,145,1,0,0,7,-7,50,10,4
1,85,1,0,0,7,-7,25,10,4
2,825,2,0,0,10,-10,25,2,4
2,788,1,0,0,10,-10,30,10,4
2,749,2,0,0,10,-10,34,6,4
2,635,1,0,0,10,-10,28,10,4
2,460,1,1,13,0,13,50,10,4
2,288,1,1,13,3,10,27,10,4
2,251,2,1,13,3,10,37,0,4
2,166,1,1,13,3,10,54,10,4
3,717,1,1,14,3,11,27,10,4
3,697,1,1,14,3,11,40,10,4
3,505,1,0,3,14,-11,28,10,4
3,411,3,0,3,14,-11,19,1,4
3,397,1,0,3,14,-11,15,10,4
3,130,2,1,17,3,14,12,2,4
3,67,1,1,17,3,14,7,7,4
4,800,2,1,17,6,11,29,1,4
4,721,1,1,17,9,8,23,10,4
4,695,2,1,17,9,8,30,3,4
4,660,3,1,17,9,8,33,0,4
4,577,2,1,17,9,8,34,12,4
4,398,2,0,9,17,-8,32,1,4
4,360,1,0,9,17,-8,9,9,4
4,264,1,0,9,17,-8,4,4,4
4,215,3,0,9,24,-15,48,3,4
4,196,1,0,9,24,-15,49,10,4
1,841,1,0,0,0,0,27,10,4
1,715,2,1,0,0,0,7,2,4
1,678,1,1,0,7,-7,36,10,4
1,623,1,1,0,7,-7,55,10,4
1,552,1,0,7,0,7,43,10,4
1,356,2,0,7,3,4,45,0,4
1,256,1,1,3,7,-4,9,10,4
1,99,2,1,3,7,-4,28,2,4
1,1,2,1,3,7,-4,17,2,4
2,806,1,1,3,14,-11,54,10,4
2,695,2,0,14,3,11,8,8,4
2,466,1,0,14,11,3,35,10,4
2,347,1,1,11,14,-3,19,10,4
2,288,1,1,11,14,-3,30,10,4
2,240,3,1,11,14,-3,39,1,4
2,161,2,0,14,11,3,28,0,4
2,64,2,1,14,14,0,49,2,4
2,39,2,1,14,14,0,36,2,4
3,841,2,1,14,21,-7,50,1,4
3,805,1,1,14,21,-7,53,10,4
3,771,1,0,21,14,7,39,10,4
3,746,2,0,21,14,7,32,3,4
3,700,1,0,21,17,4,35,10,4
3,542,1,1,17,21,-4,52,10,4
3,474,1,0,21,17,4,35,10,4
3,437,2,0,21,17,4,26,1,4
3,302,2,0,21,20,1,44,1,4
3,244,1,0,21,20,1,45,10,4
3,105,1,1,20,21,-1,42,10,4
4,900,2,0,21,20,1,48,6,4
4,880,1,0,21,20,1,40,10,4
4,800,1,0,21,20,1,3,3,4
4,770,1,0,21,28,-7,33,10,4
4,605,1,0,21,28,-7,52,10,4
4,479,1,0,21,28,-7,40,10,4
4,454,2,0,21,28,-7,33,3,4
4,205,1,1,35,21,14,27,10,4
4,194,2,1,35,21,14,32,5,4
4,180,1,1,35,21,14,43,10,4
4,153,1,1,35,21,14,55,10,4
4,130,2,0,21,35,-14,53,8,4
4,124,1,0,21,35,-14,45,10,4
1,757,2,0,0,0,0,24,4,4
1,701,1,0,0,0,0,40,10,4
1,558,1,0,9,0,9,49,10,4
1,532,1,1,0,9,-9,43,10,4
1,470,0,0,9,0,9,16,0,4
1,317,1,0,16,0,16,7,7,4
1,236,1,0,16,0,16,1,1,4
1,21,2,0,16,7,9,11,10,4
2,900,1,0,16,7,9,27,10,4
2,841,1,0,16,7,9,41,10,4
2,687,1,0,16,7,9,53,10,4
2,665,2,1,7,16,-9,51,4,4
2,593,1,1,7,16,-9,45,10,4
2,503,2,0,16,7,9,40,2,4
2,367,1,0,16,10,6,35,10,4
2,275,1,1,10,16,-6,55,10,4
2,174,2,0,16,10,6,14,10,4
2,75,1,0,16,13,3,35,10,4
2,34,1,1,13,16,-3,32,10,4
2,29,2,1,13,16,-3,33,9,4
3,863,1,1,13,16,-3,48,10,4
3,773,1,0,16,13,3,11,10,4
3,318,2,0,23,13,10,40,4,4
3,205,2,1,13,23,-10,25,1,4
3,160,1,1,13,23,-10,27,10,4
3,119,2,1,13,23,-10,35,2,4
3,39,1,1,13,23,-10,31,20,4
4,589,2,1,13,23,-10,12,2,4
4,517,3,1,13,30,-17,40,0,4
4,491,1,1,13,30,-17,41,10,4
4,372,1,0,30,20,10,50,10,4
4,204,1,0,30,20,10,51,10,4
4,147,1,0,30,20,10,44,10,4
4,143,2,0,30,20,10,45,9,4
1,672,2,1,0,0,0,45,1,4
1,648,3,1,0,0,0,45,1,4
1,468,1,0,0,0,0,31,10,4
1,339,1,0,0,3,-3,30,10,4
1,165,1,1,3,0,3,36,10,4
1,60,1,0,7,3,4,46,10,4
1,40,1,0,7,3,4,16,10,4
2,635,1,0,7,10,-3,41,10,4
2,485,1,0,7,10,-3,48,10,4
2,268,2,1,10,7,3,28,2,4
2,212,3,1,10,7,3,27,1,4
2,140,1,1,10,10,0,38,10,4
2,94,2,0,10,10,0,33,0,4
3,840,2,1,13,10,3,29,1,4
3,760,2,1,13,10,3,17,2,4
3,677,1,1,13,10,3,1,1,4
3,650,1,1,13,16,-3,30,10,4
3,628,2,1,13,16,-3,35,5,4
3,497,2,0,16,13,3,44,2,4
3,434,2,0,16,13,3,55,2,4
3,364,2,1,13,16,-3,43,0,4
3,277,2,1,13,16,-3,34,2,4
3,155,1,0,19,13,6,50,10,4
4,847,2,1,15,19,-4,53,2,4
4,739,1,0,19,15,4,13,10,4
4,654,1,0,19,15,4,1,1,4
4,526,1,0,19,22,-3,48,10,4
4,461,1,0,19,22,-3,32,10,4
4,256,3,0,19,25,-6,54,1,4
4,179,1,0,19,25,-6,41,10,4
4,129,1,0,19,25,-6,17,10,4
4,46,1,1,28,19,9,34,10,4
1,861,1,1,0,0,0,34,10,4
1,726,1,0,0,0,0,44,10,4
1,653,1,0,0,3,-3,33,10,4
1,615,2,0,0,3,-3,32,11,4
1,593,1,0,0,3,-3,49,10,4
1,548,1,1,3,0,3,25,10,4
1,440,1,0,0,3,-3,40,10,4
1,328,1,0,0,4,-4,50,10,4
1,251,1,1,4,0,4,47,10,4
1,208,1,1,4,0,4,15,10,4
2,876,1,0,7,11,-4,47,10,4
2,796,1,1,11,7,4,32,10,4
2,714,1,0,7,11,-4,40,10,4
2,669,2,0,7,11,-4,50,0,4
2,590,0,0,7,11,-4,50,0,4
2,538,1,1,11,7,4,43,10,4
2,450,1,1,11,7,4,2,10,4
2,358,1,0,14,11,3,44,10,4
2,276,1,1,11,14,-3,45,10,4
2,148,1,1,11,14,-3,25,10,4
3,877,1,0,21,14,7,28,10,4
3,867,2,0,21,14,7,35,3,4
3,811,1,0,21,14,7,48,10,4
3,787,2,1,14,21,-7,52,0,4
3,625,2,1,14,22,-8,44,1,4
3,580,1,1,14,22,-8,45,10,4
3,333,2,1,14,29,-15,51,3,4
3,285,1,1,14,29,-15,54,10,4
3,228,1,0,29,14,15,15,10,4
3,126,1,0,29,14,15,36,10,4
3,70,1,1,14,29,-15,45,10,4
3,29,2,1,14,29,-15,38,3,4
3,1,1,1,14,29,-15,32,10,4
4,900,2,1,14,29,-15,25,3,4
4,841,1,1,14,29,-15,10,10,4
4,727,1,1,14,32,-18,46,10,4
4,686,2,1,14,32,-18,55,1,4
4,584,1,0,32,21,11,35,10,4
4,540,2,0,32,21,11,39,6,4
4,389,2,0,32,21,11,55,1,4
4,377,1,1,21,32,-11,46,10,4
4,324,2,1,21,32,-11,42,6,4
4,182,1,1,21,32,-11,42,10,4
4,135,2,1,21,32,-11,37,5,4
4,45,3,0,39,21,18,38,10,4
4,23,1,0,39,21,18,2,10,4
1,769,1,1,0,0,0,17,10,4
1,654,1,1,0,7,-7,33,10,4
1,588,2,0,7,0,7,52,3,4
1,381,1,0,7,3,4,14,10,4
1,291,1,0,7,10,-3,27,10,4
1,237,1,0,7,10,-3,39,10,4
1,156,1,1,10,7,3,50,10,4
1,74,1,0,7,11,-4,35,10,4
1,20,2,0,7,11,-4,44,1,4
2,869,1,1,11,8,3,35,10,4
2,730,2,0,8,11,-3,20,2,4
2,670,1,0,8,11,-3,12,5,4
2,544,3,0,8,11,-3,1,1,4
2,469,1,1,18,8,10,49,10,4
2,322,1,1,18,15,3,7,10,4
2,205,2,1,18,15,3,55,3,4
2,97,2,1,18,15,3,45,4,4
2,59,2,1,18,15,3,38,10,4
2,22,1,1,18,15,3,2,10,4
3,841,1,0,15,18,-3,42,10,4
3,699,1,1,25,15,10,47,10,4
3,608,1,0,22,25,-3,39,10,4
3,540,1,0,22,25,-3,20,10,4
3,447,1,0,22,25,-3,37,10,4
3,384,1,0,22,25,-3,47,10,4
3,360,1,1,25,22,3,52,10,4
3,216,1,1,25,25,0,40,10,4
3,177,2,1,25,25,0,47,3,4
4,882,1,0,25,25,0,5,10,4
4,717,1,1,25,25,0,31,10,4
4,341,1,0,32,25,7,30,10,4
4,128,1,0,32,26,6,40,10,4
4,123,2,0,32,26,6,45,5,4
4,98,1,0,32,26,6,55,10,4
4,77,2,1,26,32,-6,51,6,4
1,718,2,1,0,0,0,48,1,4
1,582,3,0,0,0,0,32,1,4
1,414,1,0,0,7,-7,31,10,4
1,310,1,1,7,0,7,40,10,4
1,196,2,1,7,0,7,34,2,4
1,124,1,1,7,0,7,17,10,4
1,33,1,1,7,3,4,35,10,4
2,878,1,0,3,7,-4,23,10,4
2,852,2,0,3,7,-4,30,3,4
2,601,1,1,7,6,1,35,10,4
2,522,1,0,6,7,-1,40,10,4
2,330,1,1,7,6,1,21,10,4
2,158,2,1,7,13,-6,50,2,4
2,147,3,1,7,13,-6,52,0,4
2,50,1,0,13,7,6,17,10,4
2,40,2,0,13,7,6,22,5,4
2,6,1,0,13,7,6,39,10,4
3,894,1,1,7,13,-6,37,10,4
3,680,1,1,7,13,-6,16,10,4
3,534,1,1,7,16,-9,35,10,4
3,516,2,1,7,16,-9,36,9,4
3,361,1,0,16,7,9,30,10,4
3,265,1,1,7,16,-9,47,10,4
3,183,1,1,7,16,-9,36,10,4
3,49,3,1,7,19,-12,44,1,4
4,866,1,0,19,7,12,20,10,4
4,845,2,0,19,7,12,28,2,4
4,743,2,1,7,19,-12,50,3,4
4,545,1,0,19,7,12,43,10,4
4,476,1,1,7,19,-12,47,10,4
4,125,1,1,14,19,-5,50,10,4
4,119,1,1,14,19,-5,39,10,4
4,93,2,1,14,19,-5,34,5,4
1,843,1,0,7,0,7,54,10,4
1,661,2,0,7,7,0,45,2,4
1,623,1,0,7,7,0,49,10,4
1,526,2,1,7,7,0,26,1,4
1,328,1,0,15,7,8,29,10,4
1,260,1,0,15,7,8,32,10,4
1,176,1,0,15,7,8,10,10,4
2,900,1,0,15,7,8,14,10,4
2,785,1,1,7,15,-8,45,10,4
2,693,1,1,7,15,-8,26,10,4
2,473,3,1,7,15,-8,17,1,4
2,413,1,1,7,15,-8,28,10,4
2,329,1,1,7,18,-11,32,10,4
2,104,2,1,7,33,-26,53,2,4
3,895,1,0,33,14,19,39,10,4
3,855,2,0,33,14,19,46,3,4
3,751,1,1,14,33,-19,17,10,4
3,636,1,1,14,33,-19,1,1,4
3,612,1,1,14,40,-26,34,10,4
3,528,1,0,40,14,26,41,10,4
3,276,3,1,14,40,-26,27,1,4
3,164,1,1,14,40,-26,44,10,4
3,108,1,1,14,40,-26,32,10,4
3,41,1,1,14,40,-26,17,10,4
4,822,3,1,14,47,-33,38,0,4
4,730,1,1,14,47,-33,5,10,4
4,609,1,1,14,50,-36,35,10,4
4,519,1,0,50,14,36,39,10,4
4,309,1,0,50,17,33,50,10,4
4,244,1,1,17,50,-33,5,10,4
4,159,1,1,17,50,-33,47,10,4
4,62,1,1,17,53,-36,45,10,4
4,57,2,1,17,53,-36,41,6,4
1,850,2,1,0,0,0,42,5,4
1,816,3,1,0,0,0,47,0,4
1,749,1,0,0,7,-7,19,10,4
1,710,2,0,0,7,-7,27,2,4
1,492,1,0,0,7,-7,31,5,4
1,250,1,0,0,7,-7,52,10,4
2,815,1,0,0,9,-9,35,10,4
2,649,1,0,6,9,-3,35,10,4
2,612,2,0,6,9,-3,40,5,4
2,520,1,1,9,6,3,42,10,4
2,474,2,1,9,6,3,35,3,4
2,145,1,1,9,6,3,7,7,4
3,899,1,0,13,13,0,35,10,4
3,820,1,1,13,13,0,48,10,4
3,790,2,1,13,13,0,49,9,4
3,651,1,1,14,13,1,55,10,4
3,335,1,0,13,17,-4,35,10,4
3,221,2,1,17,13,4,50,3,4
3,150,1,0,13,17,-4,19,10,4
3,25,1,1,17,13,4,46,10,4
4,579,1,0,13,18,-5,32,10,4
4,489,1,0,13,18,-5,19,10,4
4,343,1,0,13,25,-12,48,10,4
4,233,2,1,25,13,12,27,1,4
4,190,2,1,25,13,12,18,2,4
4,160,1,1,25,13,12,15,10,4
4,124,1,0,20,25,-5,36,10,4
4,82,1,1,25,20,5,34,10,4
4,80,2,1,25,20,5,35,9,4
4,73,1,1,25,20,5,45,10,4
4,24,1,0,20,25,-5,33,10,4
1,821,1,0,0,0,0,23,10,4
1,785,2,0,0,0,0,30,3,4
1,738,1,1,0,0,0,31,10,4
1,701,2,1,0,0,0,37,4,4
1,562,3,0,0,0,0,53,1,4
1,447,3,0,0,0,0,43,1,4
1,406,1,0,0,0,0,40,10,4
1,360,2,0,0,0,0,32,2,4
1,310,1,0,0,0,0,30,10,4
1,185,2,0,0,3,-3,22,2,4
1,70,1,0,0,3,-3,24,10,4
1,45,2,0,0,3,-3,32,2,4
1,1,1,0,0,3,-3,35,10,4
2,880,2,0,0,3,-3,44,1,4
2,834,1,0,0,3,-3,48,10,4
2,611,1,1,3,0,3,48,10,4
2,531,1,1,3,0,3,26,10,4
2,505,2,1,3,0,3,35,1,4
2,475,1,1,3,0,3,41,10,4
2,353,2,1,3,0,3,47,15,4
2,303,1,0,0,3,-3,30,10,4
2,229,1,0,0,3,-3,33,10,4
2,152,1,0,0,3,-3,47,10,4
2,80,2,1,3,0,3,39,11,4
3,848,2,0,1,3,-2,37,3,4
3,695,1,1,3,1,2,29,10,4
3,657,1,1,3,1,2,19,10,4
3,524,1,0,8,3,5,35,10,4
3,462,1,0,8,3,5,55,10,4
3,434,2,1,3,8,-5,47,2,4
3,394,1,1,3,8,-5,44,10,4
3,368,1,1,3,8,-5,32,10,4
3,333,2,1,3,8,-5,23,1,4
3,225,1,1,3,15,-12,39,10,4
3,191,1,1,3,15,-12,50,10,4
3,135,2,1,3,15,-12,40,20,4
3,97,1,0,15,3,12,14,10,4
4,900,1,1,3,15,-12,39,10,4
4,819,1,1,3,15,-12,11,10,4
4,770,2,1,3,15,-12,21,0,4
4,666,1,1,3,15,-12,41,10,4
4,568,1,0,15,3,12,29,10,4
4,489,1,0,15,3,12,43,10,4
4,435,1,0,15,3,12,55,10,4
4,315,2,1,3,15,-12,5,14,4
4,284,1,0,17,3,14,35,10,4
4,245,2,0,17,3,14,32,13,4
4,159,2,0,17,3,14,40,0,4
4,142,2,0,17,3,14,43,15,4
4,118,1,0,17,3,14,22,10,4
4,95,2,0,17,3,14,23,9,4
1,875,1,0,0,0,0,52,10,4
1,727,1,0,0,0,0,31,10,4
1,715,2,0,0,0,0,34,7,4
1,560,1,1,0,0,0,34,10,4
1,480,1,1,0,0,0,50,10,4
1,443,2,1,0,0,0,54,6,4
1,343,1,0,0,0,0,18,10,4
1,130,2,0,0,1,-1,45,1,4
1,93,1,0,0,1,-1,42,10,4
1,1,1,0,0,1,-1,43,10,4
2,900,2,0,0,1,-1,51,2,4
2,552,2,1,1,14,-13,38,23,4
2,485,2,0,14,1,13,39,1,4
2,427,2,0,14,1,13,50,1,4
2,396,3,0,14,1,13,51,0,4
2,281,1,1,1,14,-13,34,10,4
2,171,2,0,14,1,13,19,20,4
2,142,1,1,1,14,-13,54,10,4
2,26,1,0,17,4,13,33,10,4
2,20,2,0,17,4,13,35,8,4
3,894,1,0,17,4,13,28,10,4
3,728,1,0,17,4,13,40,10,4
3,673,1,1,4,17,-13,43,10,4
3,452,1,1,4,20,-16,49,10,4
3,412,1,1,4,20,-16,39,10,4
3,345,1,1,4,20,-16,25,10,4
3,207,3,1,4,20,-16,16,1,4
3,0,1,0,27,4,23,1,1,4
4,873,2,0,27,11,16,41,2,4
4,488,1,1,11,35,-24,46,10,4
4,350,2,0,35,11,24,16,10,4
4,285,1,0,35,11,24,15,10,4
4,200,1,0,35,11,24,15,10,4
4,163,1,0,35,11,24,47,10,4
4,150,2,0,35,11,24,48,9,4
4,104,1,1,11,35,-24,11,10,4
4,92,1,1,11,35,-24,39,10,4
4,69,1,0,35,11,24,52,10,4
4,50,2,0,35,11,24,45,3,4
4,9,2,0,35,11,24,37,10,4
1,811,1,0,0,0,0,34,10,4
1,636,2,1,3,0,3,45,1,4
1,564,1,1,3,0,3,44,10,4
1,392,1,1,3,7,-4,35,10,4
1,291,1,0,7,3,4,33,10,4
1,170,1,0,7,3,4,45,10,4
1,92,1,0,7,3,4,31,10,4
2,870,2,0,7,6,1,40,3,4
2,787,1,1,6,7,-1,35,10,4
2,762,2,1,6,7,-1,40,5,4
2,673,1,0,7,6,1,37,10,4
2,633,2,0,7,6,1,38,9,4
2,296,2,0,14,6,8,48,2,4
2,242,1,1,6,14,-8,21,10,4
2,83,1,1,6,14,-8,1,1,4
2,74,2,1,6,21,-15,15,15,4
3,831,2,1,6,21,-15,50,0,4
3,705,1,1,6,21,-15,22,10,4
3,641,2,1,6,21,-15,18,6,4
3,621,1,1,6,28,-22,39,10,4
3,465,1,0,28,6,22,31,10,4
3,402,1,1,6,28,-22,28,10,4
3,317,1,1,6,31,-25,22,10,4
3,287,2,1,6,31,-25,27,5,4
3,144,1,0,31,6,25,23,10,4
3,32,1,0,31,6,25,15,10,4
4,820,1,1,9,31,-22,20,10,4
4,708,1,1,9,32,-23,37,10,4
4,613,1,1,9,32,-23,4,10,4
4,514,1,1,9,32,-23,27,10,4
4,430,1,1,9,32,-23,17,10,4
4,384,2,1,9,32,-23,17,10,4
4,327,1,1,9,35,-26,35,10,4
4,265,3,1,9,35,-26,44,1,4
4,170,1,0,35,9,26,11,10,4
4,138,1,0,35,9,26,6,15,4
4,134,2,0,35,9,26,7,14,4
4,80,2,0,35,11,24,54,1,4
4,29,1,0,35,11,24,1,1,4
1,882,1,1,0,0,0,31,10,4
1,856,2,1,0,0,0,38,3,4
1,776,1,0,0,0,0,47,10,4
1,602,1,0,0,0,0,30,10,4
1,459,1,0,0,0,0,42,10,4
1,267,1,1,0,1,-1,47,10,4
1,200,1,0,1,0,1,51,10,4
1,162,2,0,1,0,1,51,10,4
1,44,1,1,1,1,0,3,3,4
1,22,2,1,1,1,0,1,1,4
2,900,3,1,1,1,0,1,1,4
2,752,1,1,1,3,-2,35,10,4
2,665,1,1,1,3,-2,25,10,4
2,640,1,1,1,3,-2,38,10,4
2,306,1,1,1,3,-2,37,10,4
2,235,1,1,1,3,-2,53,10,4
3,763,1,1,4,4,0,35,10,4
3,404,1,0,4,4,0,25,10,4
3,287,3,0,4,4,0,49,1,4
3,81,1,0,4,11,-7,54,10,4
4,608,1,0,11,11,0,40,10,4
4,296,1,1,14,12,2,35,10,4
4,251,2,1,14,12,2,40,5,4
4,170,1,0,12,14,-2,15,10,4
4,103,1,1,17,12,5,37,10,4
1,894,1,0,0,0,0,36,10,4
1,811,1,1,0,0,0,35,10,4
1,660,1,0,0,0,0,46,10,4
1,617,1,1,0,0,0,36,10,4
1,532,1,1,0,0,0,2,2,4
1,500,1,1,0,7,-7,21,10,4
1,448,1,1,0,7,-7,34,10,4
1,74,1,1,0,17,-17,22,10,4
1,40,1,1,0,17,-17,4,4,4
1,0,2,1,0,17,-17,4,4,4
2,854,2,1,0,24,-24,47,2,4
2,764,3,0,24,0,24,51,1,4
2,587,1,0,24,3,21,35,10,4
2,563,1,0,24,3,21,48,10,4
2,473,1,1,3,24,-21,30,10,4
2,437,1,1,3,24,-21,43,10,4
2,210,1,0,24,10,14,8,10,4
2,163,1,0,24,10,14,22,10,4
3,892,1,1,19,24,-5,46,10,4
3,790,1,0,24,19,5,22,10,4
3,602,2,0,24,22,2,42,3,4
3,555,1,0,24,22,2,51,10,4
3,340,1,0,24,22,2,34,10,4
3,200,2,0,24,28,-4,50,4,4
3,155,3,0,24,28,-4,47,1,4
3,72,1,0,24,28,-4,21,10,4
4,766,1,1,35,24,11,27,10,4
4,660,1,1,35,24,11,24,10,4
4,540,1,1,35,27,8,50,10,4
4,464,3,0,27,35,-8,50,0,4
4,438,1,0,27,35,-8,49,10,4
4,351,1,0,27,35,-8,20,10,4
4,317,2,0,27,35,-8,17,7,4
4,175,1,1,38,27,11,42,10,4
4,118,1,0,27,38,-11,36,10,4
4,112,2,0,27,38,-11,31,5,4
1,827,1,1,0,0,0,54,10,4
1,754,3,0,0,0,0,47,1,4
1,652,1,0,0,0,0,29,10,4
1,593,1,0,0,0,0,11,10,4
1,515,1,0,0,0,0,22,10,4
1,409,1,1,0,0,0,47,10,4
1,375,2,1,0,0,0,46,9,4
1,309,1,1,0,3,-3,37,10,4
1,227,1,0,3,0,3,39,10,4
1,97,2,1,0,3,-3,31,2,4
1,15,1,1,0,3,-3,50,10,4
2,875,2,0,3,0,3,51,1,4
2,673,1,1,3,3,0,50,10,4
2,519,1,0,3,3,0,13,10,4
2,495,1,0,3,10,-7,39,10,4
2,435,1,0,3,10,-7,52,10,4
2,410,1,1,10,3,7,40,10,4
2,271,1,1,10,3,7,12,10,4
2,209,2,1,10,3,7,3,1,4
2,81,1,0,10,10,0,16,10,4
2,70,2,0,10,10,0,22,4,4
2,38,1,1,10,10,0,20,10,4
2,29,2,1,10,10,0,24,6,4
3,818,1,0,10,10,0,37,10,4
3,608,2,0,10,17,-7,21,20,4
3,554,1,1,17,10,7,51,10,4
3,311,1,0,10,17,-7,1,1,4
3,291,1,0,10,24,-14,30,10,4
3,223,3,0,10,24,-14,40,0,4
3,190,1,0,10,24,-14,45,10,4
3,1,2,1,24,10,14,5,0,4
4,793,1,1,24,13,11,45,10,4
4,746,2,1,24,13,11,43,12,4
4,643,1,0,13,24,-11,44,10,4
4,566,1,0,13,24,-11,40,10,4
4,489,1,1,24,14,10,36,10,4
4,452,2,1,24,14,10,44,2,4
4,402,1,1,24,14,10,48,10,4
4,359,2,1,24,14,10,49,9,4
4,302,1,0,14,24,-10,8,10,4
4,243,1,0,14,24,-10,14,10,4
4,200,2,0,14,24,-10,7,3,4
4,169,3,0,14,24,-10,4,0,4
4,162,1,0,14,24,-10,3,3,4
4,120,2,0,14,24,-10,4,4,4
4,66,1,0,21,31,-10,48,10,4
4,58,1,0,21,31,-10,33,10,4
1,899,1,1,0,0,0,45,10,4
1,603,1,1,0,3,-3,51,10,4
1,522,1,0,3,0,3,25,10,4
1,358,1,0,3,0,3,44,10,4
1,130,1,0,3,0,3,31,10,4
2,782,2,0,3,1,2,53,0,4
2,585,2,1,1,3,-2,54,1,4
2,456,1,0,3,2,1,35,10,4
2,403,1,1,2,3,-1,48,10,4
2,354,1,1,2,3,-1,30,10,4
2,333,2,1,2,3,-1,22,2,4
2,296,3,1,2,3,-1,21,1,4
2,110,2,0,6,2,4,40,3,4
3,734,1,0,6,9,-3,34,10,4
3,669,1,0,6,9,-3,20,10,4
3,603,1,0,6,9,-3,8,8,4
3,506,1,0,6,12,-6,14,10,4
3,413,1,0,6,12,-6,40,10,4
4,811,1,0,21,12,9,25,10,4
4,590,1,0,21,15,6,35,10,4
4,470,1,1,15,21,-6,16,10,4
4,437,3,1,15,21,-6,25,1,4
4,302,1,0,21,15,6,43,10,4
4,160,2,0,21,15,6,35,10,4
4,11,1,1,22,21,1,35,10,4
1,785,1,0,0,0,0,52,10,4
1,751,2,0,0,0,0,45,3,4
1,726,1,0,0,0,0,39,10,4
1,480,1,1,0,0,0,21,10,4
1,422,1,1,0,0,0,35,10,4
1,243,1,1,0,0,0,39,10,4
1,218,1,1,0,0,0,50,10,4
2,759,1,1,3,0,3,34,10,4
2,642,2,0,0,3,-3,34,1,4
2,589,2,0,0,3,-3,37,10,4
2,519,1,0,0,3,-3,48,10,4
2,488,2,0,0,3,-3,41,3,4
2,430,1,0,0,6,-6,35,10,4
2,418,2,0,0,6,-6,42,3,4
3,793,1,1,16,0,16,23,10,4
3,610,1,1,16,0,16,19,10,4
3,458,1,0,0,16,-16,54,10,4
3,380,3,1,16,0,16,46,0,4
3,257,1,1,16,0,16,25,10,4
3,111,1,0,0,16,-16,46,10,4
4,752,1,0,0,30,-30,25,10,4
4,683,3,0,0,30,-30,35,0,4
4,593,1,1,30,0,30,44,10,4
4,554,1,0,0,30,-30,52,10,4
4,513,1,0,0,30,-30,40,10,4
4,431,1,0,0,30,-30,29,10,4
4,173,1,1,37,0,37,44,10,4
4,123,1,0,0,37,-37,36,10,4
4,116,2,0,0,37,-37,30,4,4
4,85,1,0,0,37,-37,25,10,4
4,55,2,0,0,37,-37,15,0,4
1,720,1,0,0,0,0,40,10,4
1,691,1,0,0,0,0,30,10,4
1,602,1,0,0,3,-3,35,10,4
1,444,1,1,3,3,0,46,10,4
1,322,1,0,3,3,0,17,15,4
1,247,1,0,3,3,0,18,10,4
1,180,1,0,3,3,0,2,2,4
1,12,1,1,10,3,7,47,10,4
2,522,1,0,3,13,-10,40,5,4
2,408,1,1,13,3,10,19,10,4
2,369,1,1,13,6,7,35,10,4
2,274,1,0,6,13,-7,20,10,4
2,169,1,1,13,6,7,49,10,4
2,157,2,0,6,13,-7,53,2,4
2,137,1,0,6,13,-7,49,10,4
2,46,1,0,6,13,-7,13,10,4
3,603,1,1,20,13,7,24,10,4
3,522,1,0,13,20,-7,50,10,4
3,433,1,1,20,13,7,34,10,4
3,410,1,0,13,20,-7,54,10,4
3,361,2,0,13,20,-7,45,1,4
3,324,1,0,13,20,-7,20,10,4
3,219,1,0,13,23,-10,35,10,4
3,13,1,0,13,23,-10,31,10,4
4,798,1,1,26,13,13,40,10,4
4,662,1,1,26,27,-1,28,10,4
4,537,1,0,27,26,1,45,10,4
4,452,1,0,27,26,1,1,11,4
4,369,1,0,27,26,1,29,10,4
4,340,1,0,27,26,1,11,10,4
4,252,1,0,27,29,-2,35,10,4
4,149,1,0,27,29,-2,25,10,4
4,143,2,0,27,29,-2,17,2,4
4,119,1,0,27,29,-2,4,4,4
4,100,2,0,27,29,-2,2,2,4
4,28,1,1,32,27,5,5,5,4
4,1,2,1,32,27,5,1,1,4
1,615,2,0,0,0,0,55,0,4
1,583,1,1,0,0,0,53,10,4
1,492,1,1,0,1,-1,35,10,4
1,433,2,1,0,1,-1,49,10,4
1,372,1,0,1,0,1,15,10,4
1,301,1,0,1,0,1,26,10,4
1,216,1,1,0,1,-1,31,10,4
1,138,1,1,0,8,-8,37,10,4
1,33,1,0,8,0,8,11,10,4
2,741,1,0,8,7,1,33,10,4
2,354,1,0,11,14,-3,37,10,4
2,315,2,0,11,14,-3,46,1,4
2,276,3,0,11,14,-3,47,0,4
2,164,1,1,14,11,3,28,10,4
2,144,1,1,14,11,3,14,10,4
2,123,2,1,14,11,3,15,11,4
2,65,2,1,14,14,0,30,15,4
2,9,1,1,14,14,0,25,10,4
3,896,1,0,17,14,3,28,10,4
3,794,1,1,14,17,-3,52,10,4
3,765,1,1,14,17,-3,42,10,4
3,725,2,1,14,17,-3,33,1,4
3,647,2,1,14,17,-3,17,2,4
3,553,1,1,14,24,-10,28,10,4
3,543,1,1,14,24,-10,38,10,4
3,510,2,1,14,24,-10,45,3,4
3,344,1,0,24,14,10,55,10,4
3,313,2,1,14,24,-10,47,2,4
3,217,2,1,14,24,-10,25,1,4
3,165,1,1,14,27,-13,35,10,4
3,135,2,1,14,27,-13,40,5,4
3,103,1,1,14,27,-13,45,10,4
4,678,1,0,34,17,17,9,10,4
4,650,2,0,34,17,17,15,4,4
4,500,1,1,17,34,-17,47,10,4
4,411,1,1,17,34,-17,34,10,4
4,344,1,1,17,34,-17,23,10,4
4,307,2,1,17,34,-17,18,5,4
4,256,1,1,17,37,-20,35,10,4
4,190,3,1,17,37,-20,43,2,4
4,99,1,0,37,17,20,1,1,4
4,79,2,0,37,17,20,2,2,4
4,78,1,1,24,37,-13,45,10,4
4,73,2,1,24,37,-13,44,9,4
1,889,1,1,0,0,0,26,10,4
1,775,1,0,0,0,0,15,10,4
1,689,1,0,0,3,-3,13,10,4
1,626,1,1,3,0,3,49,10,4
1,585,2,1,3,0,3,54,5,4
1,444,1,0,0,10,-10,49,10,4
1,192,1,1,10,0,10,12,10,4
1,101,1,1,10,3,7,42,10,4
1,30,1,0,3,10,-7,37,10,4
2,809,1,0,5,10,-5,46,10,4
2,769,2,0,5,10,-5,53,3,4
2,664,1,1,10,12,-2,12,10,4
2,523,1,0,12,10,2,52,10,4
2,353,1,0,12,17,-5,55,10,4
2,315,1,1,17,12,5,35,10,4
2,182,1,0,19,17,2,51,10,4
2,80,2,0,26,17,9,30,13,4
2,29,2,1,17,26,-9,23,18,4
3,775,1,1,17,26,-9,32,10,4
3,754,1,1,17,26,-9,12,10,4
3,654,2,1,17,29,-12,43,2,4
3,558,1,0,29,17,12,27,10,4
3,525,2,0,29,17,12,33,4,4
3,496,1,0,29,17,12,42,10,4
3,257,1,1,17,29,-12,25,10,4
3,205,1,1,17,29,-12,7,7,4
3,124,2,1,17,32,-15,42,3,4
4,885,1,0,32,20,12,35,10,4
4,630,3,0,32,20,12,1,1,4
4,537,1,0,32,20,12,46,10,4
4,476,3,0,32,20,12,55,1,4
4,430,1,1,20,32,-12,53,10,4
4,385,2,1,20,32,-12,45,2,4
4,346,3,1,20,32,-12,43,0,4
4,287,1,1,20,32,-12,47,15,4
4,176,2,1,20,32,-12,38,3,4
4,90,1,0,32,20,12,43,10,4
4,83,2,0,32,20,12,48,5,4
1,744,1,1,0,0,0,25,10,4
1,691,1,1,0,0,0,46,10,4
1,614,0,0,0,0,0,42,0,4
1,320,1,0,3,0,3,15,10,4
1,300,2,0,3,0,3,25,0,4
1,202,1,0,3,0,3,26,10,4
1,58,1,0,3,0,3,43,10,4
1,30,2,0,3,0,3,35,2,4
1,1,3,0,3,0,3,33,0,4
2,853,2,0,3,0,3,26,3,4
2,766,1,0,3,7,-4,49,10,4
2,693,2,1,7,3,4,39,3,4
2,670,1,1,7,3,4,32,10,4
2,451,1,0,6,7,-1,40,10,4
2,236,1,0,6,14,-8,39,10,4
2,142,1,1,14,6,8,48,10,4
2,108,1,1,14,6,8,12,10,4
2,101,1,1,14,6,8,24,10,4
2,30,1,0,6,14,-8,42,10,4
3,888,1,1,14,6,8,36,10,4
3,819,1,0,6,14,-8,43,10,4
3,746,3,0,6,14,-8,53,0,4
3,646,3,1,14,6,8,42,1,4
3,565,1,1,14,6,8,11,10,4
3,376,2,0,9,14,-5,28,2,4
3,272,2,0,9,21,-12,28,3,4
3,198,2,0,9,21,-12,39,3,4
3,140,1,1,21,9,12,25,10,4
4,577,2,1,24,12,12,52,2,4
4,435,1,1,24,12,12,26,10,4
4,326,1,1,24,12,12,55,10,4
4,283,2,0,12,24,-12,49,4,4
4,184,1,0,12,24,-12,1,1,4
4,144,2,0,12,24,-12,1,1,4
4,136,1,0,12,31,-19,21,10,4
4,110,1,0,12,31,-19,29,15,4
4,103,2,0,12,31,-19,25,11,4
4,56,1,0,12,31,-19,11,10,4
4,51,1,0,12,38,-26,22,10,4
4,18,3,0,12,38,-26,53,10,4
1,700,1,0,0,0,0,45,10,4
1,626,1,0,0,1,-1,35,10,4
1,456,1,1,1,0,1,12,10,4
1,371,1,1,1,0,1,51,10,4
1,253,1,1,1,1,0,36,10,4
2,800,1,1,8,1,7,25,10,4
2,761,2,1,8,1,7,32,3,4
2,730,1,1,8,1,7,35,10,4
2,671,1,0,1,8,-7,38,10,4
2,632,2,0,1,8,-7,38,10,4
2,599,3,0,1,8,-7,29,1,4
2,521,1,0,1,8,-7,9,9,4
2,425,1,0,1,15,-14,35,5,4
2,293,1,1,15,1,14,25,10,4
2,128,1,0,1,15,-14,39,10,4
3,828,1,0,1,15,-14,24,10,4
3,538,1,0,1,15,-14,3,3,4
3,513,1,0,1,22,-21,25,10,4
3,491,1,0,1,22,-21,53,10,4
3,415,3,1,22,1,21,48,1,4
3,313,1,1,22,4,18,35,10,4
3,218,1,0,4,22,-18,13,10,4
3,144,1,0,4,22,-18,54,10,4
3,48,1,1,22,4,18,49,10,4
3,27,1,1,22,11,11,46,10,4
4,822,3,0,11,22,-11,40,0,4
4,771,1,1,22,11,11,54,10,4
4,707,1,1,22,11,11,22,10,4
4,470,1,1,22,19,3,35,10,4
4,431,2,1,22,19,3,27,2,4
4,350,2,1,22,19,3,15,2,4
4,180,1,1,22,20,2,5,5,4
4,156,1,0,27,22,5,45,10,4
4,35,1,1,22,34,-12,37,10,4
4,31,2,1,22,34,-12,31,4,4
1,893,1,0,0,0,0,32,10,4
1,854,2,0,0,0,0,40,2,4
1,827,3,0,0,0,0,42,0,4
1,702,1,0,0,0,0,51,5,4
1,668,2,0,0,0,0,48,2,4
1,527,1,0,0,3,-3,43,10,4
1,450,1,1,3,0,3,47,10,4
1,351,2,1,3,0,3,17,1,4
1,227,1,1,3,3,0,35,10,4
1,121,1,0,3,3,0,23,10,4
2,840,1,1,3,3,0,49,10,4
2,753,1,0,3,3,0,41,15,4
2,625,1,0,3,6,-3,53,10,4
2,586,2,1,6,3,3,49,2,4
2,550,1,1,6,3,3,46,10,4
2,420,1,1,6,3,3,8,8,4
2,394,1,1,6,10,-4,40,10,4
2,361,2,1,6,10,-4,46,4,4
2,200,1,1,6,10,-4,37,10,4
2,159,2,1,6,10,-4,13,0,4
2,58,2,1,6,17,-11,41,1,4
3,893,1,1,6,17,-11,32,10,4
3,791,1,0,17,6,11,50,10,4
3,500,1,0,17,8,9,42,10,4
3,415,1,1,8,17,-9,50,10,4
3,291,2,1,8,20,-12,43,2,4
3,269,3,1,8,20,-12,44,1,4
3,79,1,0,20,8,12,5,5,4
3,29,2,0,20,15,5,52,0,4
4,900,1,1,15,20,-5,54,10,4
4,869,2,1,15,20,-5,50,6,4
4,731,1,1,15,27,-12,42,10,4
4,647,1,0,27,15,12,33,10,4
4,560,1,0,27,15,12,48,10,4
4,524,2,0,27,15,12,52,6,4
4,306,1,0,27,22,5,29,10,4
4,265,2,0,27,22,5,37,2,4
4,205,1,1,22,27,-5,43,10,4
4,165,1,1,22,27,-5,21,10,4
4,76,1,0,30,28,2,14,10,4
4,49,1,0,30,28,2,26,10,4
4,17,1,1,28,30,-2,35,10,4
1,888,1,0,0,0,0,29,10,4
1,826,1,0,0,0,0,40,10,4
1,588,2,0,7,0,7,47,0,4
1,565,1,0,7,0,7,46,10,4
1,471,1,0,7,0,7,21,5,4
1,363,1,0,7,0,7,24,15,4
1,300,1,1,0,7,-7,52,10,4
2,876,1,0,8,3,5,43,10,4
2,669,2,1,3,8,-5,50,5,4
2,601,2,1,3,8,-5,36,1,4
2,485,2,1,3,8,-5,25,3,4
2,400,1,1,3,15,-12,40,10,4
2,174,1,1,3,15,-12,14,10,4
2,138,1,1,3,15,-12,2,2,4
2,118,2,1,3,15,-12,1,1,4
2,80,1,0,22,3,19,35,10,4
2,26,1,0,22,6,16,51,10,4
2,22,2,0,22,6,16,52,9,4
3,828,1,1,6,22,-16,45,10,4
3,728,1,0,22,6,16,29,10,4
3,697,1,0,22,6,16,9,9,4
3,597,1,0,22,9,13,21,10,4
3,503,1,0,22,9,13,1,1,4
3,484,1,0,22,16,6,23,10,4
3,455,2,0,22,16,6,29,4,4
3,420,3,0,22,16,6,32,1,4
3,205,1,1,16,22,-6,33,10,4
3,142,1,0,22,16,6,53,10,4
4,801,1,1,16,23,-7,35,10,4
4,744,1,0,23,16,7,43,10,4
4,655,1,0,23,19,4,35,10,4
4,512,1,1,19,23,-4,48,10,4
4,267,2,0,30,19,11,45,5,4
4,186,2,0,30,19,11,51,10,4
4,155,1,1,19,30,-11,43,10,4
4,108,1,1,19,30,-11,38,20,4
4,103,2,1,19,30,-11,30,12,4
1,672,1,0,0,3,-3,36,10,4
1,632,2,0,0,3,-3,40,6,4
1,554,2,1,3,0,3,31,4,4
1,451,2,0,0,3,-3,44,1,4
1,423,1,0,0,3,-3,45,10,4
1,318,2,1,3,0,3,39,10,4
1,263,1,1,3,1,2,35,10,4
1,195,1,1,3,1,2,35,10,4
1,166,2,1,3,1,2,25,0,4
1,79,1,1,3,1,2,2,10,4
1,62,1,1,3,8,-5,39,10,4
1,22,2,1,3,8,-5,39,10,4
2,880,1,0,8,3,5,25,10,4
2,848,2,0,8,3,5,30,5,4
2,758,2,0,8,3,5,50,3,4
2,598,2,1,3,9,-6,43,2,4
2,420,1,0,9,10,-1,31,10,4
2,399,2,0,9,10,-1,41,0,4
2,218,1,0,9,17,-8,35,5,4
2,183,1,0,9,17,-8,41,10,4
2,110,1,1,17,9,8,5,5,4
2,59,1,0,16,17,-1,23,10,4
2,2,2,1,17,16,1,43,14,4
3,812,1,0,16,17,-1,26,10,4
3,680,1,1,17,16,1,34,10,4
3,642,2,1,17,16,1,36,8,4
3,493,1,0,16,17,-1,47,10,4
3,443,2,0,16,17,-1,53,4,4
3,402,1,1,17,16,1,52,10,4
3,327,1,1,17,17,0,35,10,4
4,709,1,0,17,17,0,1,10,4
4,500,1,0,17,19,-2,21,10,4
4,342,1,1,26,17,9,40,10,4
4,325,2,1,26,17,9,34,4,4
4,281,1,1,26,20,6,35,10,4
4,251,2,1,26,20,6,43,2,4
4,158,1,0,20,26,-6,39,10,4
4,92,2,0,20,27,-7,37,10,4
4,84,3,0,20,27,-7,46,1,4
4,72,1,0,20,27,-7,47,10,4
4,68,2,0,20,27,-7,42,5,4
1,893,1,0,0,0,0,34,10,4
1,787,1,0,0,0,0,46,10,4
1,702,1,1,0,0,0,50,10,4
1,417,3,0,0,0,0,28,0,4
1,234,1,1,3,0,3,30,10,4
1,205,2,1,3,0,3,39,1,4
1,114,1,1,3,0,3,52,10,4
2,861,1,1,3,0,3,44,10,4
2,774,1,0,0,3,-3,49,10,4
2,662,1,1,3,7,-4,35,10,4
2,474,1,0,7,3,4,32,10,4
2,334,1,1,3,7,-4,12,10,4
2,228,1,1,3,7,-4,1,1,4
2,203,1,1,3,15,-12,36,10,4
2,158,1,1,3,15,-12,33,10,4
2,136,3,1,3,15,-12,24,1,4
2,114,1,1,3,15,-12,28,5,4
3,898,1,1,3,16,-13,45,10,4
3,786,1,0,16,3,13,1,1,4
3,759,1,0,16,10,6,48,10,4
3,632,1,1,10,16,-6,6,6,4
3,616,1,1,10,23,-13,26,10,4
3,436,1,0,23,10,13,24,10,4
3,280,1,0,23,10,13,22,10,4
3,201,1,1,10,23,-13,27,10,4
3,95,1,1,10,23,-13,2,10,4
3,56,2,1,10,23,-13,3,9,4
4,473,2,0,25,10,15,52,8,4
4,450,1,1,10,25,-15,45,10,4
4,440,2,1,10,25,-15,39,4,4
4,111,1,1,17,28,-11,41,10,4
4,91,1,1,17,28,-11,28,10,4
4,77,2,1,17,28,-11,26,8,4
1,730,1,0,7,0,7,42,10,4
1,706,2,0,7,0,7,50,2,4
1,547,1,1,0,7,-7,16,10,4
1,339,1,0,14,0,14,45,10,4
1,188,1,0,21,0,21,45,10,4
1,31,1,1,0,21,-21,3,10,4
1,2,2,1,0,21,-21,10,3,4
2,821,1,1,0,21,-21,42,10,4
2,720,2,0,21,0,21,15,2,4
2,628,1,0,21,0,21,40,10,4
2,578,1,0,21,0,21,50,10,4
2,471,1,1,0,21,-21,5,10,4
2,141,1,1,0,28,-28,49,10,4
2,118,2,1,0,28,-28,40,1,4
2,14,3,0,31,0,31,46,4,4
3,887,1,0,31,3,28,31,10,4
3,776,1,1,3,31,-28,53,10,4
3,759,2,0,31,3,28,47,0,4
3,727,1,0,31,3,28,42,10,4
3,628,3,0,31,3,28,33,1,4
3,569,2,0,31,3,28,26,10,4
3,449,1,0,31,3,28,43,10,4
3,431,2,0,31,3,28,50,3,4
3,327,1,1,3,31,-28,40,20,4
3,236,1,1,3,32,-29,35,10,4
3,138,1,0,32,3,29,28,10,4
3,101,2,0,32,3,29,36,2,4
4,842,1,0,32,10,22,22,10,4
4,719,2,0,32,10,22,51,3,4
4,670,2,0,32,10,22,41,4,4
4,595,1,0,32,10,22,21,10,4
4,568,1,0,32,10,22,10,10,4
4,511,1,0,32,13,19,35,10,4
4,490,2,0,32,13,19,40,5,4
4,446,3,0,32,13,19,44,1,4
4,410,1,0,32,13,19,46,10,4
4,303,1,1,13,32,-19,33,10,4
4,280,2,1,13,32,-19,32,9,4
4,147,1,0,35,13,22,42,10,4
4,142,2,0,35,13,22,45,7,4
4,83,1,1,13,35,-22,33,10,4
4,76,2,1,13,35,-22,29,6,4
1,822,1,0,0,0,0,10,10,4
1,738,1,0,0,0,0,14,10,4
1,715,1,0,0,7,-7,24,10,4
1,572,3,0,0,7,-7,51,1,4
1,530,1,0,0,7,-7,50,10,4
1,464,1,0,0,7,-7,25,10,4
1,425,2,0,0,7,-7,16,1,4
1,365,1,0,0,7,-7,2,2,4
1,232,1,0,0,13,-13,44,10,4
1,149,1,1,13,0,13,52,10,4
1,68,1,0,0,13,-13,38,10,4
1,32,2,0,0,13,-13,35,7,4
1,3,1,0,0,13,-13,27,10,4
2,900,2,0,0,13,-13,21,4,4
2,693,2,1,16,0,16,30,2,4
2,553,1,1,16,7,9,55,10,4
2,464,1,0,7,16,-9,7,10,4
2,308,2,1,16,7,9,34,3,4
2,224,1,1,16,7,9,55,10,4
2,126,1,0,7,16,-9,32,10,4
2,90,2,1,23,7,16,36,3,4
2,86,1,1,23,7,16,41,10,4
2,55,3,1,23,7,16,51,0,4
2,45,1,1,23,7,16,53,10,4
3,894,1,0,7,26,-19,39,10,4
3,853,1,1,26,7,19,39,10,4
3,725,1,1,26,10,16,35,10,4
3,598,1,1,26,10,16,17,10,4
3,368,1,0,17,26,-9,23,10,4
3,187,1,1,26,17,9,46,10,4
3,140,2,1,26,17,9,25,10,4
3,3,1,1,26,20,6,49,10,4
4,859,1,0,20,26,-6,23,10,4
4,759,1,1,26,20,6,51,10,4
4,435,2,0,20,35,-15,44,1,4
4,376,1,1,35,20,15,39,10,4
4,363,2,1,35,20,15,31,2,4
4,248,2,0,27,35,-8,54,2,4
4,137,2,0,27,42,-15,47,3,4
4,101,3,1,42,27,15,36,1,4
4,80,1,1,42,27,15,30,10,4
4,76,2,1,42,27,15,35,5,4
1,700,1,1,0,0,0,34,10,4
1,479,1,1,0,7,-7,49,10,4
1,334,1,0,7,0,7,30,10,4
1,253,1,1,0,7,-7,31,10,4
1,60,1,0,14,0,14,17,10,4
2,900,1,0,14,3,11,35,10,4
2,810,2,1,3,14,-11,44,10,4
2,763,1,1,3,14,-11,30,10,4
2,714,2,1,3,14,-11,22,2,4
2,622,1,1,3,14,-11,1,1,4
2,392,2,1,3,21,-18,47,3,4
2,292,1,1,3,21,-18,33,10,4
2,224,1,1,3,24,-21,35,10,4
2,162,1,1,3,24,-21,49,10,4
2,60,1,0,31,3,28,25,10,4
3,893,1,0,31,3,28,26,10,4
3,737,2,0,31,3,28,54,4,4
3,530,2,0,31,3,28,34,1,4
3,452,1,0,31,3,28,30,10,4
3,391,1,0,31,3,28,55,5,4
3,374,1,1,3,31,-28,45,10,4
3,165,1,0,32,3,29,45,10,4
3,83,1,1,3,32,-29,54,10,4
4,770,1,1,3,39,-36,51,10,4
4,737,2,1,3,39,-36,41,0,4
4,590,1,0,40,3,37,36,10,4
4,527,1,0,40,10,30,45,10,4
4,497,2,0,40,10,30,53,2,4
4,458,1,1,10,40,-30,52,10,4
4,372,1,1,10,40,-30,31,10,4
4,177,1,1,24,40,-16,48,10,4
4,143,1,1,24,40,-16,14,10,4
4,138,2,1,24,40,-16,7,3,4
4,84,2,1,24,40,-16,7,7,4
4,78,1,1,24,47,-23,41,10,4
1,875,1,0,0,0,0,40,10,4
1,758,1,1,0,0,0,31,10,4
1,645,1,1,0,3,-3,54,10,4
1,607,2,1,0,3,-3,54,10,4
1,345,2,1,0,3,-3,20,2,4
2,878,1,1,0,10,-10,7,10,4
2,800,1,1,0,10,-10,31,10,4
2,720,1,0,10,0,10,51,10,4
2,649,1,0,10,0,10,25,10,4
2,589,1,0,10,0,10,15,10,4
2,431,1,0,10,7,3,43,10,4
2,340,1,1,7,10,-3,29,10,4
2,297,2,1,7,10,-3,37,2,4
2,236,1,0,10,7,3,48,10,4
2,117,1,1,7,17,-10,50,5,4
2,113,2,1,7,17,-10,52,3,4
2,77,2,0,17,7,10,46,2,4
2,71,3,0,17,7,10,44,0,4
2,14,1,1,7,17,-10,4,10,4
2,1,2,1,7,17,-10,12,2,4
3,760,1,1,7,17,-10,42,10,4
3,588,1,1,7,17,-10,18,10,4
3,509,1,0,17,7,10,38,10,4
3,445,1,1,7,17,-10,52,10,4
3,258,1,0,17,7,10,50,10,4
3,63,1,1,7,17,-10,1,1,4
3,40,1,1,7,24,-17,54,10,4
4,618,1,1,11,24,-13,50,10,4
4,344,1,1,11,27,-16,15,10,4
4,158,1,1,18,34,-16,52,10,4
4,81,1,1,18,34,-16,43,10,4
4,76,2,1,18,34,-16,34,1,4
4,56,1,1,18,34,-16,29,10,4
4,35,2,1,18,34,-16,24,5,4
1,867,1,1,0,0,0,50,10,4
1,813,1,0,0,0,0,50,10,4
1,773,2,0,0,0,0,44,4,4
1,705,2,0,0,0,0,31,0,4
1,677,3,0,0,0,0,30,0,4
1,405,2,0,0,3,-3,50,4,4
1,391,1,0,0,10,-10,32,10,4
1,242,1,0,3,10,-7,43,10,4
1,88,1,0,3,10,-7,7,7,4
2,873,1,0,3,17,-14,52,10,4
2,709,1,1,17,3,14,50,10,4
2,471,1,0,3,18,-15,50,10,4
2,335,1,0,3,18,-15,26,10,4
2,315,2,0,3,18,-15,35,1,4
2,162,1,1,18,4,14,46,10,4
2,147,2,1,18,4,14,49,7,4
2,35,2,1,25,4,21,49,10,4
2,2,1,0,4,25,-21,21,10,4
3,895,1,0,4,25,-21,34,10,4
3,855,1,0,4,25,-21,48,10,4
3,777,3,1,25,4,21,53,1,4
3,701,1,1,25,4,21,46,10,4
3,670,1,0,4,25,-21,51,10,4
3,623,1,0,4,25,-21,11,10,4
3,466,1,1,28,4,24,52,10,4
3,430,1,1,28,4,24,41,10,4
3,315,2,1,28,4,24,10,3,4
3,126,1,1,35,11,24,23,10,4
4,876,1,1,35,11,24,37,10,4
4,754,1,0,11,38,-27,35,10,4
4,661,1,1,38,11,27,37,10,4
4,628,2,1,38,11,27,42,5,4
4,395,2,0,11,38,-27,37,1,4
4,215,1,0,11,38,-27,38,10,4
4,160,2,0,11,38,-27,31,3,4
4,155,1,0,11,38,-27,28,10,4
4,133,2,0,11,38,-27,24,6,4
4,99,1,0,11,38,-27,10,10,4
4,71,2,0,11,38,-27,7,7,4
4,52,3,0,11,38,-27,5,5,4
4,31,1,0,11,38,-27,5,10,4
4,5,1,0,11,38,-27,16,10,4
1,890,1,0,0,0,0,32,10,4
1,742,1,1,0,0,0,48,10,4
1,512,1,0,3,0,3,32,10,4
1,479,2,0,3,0,3,32,10,4
1,280,1,1,7,3,4,30,10,4
1,250,2,1,7,3,4,34,6,4
1,143,1,0,3,7,-4,37,10,4
1,103,2,0,3,7,-4,42,5,4
1,70,3,0,3,7,-4,47,0,4
1,35,1,0,3,7,-4,51,10,4
1,1,1,1,7,3,4,41,10,4
2,866,1,1,7,4,3,37,10,4
2,866,1,1,7,4,3,37,10,4
2,652,1,0,4,8,-4,35,10,4
2,616,1,0,4,8,-4,45,10,4
2,490,2,1,8,4,4,8,1,4
2,453,1,1,8,4,4,6,6,4
2,420,2,1,8,4,4,2,2,4
2,346,1,1,8,7,1,35,10,4
2,324,2,1,8,7,1,42,3,4
2,100,2,1,8,7,1,49,2,4
2,88,1,0,7,8,-1,54,10,4
2,70,2,0,7,8,-1,48,4,4
2,15,2,0,7,8,-1,42,9,4
3,769,1,1,8,10,-2,35,10,4
3,727,2,1,8,10,-2,42,3,4
3,611,1,1,9,10,-1,41,10,4
3,477,1,0,10,9,1,28,10,4
3,285,1,1,9,11,-2,40,10,4
3,199,2,0,11,9,2,11,10,4
3,134,1,1,11,11,0,40,10,4
3,1,1,0,11,11,0,15,15,4
4,862,1,0,11,14,-3,29,10,4
4,774,1,1,14,11,3,46,10,4
4,720,1,1,14,11,3,35,10,4
4,637,1,1,14,14,0,35,10,4
4,436,1,1,14,14,0,31,10,4
4,318,1,1,14,14,0,50,10,4
4,244,1,1,14,14,0,39,10,4
4,140,1,1,14,14,0,51,10,4
4,28,1,0,21,21,0,38,10,4
4,24,2,0,21,21,0,33,5,4
1,864,1,0,0,0,0,23,10,4
1,753,2,0,0,0,0,8,8,4
1,697,1,1,3,0,3,53,10,4
1,635,1,1,3,0,3,33,10,4
1,620,1,1,3,0,3,51,10,4
1,578,2,1,3,0,3,54,7,4
1,543,3,0,0,3,-3,50,1,4
1,376,1,0,0,3,-3,43,10,4
1,314,1,0,0,3,-3,14,10,4
1,221,1,0,0,10,-10,25,10,4
1,149,1,0,0,10,-10,49,10,4
2,800,1,1,13,3,10,32,10,4
2,751,1,0,3,13,-10,35,10,4
2,620,2,1,16,3,13,40,2,4
2,523,2,1,16,4,12,42,2,4
2,412,1,0,4,16,-12,52,10,4
3,834,1,1,19,11,8,48,10,4
3,715,1,0,11,19,-8,3,10,4
3,567,1,0,11,26,-15,31,10,4
3,548,2,0,11,26,-15,38,3,4
3,513,1,0,11,26,-15,50,10,4
3,364,1,1,26,11,15,1,1,4
3,309,2,1,26,11,15,1,1,4
3,204,1,1,26,18,8,54,10,4
3,127,1,1,26,18,8,19,10,4
3,104,2,1,26,18,8,23,6,4
3,16,2,0,18,26,-8,47,3,4
4,881,1,1,26,18,8,43,10,4
4,794,2,0,18,26,-8,40,1,4
4,664,1,1,26,18,8,33,10,4
4,549,2,1,26,18,8,8,0,4
4,450,1,0,26,26,0,49,10,4
4,302,1,1,33,26,7,52,10,4
4,168,1,1,33,26,7,41,10,4
4,53,2,0,26,40,-14,46,5,4
4,42,1,0,26,40,-14,51,10,4
1,871,1,1,0,0,0,45,10,4
1,632,2,1,7,0,7,54,4,4
1,511,1,0,0,7,-7,34,10,4
1,415,1,1,7,0,7,39,10,4
1,175,3,1,7,0,7,2,0,4
1,115,2,1,7,0,7,2,2,4
1,66,1,0,7,14,-7,30,10,4
1,1,2,0,7,14,-7,55,0,4
2,900,1,1,14,7,7,54,10,4
2,527,2,1,14,7,7,8,10,4
2,259,1,0,16,14,2,28,10,4
2,163,1,0,16,14,2,1,1,4
2,159,1,0,16,21,-5,34,10,4
2,131,1,1,21,16,5,45,10,4
2,123,1,0,16,21,-5,53,10,4
2,70,1,0,16,21,-5,26,10,4
3,894,1,0,16,21,-5,43,10,4
3,853,2,0,16,21,-5,47,6,4
3,761,1,1,21,16,5,31,10,4
3,535,1,1,21,16,5,30,10,4
3,355,1,1,21,16,5,41,10,4
3,277,2,1,21,16,5,20,1,4
3,2,1,1,21,19,2,52,10,4
4,846,1,0,19,21,-2,18,10,4
4,741,1,0,19,24,-5,46,10,4
4,705,2,0,19,24,-5,54,2,4
4,661,1,1,24,19,5,37,10,4
4,596,1,1,24,19,5,12,10,4
4,433,1,0,19,24,-5,48,10,4
4,191,1,0,22,24,-2,47,10,4
4,130,1,1,26,22,4,35,10,4
4,124,2,1,26,22,4,42,3,4
4,118,1,1,26,22,4,46,10,4
4,103,2,1,26,22,4,48,8,4
4,61,2,1,26,22,4,52,4,4
1,817,1,1,0,0,0,27,10,4
1,746,1,1,0,0,0,38,10,4
1,711,2,1,0,0,0,36,12,4
1,653,1,0,0,0,0,25,10,4
1,609,1,0,0,0,0,37,10,4
1,594,2,0,0,0,0,47,0,4
1,582,1,0,0,0,0,49,10,4
1,513,1,1,0,0,0,49,10,4
1,415,1,1,0,3,-3,35,10,4
1,218,1,1,0,3,-3,40,10,4
1,83,3,0,3,0,3,46,2,4
1,1,1,0,3,0,3,27,10,4
2,741,1,0,3,7,-4,44,10,4
2,691,2,0,3,7,-4,22,3,4
2,664,1,0,3,7,-4,16,10,4
2,629,2,0,3,7,-4,6,0,4
2,570,1,0,3,7,-4,5,5,4
2,469,1,1,14,3,11,46,10,4
2,423,1,0,3,14,-11,35,10,4
2,391,2,0,3,14,-11,39,6,4
2,325,1,1,14,3,11,38,10,4
2,252,1,1,14,3,11,52,10,4
2,166,1,0,3,14,-11,15,10,4
2,141,3,0,3,14,-11,24,1,4
2,108,1,1,14,3,11,25,10,4
2,53,1,1,14,3,11,2,10,4
2,46,1,1,14,3,11,13,10,4
3,890,1,0,3,14,-11,32,10,4
3,738,2,1,14,4,10,35,10,4
3,683,1,0,4,14,-10,46,10,4
3,595,1,1,14,4,10,19,10,4
3,497,1,0,4,14,-10,40,10,4
3,252,1,1,14,4,10,45,10,4
3,170,1,1,14,7,7,35,10,4
3,1,1,1,14,9,5,12,10,4
4,864,1,1,14,9,5,36,10,4
4,762,1,0,9,14,-5,41,10,4
4,747,2,0,9,14,-5,33,2,4
4,723,1,0,9,14,-5,27,10,4
4,621,2,0,9,14,-5,9,3,4
4,587,3,0,9,14,-5,7,1,4
4,299,1,1,14,9,5,38,10,4
4,179,1,0,9,14,-5,41,10,4
4,146,2,1,14,9,5,45,2,4
4,117,1,1,14,9,5,8,10,4
4,86,3,1,14,9,5,1,1,4
4,78,1,1,14,9,5,1,10,4
4,75,2,1,14,9,5,3,8,4
4,51,1,1,14,9,5,14,10,4
1,801,1,1,0,0,0,7,10,4
1,773,2,1,0,0,0,15,2,4
1,682,1,1,0,0,0,10,10,4
1,632,1,1,0,3,-3,35,10,4
1,562,1,0,3,0,3,29,10,4
1,499,1,0,3,0,3,38,10,4
1,382,1,1,0,3,-3,39,10,4
1,193,1,0,3,0,3,37,10,4
1,5,1,1,0,10,-10,36,10,4
2,797,1,0,10,0,10,27,10,4
2,690,1,1,0,10,-10,50,10,4
2,625,1,0,10,0,10,48,10,4
2,562,1,0,10,0,10,35,10,4
2,375,3,0,10,7,3,54,0,4
2,189,2,0,10,7,3,46,1,4
2,155,2,0,10,7,3,33,1,4
2,129,1,0,10,7,3,1,1,4
3,866,1,0,17,17,0,52,10,4
3,799,3,0,17,17,0,42,0,4
3,740,1,0,17,17,0,18,10,4
3,669,2,0,17,17,0,2,2,4
3,498,1,1,20,17,3,31,10,4
3,388,1,1,20,17,3,1,1,4
3,346,2,1,20,17,3,1,1,4
3,234,1,0,24,20,4,43,10,4
3,47,2,0,24,23,1,49,0,4
4,900,2,0,24,23,1,49,10,4
4,854,1,1,23,24,-1,13,10,4
4,826,1,1,23,24,-1,33,10,4
4,661,1,0,24,26,-2,32,10,4
4,635,2,0,24,26,-2,40,2,4
4,587,1,1,26,24,2,1,1,4
4,502,2,1,26,24,2,1,1,4
4,223,2,0,31,26,5,30,2,4
4,157,1,0,31,27,4,35,10,4
4,129,1,0,31,27,4,54,10,4
4,56,1,1,27,31,-4,31,10,4
4,51,2,1,27,31,-4,30,9,4
1,820,1,1,0,0,0,41,10,4
1,794,2,1,0,0,0,50,1,4
1,558,2,1,0,0,0,48,12,4
1,494,1,1,0,3,-3,35,10,4
1,407,1,0,5,0,5,43,10,4
1,238,1,1,0,12,-12,29,10,4
1,134,1,1,0,12,-12,52,10,4
2,801,1,1,0,12,-12,41,10,4
2,727,2,1,0,12,-12,31,0,4
2,659,2,1,0,12,-12,22,2,4
2,620,3,1,0,12,-12,21,1,4
2,580,1,1,0,12,-12,21,10,4
2,195,1,0,15,7,8,33,10,4
2,172,2,0,15,7,8,40,3,4
2,143,1,1,7,15,-8,13,10,4
2,133,2,1,7,15,-8,20,3,4
2,57,1,1,7,15,-8,44,10,4
2,36,1,1,7,18,-11,35,10,4
2,14,1,1,7,18,-11,22,10,4
3,887,1,0,21,7,14,27,10,4
3,839,1,0,21,7,14,16,10,4
3,797,1,0,21,14,7,37,10,4
3,654,1,0,28,14,14,5,5,4
3,552,2,0,28,14,14,6,6,4
3,443,2,1,21,28,-7,19,10,4
3,416,1,1,21,28,-7,35,10,4
3,318,2,0,28,21,7,47,10,4
3,276,3,0,28,21,7,37,0,4
3,265,1,0,28,21,7,36,10,4
3,134,1,0,28,24,4,42,10,4
4,882,1,0,28,24,4,26,10,4
4,300,1,0,38,33,5,31,10,4
4,275,2,0,38,33,5,31,10,4
4,221,1,0,38,36,2,35,10,4
4,162,1,0,38,36,2,17,10,4
4,114,1,1,36,38,-2,52,10,4
4,84,1,1,36,38,-2,42,10,4
4,77,2,1,36,38,-2,48,16,4
1,803,2,0,0,0,0,45,1,4
1,730,2,0,0,0,0,34,1,4
1,655,2,0,0,0,0,24,2,4
1,572,1,0,0,7,-7,30,10,4
1,534,1,0,0,7,-7,40,10,4
1,476,1,0,0,7,-7,51,10,4
1,336,1,0,2,7,-5,55,10,4
1,140,2,1,7,4,3,50,2,4
2,879,1,1,7,4,3,1,1,4
2,828,2,1,7,4,3,1,1,4
2,630,1,0,7,7,0,55,10,4
2,554,1,1,7,7,0,45,10,4
2,518,2,1,7,7,0,39,4,4
2,402,1,1,7,14,-7,49,10,4
2,328,1,0,14,7,7,24,10,4
2,164,1,0,14,7,7,14,10,4
2,112,1,0,14,7,7,2,2,4
2,28,2,0,21,14,7,40,10,4
3,873,2,1,14,21,-7,29,10,4
3,796,1,0,21,14,7,10,10,4
3,765,2,0,21,14,7,16,4,4
3,708,1,0,21,14,7,52,10,4
3,675,2,0,21,14,7,52,10,4
3,616,2,0,21,14,7,21,2,4
3,348,1,1,14,21,-7,51,10,4
3,236,1,0,21,14,7,37,10,4
3,194,2,0,21,14,7,47,0,4
3,87,3,1,14,21,-7,52,1,4
3,66,1,1,14,21,-7,48,10,4
4,900,2,1,14,21,-7,27,2,4
4,834,2,1,14,21,-7,24,11,4
4,722,2,1,14,22,-8,14,3,4
4,656,1,1,14,22,-8,11,10,4
4,552,1,0,29,14,15,40,10,4
4,330,1,0,29,14,15,45,10,4
4,251,1,1,14,29,-15,54,10,4
4,224,2,1,14,29,-15,48,4,4
4,164,1,1,14,29,-15,26,10,4
4,158,2,1,14,29,-15,24,8,4
4,152,1,1,14,29,-15,13,10,4
4,129,2,1,14,29,-15,14,11,4
4,100,1,1,14,32,-18,35,10,4
4,71,1,1,14,32,-18,35,10,4
4,64,2,1,14,32,-18,30,5,4
4,15,1,1,14,35,-21,35,10,4
4,8,1,1,14,35,-21,47,10,4
1,894,1,0,0,0,0,30,10,4
1,870,2,0,0,0,0,38,2,4
1,825,3,0,0,0,0,40,0,4
1,659,1,1,0,0,0,48,10,4
1,505,2,1,0,0,0,23,4,4
1,423,1,1,0,1,-1,53,10,4
1,388,2,0,1,0,1,51,4,4
1,219,1,0,1,2,-1,34,5,4
1,180,2,0,1,2,-1,30,1,4
1,58,1,0,1,2,-1,1,1,4
2,785,2,1,9,1,8,35,3,4
2,616,3,1,9,1,8,50,1,4
2,456,1,0,1,9,-8,1,1,4
2,406,1,0,1,16,-15,47,10,4
2,273,1,1,16,1,15,25,10,4
2,73,1,1,16,8,8,28,10,4
2,68,2,1,16,8,8,37,1,4
2,19,2,1,16,8,8,47,19,4
3,659,1,0,8,16,-8,2,2,4
3,599,2,0,8,23,-15,41,2,4
3,552,1,1,23,8,15,20,10,4
3,533,1,1,23,8,15,31,10,4
3,458,1,1,23,8,15,45,10,4
3,430,2,1,23,8,15,54,1,4
3,231,1,0,8,24,-16,50,10,4
4,900,2,1,24,11,13,34,2,4
4,815,1,0,11,24,-13,47,10,4
4,643,1,1,24,11,13,51,10,4
4,600,1,1,24,11,13,39,10,4
4,390,2,1,24,18,6,48,5,4
4,342,1,1,24,18,6,54,10,4
4,215,2,0,18,24,-6,12,2,4
4,143,2,0,18,24,-6,43,2,4
4,71,1,1,24,18,6,25,10,4
4,63,1,0,18,24,-6,51,10,4
4,58,2,0,18,24,-6,53,12,4
1,679,1,0,0,7,-7,35,10,4
1,511,1,0,0,7,-7,50,10,4
1,458,2,0,0,7,-7,42,2,4
1,230,1,0,0,10,-10,51,10,4
1,152,2,0,0,10,-10,31,0,4
1,72,1,0,0,10,-10,12,10,4
2,875,2,0,0,17,-17,44,10,4
2,671,1,0,0,17,-17,34,10,4
2,577,1,1,17,0,17,31,10,4
2,431,1,1,24,0,24,50,10,4
2,409,2,1,24,0,24,46,6,4
2,117,1,1,24,3,21,50,10,4
2,109,2,1,24,3,21,42,2,4
2,102,3,1,24,3,21,41,1,4
3,839,1,0,6,24,-18,50,10,4
3,804,1,1,24,6,18,46,10,4
3,721,1,1,24,7,17,35,10,4
3,715,2,1,24,7,17,45,0,4
3,621,2,0,7,24,-17,54,1,4
3,406,1,0,7,24,-17,29,10,4
3,175,1,1,24,7,17,38,10,4
3,132,1,0,7,24,-17,46,10,4
3,93,1,0,7,24,-17,35,10,4
3,26,1,0,7,24,-17,7,7,4
4,684,1,1,27,7,20,44,10,4
4,665,1,1,27,14,13,39,10,4
4,417,1,0,14,27,-13,27,10,4
4,312,1,1,27,14,13,51,10,4
4,128,1,0,14,27,-13,4,4,4
4,83,1,0,14,34,-20,35,10,4
4,78,2,0,14,34,-20,39,14,4
4,41,1,0,14,37,-23,35,10,4
1,855,1,1,0,0,0,42,10,4
1,842,2,1,0,0,0,50,2,4
1,811,1,0,0,0,0,43,10,4
1,654,1,1,3,0,3,29,10,4
1,630,2,1,3,0,3,23,4,4
1,407,1,1,3,3,0,26,10,4
1,322,1,0,3,3,0,27,10,4
1,126,1,0,3,3,0,44,10,4
1,101,2,0,3,3,0,54,0,4
2,851,1,1,3,6,-3,35,10,4
2,672,1,0,6,10,-4,25,10,4
2,630,2,0,6,10,-4,27,8,4
2,604,3,0,6,10,-4,35,0,4
2,568,1,0,6,10,-4,36,10,4
2,445,1,1,10,6,4,46,10,4
2,421,2,1,10,6,4,54,2,4
2,386,1,0,6,10,-4,40,10,4
2,325,1,1,10,6,4,43,10,4
2,248,1,1,10,6,4,30,10,4
2,40,1,1,10,12,-2,35,10,4
2,31,2,1,10,12,-2,42,3,4
3,893,1,0,12,10,2,39,10,4
3,853,2,0,12,10,2,46,3,4
3,826,3,0,12,10,2,49,0,4
3,749,1,1,10,12,-2,38,10,4
3,708,2,1,10,12,-2,34,6,4
3,614,2,1,10,15,-5,43,2,4
3,586,1,1,10,15,-5,53,10,4
3,492,1,0,15,10,5,14,10,4
3,402,1,0,15,17,-2,36,10,4
3,262,1,1,17,15,2,28,10,4
3,189,1,1,17,15,2,10,10,4
3,176,1,1,17,22,-5,32,10,4
4,860,1,1,24,22,2,15,10,4
4,794,1,1,24,22,2,38,10,4
4,786,1,1,24,22,2,50,10,4
4,716,2,0,22,24,-2,45,8,4
4,552,1,1,27,22,5,28,10,4
4,499,2,1,27,22,5,18,0,4
4,224,1,0,29,27,2,51,20,4
4,184,2,0,29,27,2,53,18,4
4,125,1,1,27,30,-3,35,10,4
4,105,2,1,27,30,-3,41,4,4
4,78,1,1,27,30,-3,53,10,4
4,70,2,1,27,30,-3,45,2,4
4,46,1,1,27,30,-3,42,10,4
4,42,2,1,27,30,-3,38,6,4
1,862,1,0,0,0,0,51,10,4
1,800,1,0,0,0,0,24,10,4
1,498,2,1,3,3,0,43,1,4
1,459,1,1,3,3,0,46,10,4
1,375,1,0,3,3,0,45,10,4
1,328,1,1,3,3,0,50,10,4
2,881,1,0,10,3,7,49,10,4
2,701,1,1,3,17,-14,29,10,4
2,594,1,0,17,3,14,33,10,4
2,518,1,1,3,17,-14,42,10,4
2,386,1,1,3,17,-14,50,10,4
2,158,1,0,20,3,17,48,10,4
2,88,2,0,20,3,17,28,1,4
2,67,1,0,20,3,17,30,10,4
3,837,3,1,3,23,-20,54,0,4
3,564,1,0,23,3,20,1,1,4
3,419,1,1,10,23,-13,23,10,4
3,255,1,1,10,23,-13,27,10,4
3,239,1,1,10,23,-13,40,10,4
3,1,1,0,23,10,13,36,10,4
4,830,2,1,10,23,-13,24,2,4
4,758,3,1,10,23,-13,43,0,4
4,711,1,1,10,23,-13,44,10,4
4,512,1,0,23,17,6,47,10,4
4,232,2,0,23,17,6,37,0,4
4,125,1,0,23,20,3,35,10,4
4,97,1,1,20,23,-3,30,10,4
4,22,2,0,26,20,6,47,12,4
1,822,1,1,0,0,0,33,10,4
1,732,1,0,0,0,0,27,10,4
1,701,1,0,0,0,0,55,10,4
1,580,2,1,0,0,0,17,1,4
1,325,1,0,7,0,7,47,10,4
1,272,1,0,7,0,7,28,10,4
1,157,1,1,3,7,-4,52,10,4
1,40,1,0,7,10,-3,54,10,4
2,815,1,0,7,13,-6,39,10,4
2,670,1,1,20,7,13,54,10,4
2,613,1,0,7,20,-13,45,10,4
2,554,1,0,7,20,-13,3,3,4
2,483,2,0,7,20,-13,1,1,4
2,465,1,0,7,27,-20,30,10,4
2,406,1,0,7,27,-20,42,10,4
2,342,1,1,27,7,20,28,10,4
2,312,2,1,27,7,20,33,5,4
2,285,1,1,27,7,20,40,10,4
2,149,1,0,7,28,-21,36,10,4
2,138,2,0,7,28,-21,35,11,4
2,102,1,1,28,7,21,46,10,4
2,94,2,1,28,7,21,55,1,4
2,76,3,0,7,28,-21,54,0,4
2,15,1,0,7,31,-24,35,10,4
3,809,1,1,31,7,24,36,10,4
3,757,3,1,31,7,24,45,1,4
3,719,1,1,31,7,24,47,10,4
3,668,1,1,31,7,24,51,10,4
3,644,2,1,31,7,24,45,4,4
3,477,1,1,31,14,17,11,10,4
3,440,2,1,31,14,17,16,5,4
3,423,1,1,31,14,17,23,10,4
3,313,1,1,31,14,17,51,10,4
3,252,1,1,31,14,17,10,10,4
3,118,2,1,31,14,17,54,1,4
4,900,2,0,14,31,-17,35,1,4
4,793,2,1,31,14,17,39,20,4
4,698,1,1,32,14,18,47,10,4
4,640,2,0,14,32,-18,51,10,4
4,469,1,1,32,14,18,44,10,4
4,124,1,0,14,32,-18,34,10,4
4,118,2,0,14,32,-18,35,11,4
4,69,1,1,35,14,21,44,10,4
4,47,2,1,35,14,21,45,9,4
4,12,1,0,14,35,-21,25,10,4
4,1,2,0,14,35,-21,29,7,4
1,808,1,1,0,0,0,42,10,4
1,736,1,0,0,0,0,43,10,4
1,665,1,1,0,0,0,54,10,4
1,258,1,0,0,7,-7,9,9,4
1,111,2,0,0,14,-14,36,13,4
2,759,1,1,14,3,11,35,10,4
2,653,1,0,3,14,-11,41,10,4
2,627,1,0,3,14,-11,30,10,4
2,554,1,0,3,14,-11,19,10,4
2,534,1,1,21,3,18,50,10,4
2,257,2,0,3,21,-18,42,3,4
2,199,1,0,3,21,-18,27,10,4
2,108,1,1,24,3,21,52,10,4
3,875,1,1,31,3,28,40,20,4
3,723,1,0,3,31,-28,25,10,4
3,699,2,0,3,31,-28,16,1,4
3,644,1,0,3,31,-28,14,10,4
3,538,1,0,3,34,-31,37,10,4
3,343,1,1,34,3,31,10,10,4
3,251,3,1,34,3,31,35,1,4
3,230,1,1,34,3,31,37,10,4
3,105,2,0,3,34,-31,40,0,4
3,76,1,0,3,34,-31,42,10,4
3,1,1,1,34,3,31,15,10,4
4,812,2,0,5,34,-29,53,2,4
4,518,1,1,36,5,31,35,10,4
4,376,0,1,36,5,31,11,0,4
4,271,3,0,5,36,-31,46,1,4
4,157,1,1,36,5,31,26,10,4
4,108,1,1,36,5,31,21,10,4
4,71,1,0,5,36,-31,49,10,4
1,865,1,1,0,0,0,45,10,4
1,644,1,1,0,0,0,33,10,4
1,544,1,0,0,7,-7,24,10,4
1,277,2,0,0,10,-10,44,1,4
1,162,1,1,10,0,10,11,10,4
1,121,1,1,10,0,10,6,6,4
1,42,1,1,10,7,3,35,10,4
2,730,2,0,7,13,-6,40,2,4
2,698,1,0,7,13,-6,43,10,4
2,613,1,1,13,7,6,45,10,4
2,493,1,1,13,10,3,49,10,4
2,434,2,0,10,13,-3,45,5,4
2,220,1,0,10,21,-11,55,10,4
2,141,2,1,21,10,11,38,2,4
3,782,2,1,21,17,4,43,2,4
3,630,1,0,17,21,-4,21,10,4
3,496,2,1,21,17,4,48,1,4
4,877,1,1,27,20,7,48,10,4
4,778,1,0,20,27,-7,7,10,4
4,713,1,0,20,27,-7,18,10,4
4,584,1,0,20,27,-7,54,10,4
4,283,2,0,21,27,-6,1,10,4
4,231,1,1,29,21,8,40,10,4
4,109,1,0,21,36,-15,49,10,4
4,95,2,0,21,36,-15,50,11,4
1,773,1,0,7,0,7,55,10,4
1,696,1,1,0,7,-7,18,10,4
1,455,1,1,0,10,-10,46,10,4
1,378,1,0,10,0,10,20,10,4
1,226,2,1,0,10,-10,52,3,4
1,35,1,1,1,10,-9,15,10,4
2,709,2,0,12,1,11,31,10,4
2,659,1,1,1,12,-11,29,10,4
2,600,1,1,1,12,-11,41,10,4
2,562,2,1,1,12,-11,44,7,4
2,519,1,0,12,1,11,32,10,4
2,301,1,0,12,1,11,49,10,4
2,219,1,0,12,1,11,54,10,4
2,152,1,1,8,12,-4,13,10,4
2,97,1,1,8,15,-7,35,10,4
3,893,1,1,15,15,0,33,10,4
3,865,1,0,15,15,0,42,10,4
3,781,1,0,15,22,-7,34,10,4
3,691,1,1,22,15,7,50,10,4
3,505,2,0,15,22,-7,52,5,4
3,439,1,0,15,22,-7,3,3,4
3,285,1,0,15,29,-14,26,10,4
3,243,2,0,15,29,-14,33,3,4
3,105,1,1,29,15,14,50,10,4
3,16,1,0,15,29,-14,20,10,4
4,900,1,0,15,29,-14,31,10,4
4,888,2,0,15,29,-14,39,2,4
4,805,1,0,15,29,-14,35,10,4
4,767,2,0,15,29,-14,27,2,4
4,724,3,0,15,29,-14,25,0,4
4,685,1,0,15,29,-14,24,10,4
4,574,1,0,15,29,-14,2,2,4
4,310,1,1,36,22,14,27,10,4
4,270,2,1,36,22,14,35,2,4
4,230,1,1,36,22,14,43,10,4
4,195,1,0,22,36,-14,18,10,4
4,168,1,0,22,36,-14,4,4,4
4,48,1,1,43,22,21,2,2,4
4,46,1,0,29,43,-14,50,10,4
1,740,1,1,0,0,0,55,10,4
1,668,1,0,0,0,0,27,10,4
1,604,1,1,0,0,0,15,10,4
1,434,2,1,0,7,-7,39,2,4
1,395,1,1,0,7,-7,43,10,4
1,360,2,1,0,7,-7,50,3,4
1,224,1,1,0,14,-14,47,5,4
1,193,2,1,0,14,-14,51,1,4
1,140,2,0,14,0,14,42,2,4
1,115,3,0,14,0,14,43,1,4
1,73,1,0,14,0,14,46,10,4
1,33,2,0,14,0,14,54,2,4
2,613,1,0,16,0,16,53,10,4
2,541,1,1,0,16,-16,32,10,4
2,405,1,1,0,16,-16,11,10,4
2,387,1,1,0,16,-16,30,10,4
2,296,1,0,16,0,16,38,10,4
2,210,1,1,0,16,-16,52,10,4
2,65,1,0,16,3,13,35,10,4
3,895,1,0,16,3,13,42,10,4
3,739,2,0,16,3,13,41,1,4
3,703,1,0,16,3,13,22,10,4
3,689,2,0,16,3,13,19,7,4
3,635,3,0,16,3,13,15,3,4
3,490,2,0,16,10,6,32,9,4
3,454,1,0,16,10,6,41,10,4
3,355,1,1,10,23,-13,43,10,4
3,267,1,0,23,10,13,54,10,4
3,202,1,0,23,10,13,4,10,4
3,177,1,0,23,10,13,22,10,4
3,69,1,0,23,10,13,41,10,4
4,824,3,1,10,23,-13,47,1,4
4,711,1,0,23,10,13,45,10,4
4,488,1,0,23,20,3,35,10,4
4,469,2,0,23,20,3,43,2,4
4,351,1,1,20,23,-3,36,10,4
4,138,1,1,27,24,3,35,10,4
4,107,1,1,27,24,3,46,10,4
4,61,1,0,24,27,-3,52,10,4
4,49,2,1,27,24,3,52,16,4
1,847,1,1,0,0,0,42,10,4
1,654,0,1,0,3,-3,54,0,4
1,407,1,0,3,0,3,50,10,4
1,347,2,0,3,0,3,21,2,4
1,276,1,0,3,0,3,16,10,4
1,192,1,0,3,3,0,35,10,4
1,98,1,1,3,3,0,26,10,4
2,778,1,0,3,3,0,29,10,4
2,625,1,1,10,3,7,51,10,4
2,282,1,1,10,6,4,16,10,4
2,218,1,1,10,6,4,26,10,4
2,134,1,1,10,6,4,41,10,4
2,54,3,1,10,9,1,2,0,4
2,37,1,1,10,9,1,1,1,4
2,28,1,1,10,15,-5,33,10,4
2,17,2,1,10,15,-5,38,5,4
3,893,1,0,15,10,5,31,10,4
3,816,1,0,15,13,2,35,10,4
3,634,2,1,13,15,-2,29,2,4
3,465,1,0,15,13,2,1,1,4
3,407,2,1,19,15,4,54,2,4
3,308,3,1,19,15,4,40,0,4
3,222,2,1,19,15,4,30,1,4
3,117,1,1,19,18,1,35,10,4
3,77,1,1,19,18,1,45,10,4
3,55,2,1,19,18,1,54,1,4
4,625,1,0,18,22,-4,35,10,4
4,599,2,0,18,22,-4,35,10,4
4,421,2,0,18,22,-4,42,0,4
4,381,2,1,22,18,4,53,0,4
4,285,1,1,22,25,-3,30,10,4
4,223,1,0,25,22,3,54,10,4
4,180,2,0,25,22,3,45,1,4
4,108,1,0,25,22,3,3,3,4
4,65,1,0,25,29,-4,35,10,4
4,58,2,0,25,29,-4,28,3,4
1,808,1,0,0,0,0,48,10,4
1,788,2,1,0,0,0,54,2,4
1,668,1,0,0,7,-7,27,10,4
1,535,1,1,7,0,7,16,10,4
1,102,1,0,0,10,-10,35,10,4
1,32,1,1,10,0,10,34,10,4
2,900,1,1,10,0,10,53,10,4
2,830,1,0,0,10,-10,35,10,4
2,720,1,1,10,7,3,34,10,4
2,639,1,1,10,7,3,3,3,4
2,555,1,1,10,14,-4,34,10,4
2,395,1,0,14,11,3,35,10,4
2,370,2,0,14,11,3,42,3,4
2,322,1,0,14,11,3,51,10,4
2,155,1,1,11,15,-4,35,10,4
2,93,2,0,15,11,4,48,4,4
2,43,1,1,11,15,-4,24,10,4
3,865,1,0,15,11,4,42,10,4
3,782,1,1,11,15,-4,34,10,4
3,771,2,1,11,15,-4,42,2,4
3,667,1,0,15,11,4,35,10,4
3,642,2,0,15,11,4,26,1,4
3,601,3,0,15,11,4,25,0,4
3,439,1,0,15,17,-2,18,10,4
3,374,1,0,15,17,-2,34,10,4
3,274,2,1,17,15,2,29,10,4
3,152,1,0,15,17,-2,52,10,4
3,65,1,0,15,17,-2,6,10,4
4,862,1,1,19,15,4,46,15,4
4,849,2,1,19,15,4,55,6,4
4,674,1,0,15,19,-4,50,10,4
4,649,1,0,15,19,-4,37,10,4
4,548,1,0,15,20,-5,35,10,4
4,535,1,0,15,20,-5,50,10,4
4,403,1,0,15,20,-5,35,10,4
4,217,1,1,20,15,5,40,10,4
4,153,2,1,20,23,-3,50,3,4
4,106,1,1,20,23,-3,53,10,4
4,100,2,1,20,23,-3,50,7,4
4,64,1,1,20,23,-3,48,10,4
1,867,2,0,0,0,0,26,10,4
1,838,1,0,0,0,0,39,10,4
1,801,2,0,0,0,0,45,4,4
1,763,1,0,0,0,0,50,10,4
1,637,1,1,0,0,0,34,10,4
1,480,1,0,3,0,3,55,10,4
1,382,1,0,3,0,3,50,10,4
1,295,1,0,3,0,3,25,10,4
1,102,1,0,3,0,3,1,1,4
2,862,2,1,7,4,3,33,12,4
2,822,1,1,7,4,3,46,10,4
2,724,1,0,4,7,-3,12,10,4
2,627,2,0,4,7,-3,40,0,4
2,581,1,0,4,7,-3,39,10,4
2,467,1,0,4,10,-6,46,10,4
2,386,1,1,10,4,6,22,10,4
2,348,2,1,10,4,6,22,10,4
2,300,1,1,10,4,6,42,10,4
2,241,1,1,10,4,6,53,10,4
2,165,1,0,4,10,-6,1,1,4
2,118,1,1,17,4,13,21,10,4
2,87,1,1,17,4,13,35,10,4
2,10,1,1,17,4,13,54,10,4
3,893,1,1,17,4,13,38,10,4
3,735,1,1,17,4,13,27,10,4
3,697,1,1,17,4,13,39,10,4
3,632,1,0,4,17,-13,30,10,4
3,583,2,0,4,17,-13,46,5,4
3,495,2,0,4,17,-13,50,15,4
3,445,1,1,17,4,13,15,10,4
3,417,2,1,17,4,13,24,1,4
3,194,1,1,17,7,10,40,10,4
3,54,1,0,7,17,-10,19,10,4
4,804,1,0,7,17,-10,45,10,4
4,760,2,0,7,17,-10,38,3,4
4,522,1,0,7,20,-13,24,10,4
4,462,1,0,7,20,-13,1,1,4
4,305,1,1,23,7,16,32,10,4
4,205,2,0,7,23,-16,40,10,4
4,160,1,1,23,7,16,30,10,4
4,153,1,1,23,7,16,43,10,4
4,126,2,1,23,7,16,46,7,4
4,100,3,1,23,7,16,52,1,4
4,66,1,0,7,23,-16,22,10,4
4,58,2,0,7,23,-16,20,8,4
1,895,1,1,0,0,0,27,10,4
1,535,2,0,0,0,0,25,1,4
1,315,1,0,0,3,-3,43,10,4
1,67,1,1,3,3,0,37,10,4
2,674,1,0,3,6,-3,49,10,4
2,636,2,1,6,3,3,53,2,4
2,499,2,1,6,3,3,11,5,4
2,274,1,0,10,6,4,53,10,4
2,119,1,1,6,10,-4,41,10,4
2,101,2,1,6,10,-4,32,1,4
3,891,1,0,17,6,11,43,10,4
3,755,1,1,6,20,-14,35,10,4
3,639,2,0,20,6,14,34,4,4
3,510,1,1,6,27,-21,34,10,4
3,469,2,1,6,27,-21,43,1,4
3,362,2,0,27,6,21,29,7,4
3,306,2,1,6,27,-21,54,1,4
3,154,1,0,27,6,21,47,10,4
3,72,1,1,6,27,-21,45,10,4
4,865,2,1,6,27,-21,19,11,4
4,702,1,0,30,7,23,35,10,4
4,378,2,0,30,7,23,14,3,4
4,230,1,1,7,37,-30,39,10,4
4,147,1,0,37,7,30,54,10,4
4,142,2,0,37,7,30,55,9,4
4,118,1,1,7,37,-30,45,10,4
4,93,2,1,7,37,-30,48,13,4
4,40,2,1,7,37,-30,1,10,4
1,894,1,0,0,0,0,43,10,4
1,695,1,1,0,0,0,6,5,4
1,625,1,1,0,0,0,27,10,4
1,559,1,1,0,0,0,51,10,4
1,539,1,1,0,0,0,40,10,4
1,445,1,1,0,3,-3,35,10,4
1,374,1,1,0,10,-10,27,10,4
1,247,1,0,10,0,10,51,10,4
1,191,1,0,10,0,10,32,10,4
1,157,1,0,10,0,10,16,10,4
1,1,1,1,3,10,-7,7,10,4
2,900,1,1,3,10,-7,21,10,4
2,844,1,1,3,10,-7,31,10,4
2,740,2,0,10,3,7,29,3,4
2,696,1,0,10,3,7,33,10,4
2,655,2,0,10,3,7,42,1,4
2,610,1,0,10,3,7,50,10,4
2,445,1,0,10,3,7,45,10,4
2,420,2,0,10,3,7,37,2,4
2,312,2,0,10,3,7,11,2,4
2,189,2,1,10,10,0,40,15,4
2,119,1,0,13,10,3,17,10,4
3,889,1,1,10,13,-3,32,10,4
3,862,2,1,10,13,-3,41,1,4
3,793,1,0,13,10,3,44,10,4
3,732,2,0,13,10,3,37,3,4
3,666,2,0,13,10,3,34,10,4
3,626,3,0,13,10,3,25,1,4
3,547,1,0,13,10,3,9,9,4
3,422,1,1,13,13,0,41,10,4
3,378,2,1,13,13,0,38,7,4
3,353,1,1,13,13,0,27,10,4
3,319,2,1,13,13,0,20,3,4
3,252,1,1,13,16,-3,35,10,4
3,109,1,0,16,13,3,8,8,4
3,89,1,0,16,20,-4,49,10,4
3,48,1,1,20,16,4,50,10,4
4,892,1,1,20,23,-3,40,10,4
4,860,1,1,20,23,-3,51,10,4
4,687,2,0,23,20,3,16,6,4
4,468,1,0,23,23,0,47,10,4
4,439,2,0,23,23,0,39,2,4
4,403,1,0,23,23,0,23,10,4
4,354,1,0,23,23,0,1,1,4
4,282,1,0,23,23,0,1,1,4
4,247,2,0,23,23,0,1,1,4
4,169,2,0,23,26,-3,50,10,4
4,141,1,1,26,23,3,13,10,4
4,114,1,1,26,23,3,28,10,4
4,109,2,1,26,23,3,27,11,4
1,896,1,0,0,0,0,38,10,4
1,874,2,0,0,0,0,46,2,4
1,842,1,0,0,0,0,50,10,4
1,716,2,1,0,0,0,15,2,4
1,676,1,1,0,0,0,22,10,4
1,488,1,1,0,1,-1,35,10,4
1,397,1,0,1,0,1,53,10,4
1,230,1,1,0,2,-2,31,10,4
2,848,1,1,0,2,-2,23,10,4
2,618,1,0,2,0,2,20,10,4
2,538,1,0,2,0,2,27,10,4
2,479,1,0,2,0,2,8,8,4
2,458,2,0,2,0,2,3,3,4
2,417,3,0,2,0,2,2,2,4
2,354,2,0,2,0,2,15,1,4
2,111,2,1,0,2,-2,49,2,4
2,79,1,0,2,0,2,10,10,4
2,71,1,0,2,0,2,31,10,4
2,49,2,0,2,0,2,35,6,4
3,705,1,0,2,3,-1,35,10,4
3,591,1,0,2,3,-1,19,10,4
3,505,1,0,2,3,-1,31,10,4
3,351,1,1,6,2,4,40,10,4
3,172,3,0,9,6,3,51,0,4
3,44,1,0,9,6,3,13,10,4
4,872,1,1,6,9,-3,43,10,4
4,797,1,0,9,6,3,44,10,4
4,680,1,1,6,9,-3,52,10,4
4,592,1,1,6,10,-4,35,10,4
4,571,2,1,6,10,-4,44,1,4
4,468,1,0,10,6,4,50,10,4
4,445,1,1,6,10,-4,50,10,4
4,309,2,1,6,10,-4,21,2,4
4,124,2,0,10,6,4,24,0,4
4,57,1,0,10,13,-3,43,10,4
4,46,2,0,10,13,-3,51,2,4
4,38,1,1,13,10,3,38,10,4
4,26,2,1,13,10,3,30,2,4
5,0,2,0,16,13,3,26,1,4
5,0,3,0,16,13,3,25,0,4
5,0,2,0,16,13,3,15,1,4
5,0,3,0,16,13,3,14,0,4
5,0,1,0,16,13,3,13,10,4
5,900,1,0,16,13,3,2,2,4
1,894,1,1,0,0,0,32,10,4
1,812,2,1,0,0,0,51,3,4
1,737,2,1,0,0,0,53,13,4
1,600,2,0,0,0,0,37,9,4
1,530,1,0,0,0,0,25,10,4
1,463,1,0,0,0,0,37,10,4
1,343,1,1,0,0,0,32,10,4
1,145,1,1,3,0,3,53,10,4
1,106,2,1,3,0,3,48,5,4
2,854,1,0,7,3,4,26,10,4
2,748,1,0,7,6,1,52,10,4
2,702,2,0,7,6,1,54,8,4
2,562,1,1,6,7,-1,35,10,4
2,470,1,1,6,7,-1,15,10,4
2,431,2,1,6,7,-1,6,1,4
2,364,1,1,6,7,-1,5,5,4
2,283,2,1,6,7,-1,2,2,4
2,153,1,0,14,13,1,37,10,4
2,120,2,0,14,13,1,54,10,4
3,894,1,0,17,16,1,33,10,4
3,868,2,0,17,16,1,40,3,4
3,833,1,0,17,16,1,55,10,4
3,798,2,1,16,17,-1,50,5,4
3,708,0,0,17,16,1,22,0,4
3,633,1,1,16,17,-1,1,1,4
3,609,1,1,16,24,-8,31,10,4
3,512,2,0,24,16,8,47,3,4
3,182,3,1,16,24,-8,50,2,4
3,170,1,1,16,24,-8,51,10,4
3,141,2,1,16,24,-8,52,11,4
3,141,2,1,16,24,-8,52,11,4
3,39,1,1,16,25,-9,49,10,4
3,1,2,1,16,25,-9,50,9,4
4,885,2,0,25,16,9,45,10,4
4,837,1,0,25,16,9,10,10,4
4,773,1,0,25,23,2,36,10,4
4,744,2,0,25,23,2,43,3,4
4,569,2,1,23,25,-2,32,1,4
4,544,1,1,23,25,-2,44,10,4
4,507,2,1,23,25,-2,48,6,4
4,464,1,0,25,23,2,52,10,4
4,395,1,0,25,23,2,40,10,4
4,297,1,0,25,26,-1,35,10,4
4,264,1,1,26,25,1,52,10,4
4,176,1,1,26,25,1,23,10,4
4,156,2,1,26,25,1,23,10,4
4,107,1,0,25,26,-1,42,10,4
4,102,2,0,25,26,-1,39,7,4
4,78,1,0,25,26,-1,26,10,4
1,847,1,0,0,0,0,46,10,4
1,790,1,1,0,0,0,52,10,4
1,665,0,0,0,0,0,49,0,4
1,619,1,0,0,0,0,27,10,4
1,556,1,0,0,0,0,37,10,4
1,471,1,0,0,0,0,8,8,4
1,403,1,0,0,3,-3,35,10,4
1,347,1,1,3,0,3,53,10,4
1,299,2,1,3,0,3,32,1,4
1,239,1,1,3,0,3,5,5,4
1,109,1,0,7,3,4,28,10,4
1,15,1,0,7,6,1,35,10,4
2,877,1,0,7,6,1,48,10,4
2,833,2,0,7,6,1,52,6,4
2,792,1,1,6,7,-1,49,10,4
2,762,2,1,6,7,-1,42,3,4
2,659,1,1,6,7,-1,23,10,4
2,621,2,1,6,7,-1,14,1,4
2,582,1,1,6,7,-1,9,9,4
2,474,1,0,14,6,8,16,10,4
2,415,1,0,14,6,8,34,10,4
2,395,1,0,14,6,8,48,10,4
2,370,2,0,14,6,8,55,3,4
2,339,1,1,6,14,-8,47,10,4
2,156,1,1,6,22,-16,32,10,4
2,97,1,0,22,6,16,29,10,4
3,894,1,1,6,22,-16,38,10,4
3,865,2,1,6,22,-16,45,3,4
3,792,1,0,22,6,16,30,10,4
3,701,1,1,6,22,-16,47,10,4
3,669,2,0,22,6,16,54,1,4
3,474,1,1,13,22,-9,20,10,4
3,373,1,1,13,22,-9,10,10,4
3,268,1,0,22,13,9,18,10,4
3,8,2,0,22,13,9,36,2,4
4,878,2,0,22,13,9,41,9,4
4,810,3,0,22,13,9,48,2,4
4,779,1,0,22,13,9,53,10,4
4,735,2,1,13,22,-9,49,2,4
4,700,1,1,13,22,-9,45,10,4
4,655,2,1,13,22,-9,35,0,4
4,611,1,1,13,22,-9,25,10,4
4,550,1,1,13,22,-9,13,10,4
4,443,1,1,13,25,-12,35,10,4
4,358,1,0,25,13,12,26,10,4
4,316,2,0,25,13,12,28,8,4
4,252,1,1,13,25,-12,32,10,4
4,179,1,1,13,28,-15,35,10,4
4,133,1,1,13,28,-15,42,10,4
4,127,2,1,13,28,-15,39,7,4
4,104,1,1,13,28,-15,31,10,4
4,72,1,1,13,28,-15,1,1,4
4,40,3,1,13,35,-22,36,4,4
4,26,1,0,35,13,22,50,10,4
1,307,1,0,3,7,-4,20,10,4
1,157,1,1,7,3,4,21,10,4
1,118,2,1,7,3,4,13,2,4
2,870,1,0,10,7,3,29,10,4
2,680,1,1,14,10,4,44,10,4
2,574,1,0,10,14,-4,26,5,4
2,550,2,0,10,14,-4,30,1,4
2,415,1,0,10,14,-4,1,1,4
2,295,2,0,10,21,-11,44,1,4
2,126,2,1,24,10,14,33,5,4
2,72,2,1,24,10,14,18,4,4
3,883,1,0,17,24,-7,42,10,4
3,713,1,1,24,17,7,13,10,4
3,481,2,0,24,24,0,23,2,4
3,450,3,0,24,24,0,25,0,4
3,70,1,1,24,24,0,16,5,4
4,809,1,0,27,24,3,11,10,4
4,779,2,0,27,24,3,17,4,4
4,675,2,0,27,24,3,32,2,4
4,470,2,1,24,27,-3,34,8,4
4,415,1,0,27,24,3,38,10,4
4,182,1,1,24,27,-3,38,10,4
4,153,3,1,24,27,-3,28,0,4
4,145,1,1,24,27,-3,27,10,4
4,127,2,1,24,27,-3,20,3,4
4,105,1,1,24,27,-3,16,10,4
4,51,2,0,30,24,6,42,12,4
1,823,1,1,0,0,0,26,10,4
1,711,2,1,0,0,0,47,2,4
1,528,1,0,3,0,3,28,5,4
1,506,2,0,3,0,3,26,3,4
1,474,1,0,3,0,3,16,10,4
1,272,1,1,7,3,4,21,10,4
1,236,2,1,7,3,4,23,8,4
1,200,1,1,7,3,4,32,10,4
1,41,1,1,7,3,4,49,10,4
1,1,2,0,3,7,-4,51,0,4
2,573,1,0,3,10,-7,18,10,4
2,540,1,0,3,10,-7,3,3,4
2,482,1,0,3,17,-14,8,8,4
2,331,1,0,3,17,-14,1,1,4
2,226,1,1,24,3,21,17,10,4
2,167,1,1,24,6,18,35,10,4
2,160,1,1,24,6,18,53,10,4
2,85,1,1,31,6,25,29,10,4
2,78,1,1,31,6,25,49,10,4
2,34,2,0,6,31,-25,52,11,4
3,811,1,1,31,6,25,39,10,4
3,588,1,1,31,6,25,36,10,4
3,484,1,0,6,31,-25,23,10,4
3,419,1,0,6,31,-25,49,10,4
3,353,1,1,31,6,25,35,10,4
3,326,2,1,31,6,25,41,4,4
3,172,1,1,31,6,25,18,10,4
3,159,1,1,31,13,18,45,10,4
4,791,2,0,16,31,-15,23,10,4
4,673,1,1,31,16,15,28,10,4
4,599,2,1,31,16,15,19,19,4
4,576,1,1,31,16,15,40,10,4
4,546,1,0,16,31,-15,54,10,4
4,502,2,0,16,31,-15,47,3,4
4,437,1,0,16,31,-15,34,10,4
4,323,1,0,16,31,-15,4,4,4
4,191,1,1,45,16,29,44,10,4
4,116,1,1,45,16,29,2,2,4
4,114,1,0,23,45,-22,53,10,4
4,108,2,0,23,45,-22,48,5,4
4,84,1,0,23,45,-22,40,10,4
1,893,1,1,0,0,0,29,10,4
1,603,1,0,0,0,0,41,10,4
1,523,1,0,0,3,-3,25,10,4
1,456,1,0,0,3,-3,48,10,4
1,318,1,1,3,0,3,24,10,4
1,209,1,1,3,0,3,1,1,4
1,184,1,1,3,7,-4,26,10,4
1,155,1,1,3,7,-4,42,10,4
1,18,1,0,7,3,4,14,10,4
2,900,1,0,7,3,4,34,10,4
2,810,2,1,3,7,-4,47,1,4
2,779,1,1,3,7,-4,44,10,4
2,717,2,1,3,7,-4,13,2,4
2,696,1,1,3,14,-11,34,10,4
2,563,1,0,14,3,11,48,10,4
2,458,2,0,14,3,11,12,4,4
2,251,1,0,14,10,4,49,10,4
2,164,2,0,14,13,1,27,10,4
2,24,1,1,13,14,-1,38,10,4
2,1,1,0,14,13,1,54,10,4
3,806,1,1,13,14,-1,37,10,4
3,556,2,0,14,13,1,30,10,4
3,503,1,1,13,14,-1,27,10,4
3,418,1,1,13,14,-1,35,10,4
3,192,1,1,13,14,-1,16,10,4
3,89,1,1,13,14,-1,9,9,4
4,857,1,0,17,13,4,40,10,4
4,752,1,1,13,17,-4,41,10,4
4,647,1,0,17,13,4,30,10,4
4,472,1,1,16,17,-1,20,10,4
4,330,1,1,16,24,-8,10,10,4
4,232,1,0,24,16,8,37,10,4
4,183,1,0,24,16,8,26,10,4
4,136,1,0,24,22,2,27,10,4
4,104,1,1,22,24,-2,51,10,4
4,80,2,1,22,24,-2,45,4,4
4,80,3,1,22,24,-2,42,1,4
1,835,1,0,0,0,0,49,10,4
1,762,1,1,0,0,0,43,10,4
1,475,1,1,0,0,0,45,10,4
1,332,1,0,0,7,-7,36,10,4
1,299,2,0,0,7,-7,46,0,4
1,225,1,1,7,0,7,35,10,4
1,90,3,1,7,3,4,44,1,4
2,882,1,0,3,7,-4,31,10,4
2,840,2,0,3,7,-4,40,1,4
2,578,1,0,3,7,-4,15,10,4
2,515,2,0,3,7,-4,33,3,4
2,455,2,1,7,3,4,26,10,4
2,183,1,0,4,7,-3,40,10,4
2,135,1,1,7,4,3,12,10,4
2,98,1,1,7,4,3,9,10,4
2,94,1,1,7,4,3,20,10,4
2,38,1,0,4,7,-3,13,10,4
2,20,2,0,4,7,-3,9,6,4
3,823,1,1,10,4,6,49,10,4
3,783,2,0,4,10,-6,54,3,4
3,715,2,0,4,10,-6,40,0,4
3,684,1,0,4,10,-6,39,10,4
3,585,1,0,4,10,-6,18,10,4
3,557,2,0,4,10,-6,26,2,4
3,511,1,1,10,4,6,47,10,4
4,806,2,0,4,11,-7,21,17,4
4,763,1,0,4,11,-7,54,10,4
4,625,1,1,11,4,7,30,10,4
4,570,1,1,11,4,7,25,10,4
4,470,1,1,11,4,7,37,10,4
4,404,2,0,4,11,-7,42,10,4
4,373,3,0,4,11,-7,52,0,4
4,338,1,0,4,11,-7,33,10,4
4,45,1,1,11,11,0,25,10,4
4,25,2,1,11,11,0,27,12,4
1,768,1,0,0,0,0,29,10,4
1,695,1,0,0,0,0,39,10,4
1,475,2,1,0,0,0,55,7,4
1,449,1,0,0,0,0,43,10,4
1,327,1,1,0,0,0,1,1,4
1,204,1,0,7,0,7,18,10,4
1,81,1,0,7,0,7,1,1,4
1,45,2,0,7,0,7,1,1,4
1,0,3,0,7,0,7,1,1,4
2,834,1,1,7,7,0,37,10,4
2,800,2,1,7,7,0,36,11,4
2,760,1,0,7,7,0,36,10,4
2,711,2,0,7,7,0,42,4,4
2,475,2,0,7,7,0,52,2,4
2,445,1,1,7,7,0,54,10,4
2,339,2,1,7,7,0,35,2,4
2,221,1,1,7,10,-3,39,10,4
2,124,2,1,7,10,-3,41,2,4
2,22,1,0,17,7,10,11,10,4
2,17,2,0,17,7,10,10,11,4
3,563,1,0,20,7,13,10,10,4
3,438,1,1,14,20,-6,48,10,4
3,235,2,1,14,20,-6,53,1,4
3,123,1,0,20,21,-1,27,10,4
3,47,2,0,20,21,-1,53,2,4
4,889,2,1,21,20,1,30,10,4
4,839,1,1,21,20,1,15,10,4
4,763,1,1,21,23,-2,35,10,4
4,714,2,1,21,23,-2,37,8,4
4,677,3,1,21,23,-2,44,1,4
4,617,2,1,21,23,-2,54,3,4
4,415,1,0,23,21,2,48,10,4
4,291,1,0,23,28,-5,40,10,4
4,135,1,0,23,28,-5,32,10,4
4,102,1,1,28,23,5,30,10,4
4,96,2,1,28,23,5,40,0,4
4,75,1,1,28,23,5,42,10,4
4,52,2,1,28,23,5,45,7,4
4,16,1,0,23,28,-5,11,10,4
1,888,1,0,0,0,0,36,10,4
1,797,1,0,0,0,0,1,1,4
1,778,1,0,0,7,-7,38,10,4
1,703,1,1,7,0,7,33,10,4
1,652,1,1,7,0,7,50,10,4
1,529,2,0,0,7,-7,35,2,4
1,318,1,0,0,7,-7,43,10,4
1,223,1,0,0,10,-10,33,10,4
1,51,1,1,10,7,3,34,10,4
2,821,1,0,7,10,-3,12,10,4
2,764,1,0,7,10,-3,25,10,4
2,705,1,0,7,10,-3,39,10,4
2,689,1,0,7,10,-3,49,10,4
2,625,1,1,10,7,3,33,10,4
2,588,2,1,10,7,3,23,0,4
2,536,1,1,10,14,-4,22,10,4
2,420,1,1,10,14,-4,40,10,4
2,268,1,0,14,10,4,54,10,4
2,210,1,1,10,14,-4,45,10,4
2,137,2,1,10,14,-4,32,2,4
2,116,1,1,10,14,-4,35,10,4
2,81,1,0,14,10,4,23,10,4
2,58,2,0,14,10,4,24,9,4
3,888,1,0,14,10,4,35,10,4
3,783,1,0,14,10,4,20,10,4
3,683,1,1,10,14,-4,9,9,4
3,615,1,1,10,21,-11,23,10,4
3,523,1,0,21,10,11,52,10,4
3,474,2,0,21,10,11,51,11,4
3,338,1,1,10,21,-11,28,10,4
3,301,1,1,10,21,-11,40,10,4
3,263,2,1,10,21,-11,47,3,4
3,233,3,1,10,21,-11,49,1,4
3,109,1,0,21,17,4,36,10,4
3,40,3,0,21,17,4,45,1,4
3,1,1,0,21,17,4,51,10,4
4,876,2,0,21,17,4,43,18,4
4,821,1,1,17,21,-4,19,10,4
4,799,1,1,17,21,-4,38,10,4
4,689,1,0,21,17,4,26,10,4
4,665,1,0,21,17,4,41,10,4
4,584,1,1,17,21,-4,42,10,4
4,552,1,1,17,21,-4,52,10,4
4,461,1,1,17,21,-4,47,10,4
4,363,2,1,17,21,-4,14,1,4
4,263,1,1,17,21,-4,28,15,4
4,201,1,0,21,17,4,52,10,4
4,187,2,0,21,17,4,52,10,4
4,117,2,1,17,21,-4,25,3,4
1,880,1,0,0,0,0,52,10,4
1,814,1,0,0,0,0,33,10,4
1,751,1,0,0,0,0,1,1,4
1,700,1,0,0,7,-7,36,10,4
1,548,1,1,7,0,7,12,10,4
1,525,2,1,7,0,7,18,4,4
1,489,1,1,7,0,7,25,10,4
1,435,1,1,7,0,7,39,10,4
1,344,2,0,0,7,-7,21,4,4
1,305,1,0,0,7,-7,25,10,4
1,25,1,0,0,7,-7,18,10,4
2,864,1,0,0,14,-14,47,10,4
2,658,2,1,14,3,11,43,4,4
2,573,2,0,3,14,-11,46,10,4
2,527,3,0,3,14,-11,38,2,4
2,323,1,0,3,17,-14,55,10,4
2,233,1,1,17,4,13,48,10,4
2,193,2,1,17,4,13,55,3,4
2,134,2,0,4,17,-13,55,0,4
3,894,1,0,7,17,-10,27,10,4
3,726,1,1,17,7,10,18,10,4
3,578,1,1,17,10,7,27,10,4
3,518,1,0,10,17,-7,33,10,4
3,484,2,0,10,17,-7,41,2,4
3,450,3,0,10,17,-7,43,0,4
3,358,2,1,17,10,7,49,3,4
3,263,1,1,17,10,7,26,10,4
3,123,1,1,17,17,0,46,10,4
3,80,1,0,17,17,0,50,10,4
3,46,2,0,17,17,0,50,10,4
3,10,3,0,17,17,0,40,0,4
4,763,2,0,17,17,0,28,10,4
4,692,1,0,17,17,0,41,10,4
4,610,2,1,17,17,0,34,0,4
4,325,1,1,17,20,-3,25,10,4
4,291,2,1,17,20,-3,31,4,4
4,203,1,0,20,17,3,32,10,4
4,151,1,0,20,17,3,48,10,4
4,44,1,0,20,20,0,47,10,4
4,28,2,0,20,20,0,41,4,4
4,16,1,0,20,20,0,40,20,4
1,801,2,0,0,0,0,21,10,4
1,707,1,0,0,0,0,46,10,4
1,668,1,1,0,0,0,50,10,4
1,636,2,1,0,0,0,41,1,4
1,358,1,0,3,7,-4,35,10,4
1,11,1,1,14,3,11,3,3,4
2,878,1,1,14,6,8,35,10,4
2,822,1,1,14,6,8,45,10,4
2,806,2,1,14,6,8,54,1,4
2,700,1,0,6,14,-8,14,10,4
2,587,1,0,6,21,-15,29,10,4
2,325,1,1,21,6,15,42,10,4
2,133,1,1,21,6,15,38,10,4
2,40,2,1,21,13,8,28,26,4
3,890,1,0,13,21,-8,37,10,4
3,759,1,1,21,13,8,25,10,4
3,702,1,0,13,21,-8,30,10,4
3,640,0,1,21,13,8,12,0,4
3,508,1,0,13,28,-15,50,5,4
3,241,1,1,28,13,15,45,10,4
3,217,1,0,13,28,-15,53,10,4
3,133,1,0,13,28,-15,24,10,4
4,900,2,1,35,13,22,30,2,4
4,702,1,1,35,13,22,35,10,4
4,542,1,0,16,35,-19,45,10,4
4,426,1,1,35,16,19,18,10,4
4,324,1,1,35,23,12,29,10,4
4,298,1,1,35,23,12,39,10,4
4,218,1,1,35,23,12,53,10,4
4,107,1,0,23,38,-15,36,10,4
4,102,2,0,23,38,-15,35,9,4
1,776,1,1,0,0,0,51,10,4
1,656,1,0,0,0,0,14,10,4
1,521,1,0,0,0,0,51,10,4
1,495,2,0,0,0,0,50,9,4
1,431,1,0,0,1,-1,35,10,4
1,400,2,0,0,1,-1,41,4,4
1,336,1,1,1,0,1,24,10,4
1,164,1,1,1,0,1,3,3,4
1,113,1,0,7,1,6,27,10,4
1,32,1,0,7,4,3,45,10,4
2,856,1,1,4,7,-3,1,1,4
2,560,2,1,4,14,-10,47,4,4
2,508,2,1,4,14,-10,33,4,4
2,410,1,1,4,15,-11,49,10,4
2,370,2,0,15,4,11,53,2,4
2,325,3,0,15,4,11,52,1,4
2,275,1,0,15,4,11,46,10,4
2,125,1,0,15,4,11,21,10,4
3,800,1,1,7,22,-15,49,10,4
3,766,2,1,7,22,-15,44,5,4
3,703,2,1,7,23,-16,35,10,4
3,460,1,0,23,7,16,24,10,4
3,433,1,0,23,7,16,13,10,4
3,355,1,0,23,10,13,36,10,4
3,179,1,0,23,10,13,43,10,4
3,70,1,1,10,23,-13,15,10,4
3,7,3,1,10,23,-13,24,1,4
4,900,1,1,10,23,-13,24,10,4
4,870,2,1,10,23,-13,18,4,4
4,625,1,0,26,10,16,47,10,4
4,530,1,1,10,26,-16,41,10,4
4,453,1,0,26,10,16,33,10,4
4,424,1,0,26,10,16,44,10,4
4,215,3,0,26,10,16,46,6,4
4,188,1,0,26,10,16,46,10,4
4,81,1,0,26,10,16,54,10,4
4,70,2,0,26,10,16,54,10,4
1,618,1,0,0,0,0,45,10,4
1,399,1,1,0,0,0,5,10,4
1,345,2,1,0,0,0,13,2,4
1,312,1,1,0,0,0,19,10,4
1,252,1,1,0,0,0,39,10,4
1,209,2,1,0,0,0,48,1,4
1,163,1,1,0,0,0,48,15,4
1,1,1,0,0,0,0,27,10,4
2,867,1,0,0,7,-7,47,10,4
2,775,1,1,7,0,7,33,10,4
2,599,2,0,0,7,-7,39,4,4
2,570,3,0,0,7,-7,36,1,4
2,539,1,0,0,7,-7,35,10,4
2,451,1,0,0,14,-14,35,10,4
2,310,1,1,14,1,13,35,10,4
2,183,1,0,1,14,-13,26,10,4
2,154,1,0,1,14,-13,46,10,4
2,115,1,0,1,14,-13,45,10,4
2,90,1,1,14,1,13,53,10,4
3,825,1,1,14,2,12,21,10,4
3,655,1,0,9,14,-5,16,10,4
3,530,1,1,14,9,5,41,10,4
3,506,1,1,14,16,-2,34,10,4
3,430,1,1,14,16,-2,52,10,4
3,362,1,0,16,14,2,49,10,4
3,259,1,1,14,16,-2,23,10,4
3,231,2,1,14,16,-2,26,7,4
3,177,1,0,16,14,2,45,10,4
3,92,1,1,14,16,-2,37,10,4
3,47,2,1,14,16,-2,38,9,4
3,26,1,0,16,14,2,54,10,4
4,867,1,0,16,14,2,30,10,4
4,842,2,0,16,14,2,24,4,4
4,589,1,1,14,16,-2,25,10,4
4,494,1,0,16,14,2,50,10,4
4,361,2,1,14,16,-2,24,10,4
4,252,2,0,16,14,2,37,2,4
4,185,1,0,16,14,2,35,15,4
4,178,2,0,16,14,2,37,13,4
4,130,1,1,14,16,-2,36,10,4
4,123,2,1,14,16,-2,40,6,4
4,104,1,1,14,16,-2,40,10,4
4,89,2,1,14,16,-2,32,2,4
4,65,1,1,14,16,-2,30,15,4
1,830,1,0,0,0,0,47,10,4
1,764,1,1,0,0,0,36,10,4
1,462,1,0,0,14,-14,42,5,4
1,426,2,0,0,14,-14,42,5,4
1,299,1,1,14,0,14,19,10,4
1,207,1,0,0,14,-14,31,10,4
1,69,1,0,0,17,-17,51,10,4
2,900,1,0,0,18,-18,35,10,4
2,871,2,0,0,18,-18,42,3,4
2,797,2,0,0,18,-18,52,4,4
2,758,1,1,18,0,18,51,10,4
2,554,1,1,18,3,15,35,10,4
2,426,1,1,18,3,15,30,10,4
2,316,2,1,18,10,8,40,7,4
2,243,1,0,10,18,-8,42,10,4
2,203,2,0,10,18,-8,40,8,4
2,139,1,1,21,10,11,46,10,4
2,53,1,0,10,21,-11,19,10,4
2,48,2,0,10,21,-11,25,4,4
3,740,3,0,13,21,-8,45,3,4
3,501,2,0,13,24,-11,13,1,4
3,358,1,1,24,13,11,42,10,4
3,222,1,0,13,24,-11,5,10,4
3,128,2,0,13,31,-18,42,4,4
3,9,1,0,13,31,-18,45,10,4
4,707,1,0,13,34,-21,22,10,4
4,515,1,1,37,13,24,51,10,4
4,440,1,0,13,37,-24,45,10,4
4,363,1,0,13,37,-24,13,10,4
4,252,1,1,37,13,24,54,10,4
4,150,1,0,13,37,-24,11,10,4
4,137,2,0,13,37,-24,17,4,4
4,103,1,0,13,37,-24,54,10,4
4,92,2,0,13,37,-24,50,6,4
4,51,2,0,13,37,-24,26,10,4
4,45,3,0,13,37,-24,35,1,4
4,33,1,0,13,37,-24,39,10,4
1,895,1,1,0,0,0,34,10,4
1,744,1,0,0,0,0,30,10,4
1,638,1,0,0,7,-7,51,10,4
1,407,1,0,0,7,-7,35,10,4
1,332,1,0,0,7,-7,19,10,4
1,75,1,0,0,14,-14,1,1,4
1,30,2,0,0,14,-14,1,1,4
2,740,1,1,17,0,17,15,5,4
2,712,1,1,17,0,17,40,10,4
2,675,2,1,17,0,17,43,7,4
2,581,1,0,0,17,-17,26,10,4
2,400,1,0,0,17,-17,42,10,4
2,337,1,1,17,0,17,16,10,4
2,233,1,0,0,17,-17,32,10,4
2,159,2,1,24,0,24,17,1,4
2,121,1,1,24,7,17,29,10,4
3,808,1,0,7,24,-17,48,10,4
3,726,1,0,7,24,-17,22,10,4
3,655,1,0,7,24,-17,1,1,4
3,595,2,0,7,31,-24,42,1,4
3,560,1,0,7,31,-24,46,10,4
3,127,2,1,38,14,24,22,3,4
3,38,1,1,38,14,24,8,10,4
4,853,1,1,38,14,24,43,5,4
4,820,1,1,38,14,24,48,10,4
4,702,1,0,14,38,-24,43,10,4
4,674,1,0,14,38,-24,23,10,4
4,590,3,0,14,38,-24,14,1,4
4,554,1,0,14,38,-24,11,10,4
4,327,1,1,45,14,31,25,10,4
4,200,1,0,21,45,-24,42,10,4
4,154,3,0,21,45,-24,34,2,4
4,130,1,0,21,45,-24,30,10,4
4,109,2,0,21,45,-24,27,7,4
4,59,1,0,21,45,-24,27,20,4
1,897,1,1,0,0,0,41,10,4
1,858,1,1,0,0,0,51,10,4
1,691,1,1,1,0,1,52,10,4
1,599,1,1,1,0,1,33,10,4
1,599,2,1,1,0,1,25,2,4
1,385,1,1,1,0,1,15,10,4
1,326,1,1,1,0,1,34,10,4
1,169,1,0,0,4,-4,35,10,4
1,134,2,0,0,4,-4,44,1,4
2,898,1,0,0,11,-11,44,10,4
2,859,1,1,11,0,11,54,10,4
2,553,1,0,0,11,-11,45,10,4
2,291,2,0,0,11,-11,31,2,4
2,250,1,0,0,11,-11,37,10,4
2,110,1,1,11,0,11,2,10,4
2,100,2,1,11,0,11,10,2,4
2,83,3,1,11,0,11,11,1,4
2,71,1,1,11,0,11,13,10,4
2,49,2,1,11,0,11,15,8,4
3,860,1,0,0,11,-11,47,10,4
3,768,1,0,0,11,-11,28,10,4
3,716,1,0,0,11,-11,18,10,4
3,351,1,1,14,0,14,40,10,4
3,270,1,0,0,15,-15,35,10,4
3,103,1,1,15,0,15,39,10,4
4,900,1,0,1,15,-14,30,10,4
4,880,2,0,1,15,-14,20,0,4
4,816,1,0,1,15,-14,18,10,4
4,687,1,1,22,1,21,2,10,4
4,562,2,0,1,22,-21,26,8,4
4,526,1,0,1,22,-21,21,10,4
4,282,1,1,29,1,28,47,10,4
4,250,2,1,29,1,28,55,2,4
4,208,1,0,1,29,-28,50,10,4
4,179,2,0,1,29,-28,47,7,4
4,118,1,0,1,29,-28,46,10,4
4,114,2,0,1,29,-28,43,7,4
4,0,1,1,29,1,28,1,1,4
1,741,2,0,0,7,-7,35,7,4
1,576,1,1,7,0,7,31,10,4
1,509,2,1,7,0,7,34,10,4
1,362,1,1,7,7,0,41,10,4
1,328,2,1,7,7,0,46,5,4
1,137,1,0,7,7,0,2,2,4
2,884,1,1,14,7,7,41,5,4
2,726,1,1,14,10,4,27,10,4
2,257,1,1,14,13,1,48,5,4
2,223,1,0,13,14,-1,51,10,4
2,111,2,0,13,14,-1,14,2,4
2,83,1,0,13,14,-1,10,10,4
2,43,1,0,13,17,-4,35,10,4
2,38,2,0,13,17,-4,42,3,4
2,14,3,0,13,17,-4,45,0,4
3,886,1,0,13,17,-4,36,10,4
3,801,1,1,17,13,4,33,10,4
3,656,1,0,13,17,-4,29,10,4
3,515,1,0,13,17,-4,35,10,4
3,380,1,0,13,17,-4,25,10,4
3,301,1,1,17,13,4,46,10,4
3,195,2,1,17,13,4,36,6,4
4,897,1,0,20,17,3,46,10,4
4,875,2,0,20,17,3,55,1,4
4,812,1,1,17,20,-3,32,10,4
4,784,2,1,17,20,-3,38,4,4
4,725,2,0,20,17,3,45,1,4
4,619,2,1,17,20,-3,37,0,4
4,276,1,0,27,17,10,46,10,4
4,180,2,0,27,20,7,41,4,4
4,125,1,0,27,20,7,40,10,4
4,68,1,0,27,20,7,33,10,4
4,64,2,0,27,20,7,37,6,4
1,891,1,1,0,0,0,40,10,4
1,834,2,0,0,0,0,47,0,4
1,756,1,0,0,0,0,32,10,4
1,481,1,0,0,3,-3,28,5,4
1,458,1,0,0,3,-3,18,10,4
1,357,1,0,0,10,-10,11,10,4
1,29,1,0,0,12,-12,47,10,4
2,830,1,0,0,12,-12,1,1,4
2,788,1,0,0,19,-19,46,10,4
2,755,2,0,0,19,-19,43,7,4
2,661,1,0,0,19,-19,19,10,4
2,575,1,1,21,0,21,45,10,4
2,536,2,1,21,0,21,47,8,4
2,417,1,1,21,1,20,35,10,4
2,218,1,0,1,21,-20,14,10,4
2,190,2,0,1,21,-20,23,1,4
2,164,3,0,1,21,-20,23,1,4
2,94,2,0,1,21,-20,13,4,4
3,796,1,1,24,1,23,31,10,4
3,727,1,0,1,24,-23,49,10,4
3,698,2,0,1,24,-23,44,5,4
3,653,1,0,1,24,-23,30,10,4
3,379,1,1,31,1,30,2,10,4
3,345,2,1,31,1,30,5,7,4
3,192,3,0,3,31,-28,44,1,4
3,91,1,1,31,3,28,33,10,4
3,56,1,1,31,3,28,50,10,4
3,1,2,1,31,3,28,51,9,4
4,773,1,1,31,3,28,7,10,4
4,642,2,0,3,31,-28,50,5,4
4,561,2,1,31,3,28,25,1,4
4,387,2,1,31,10,21,9,6,4
4,231,1,1,31,10,21,22,20,4
4,108,1,1,31,10,21,32,10,4
4,95,2,1,31,10,21,35,7,4
4,1,3,1,31,10,21,48,6,4
1,743,1,1,0,0,0,7,7,4
1,680,2,1,0,0,0,3,3,4
1,642,1,1,0,7,-7,19,10,4
1,555,1,1,0,7,-7,43,10,4
1,392,1,0,14,0,14,11,10,4
1,367,2,0,14,0,14,3,2,4
1,314,1,0,14,0,14,1,1,4
1,251,2,0,14,0,14,1,1,4
1,160,1,1,7,14,-7,49,10,4
1,58,2,1,7,14,-7,25,6,4
2,819,2,0,21,7,14,51,8,4
2,753,1,0,21,7,14,45,10,4
2,650,2,1,7,21,-14,31,1,4
2,386,1,0,21,7,14,4,4,4
2,361,1,0,21,14,7,39,10,4
2,84,1,0,21,14,7,29,10,4
3,892,1,0,21,17,4,35,10,4
3,637,1,0,21,20,1,35,10,4
3,600,1,0,21,20,1,45,10,4
3,448,1,1,20,21,-1,38,10,4
3,405,2,1,20,21,-1,30,2,4
3,362,1,1,20,22,-2,35,10,4
3,111,2,1,20,22,-2,39,10,4
3,45,1,1,20,25,-5,35,10,4
4,819,1,1,20,25,-5,31,10,4
4,746,1,1,20,25,-5,16,10,4
4,622,1,0,28,26,2,43,10,4
4,520,1,1,26,28,-2,22,5,4
4,201,1,0,28,26,2,8,8,4
4,153,2,0,28,26,2,3,3,4
4,115,1,1,33,28,5,30,10,4
4,103,1,0,28,33,-5,30,10,4
4,77,2,0,28,33,-5,30,10,4
4,30,1,0,28,36,-8,35,10,4
1,893,1,1,0,0,0,29,10,4
1,799,1,0,0,0,0,35,10,4
1,670,2,1,0,0,0,26,0,4
1,633,1,1,0,0,0,27,10,4
1,595,2,1,0,0,0,35,2,4
1,568,3,1,0,0,0,37,0,4
1,360,1,1,7,0,7,39,10,4
1,265,2,0,0,7,-7,45,1,4
1,232,3,0,0,7,-7,44,0,4
1,147,3,0,0,7,-7,34,1,4
1,93,1,0,0,7,-7,32,10,4
1,1,1,0,0,14,-14,48,10,4
2,804,1,0,0,14,-14,25,10,4
2,788,2,0,0,14,-14,35,0,4
2,747,1,0,0,14,-14,36,10,4
2,665,1,0,0,14,-14,54,10,4
2,564,3,1,14,0,14,18,0,4
2,549,1,0,0,14,-14,51,10,4
2,423,1,0,0,14,-14,23,10,4
2,292,2,0,0,14,-14,43,10,4
2,187,1,0,0,17,-17,35,10,4
2,118,1,1,17,0,17,28,10,4
2,28,1,0,0,17,-17,29,10,4
2,7,1,0,0,20,-20,37,10,4
2,1,2,0,0,20,-20,44,3,4
3,885,1,0,0,20,-20,37,10,4
3,854,2,0,0,20,-20,42,5,4
3,811,1,1,20,0,20,29,10,4
3,790,2,1,20,0,20,36,3,4
3,623,1,1,20,0,20,16,10,4
3,525,2,1,20,3,17,23,10,4
3,411,3,1,20,3,17,50,2,4
3,340,1,0,3,20,-17,45,10,4
3,304,2,0,3,20,-17,43,8,4
3,270,3,0,3,20,-17,36,1,4
3,206,2,0,3,20,-17,42,3,4
3,53,2,1,20,3,17,48,10,4
4,858,1,1,20,3,17,14,10,4
4,800,1,1,20,3,17,44,10,4
4,754,1,0,3,20,-17,49,10,4
4,574,1,0,3,21,-18,35,10,4
4,551,2,0,3,21,-18,41,4,4
4,411,1,1,21,3,18,19,10,4
4,385,2,1,21,3,18,23,6,4
4,336,1,1,21,3,18,44,10,4
4,244,1,0,3,21,-18,44,10,4
4,80,1,0,9,24,-15,51,10,4
4,75,2,0,9,24,-15,44,3,4
4,50,3,0,9,24,-15,41,0,4
1,893,1,0,0,0,0,28,10,4
1,782,1,1,0,0,0,40,10,4
1,608,1,0,0,0,0,14,10,4
1,533,1,0,0,0,0,2,2,4
1,451,1,0,0,7,-7,29,10,4
1,218,2,1,7,0,7,7,1,4
1,137,2,1,7,0,7,2,2,4
1,29,1,1,7,7,0,45,10,4
2,881,1,0,7,7,0,16,10,4
2,777,2,0,7,7,0,43,1,4
2,601,2,0,7,7,0,10,0,4
2,567,1,0,7,7,0,8,8,4
2,303,1,1,10,7,3,50,10,4
2,227,1,1,10,7,3,17,10,4
2,177,2,1,10,7,3,12,5,4
3,706,1,1,10,10,0,7,7,4
3,680,1,1,10,17,-7,24,10,4
3,630,2,1,10,17,-7,32,2,4
3,572,1,0,17,10,7,51,10,4
3,361,1,1,13,17,-4,17,10,4
3,253,1,0,17,13,4,19,10,4
3,218,2,0,17,13,4,23,6,4
3,117,1,1,13,17,-4,24,10,4
4,828,2,1,13,17,-4,48,1,4
4,366,2,0,24,22,2,32,13,4
4,348,3,0,24,22,2,44,1,4
4,153,1,0,24,22,2,38,10,4
4,72,2,0,24,25,-1,11,4,4
1,738,1,1,0,0,0,51,10,4
1,712,2,0,0,0,0,54,5,4
1,584,2,0,0,0,0,1,1,4
1,563,1,0,0,7,-7,31,10,4
1,459,1,1,7,0,7,40,10,4
1,334,1,1,7,0,7,15,10,4
1,266,1,0,0,7,-7,55,10,4
1,241,2,1,7,0,7,52,7,4
1,79,1,1,7,0,7,44,10,4
2,874,1,0,0,10,-10,35,10,4
2,815,1,0,0,10,-10,49,10,4
2,636,2,0,0,17,-17,37,0,4
2,447,1,0,0,17,-17,38,10,4
2,301,1,1,17,1,16,35,10,4
2,267,2,1,17,1,16,43,2,4
2,230,1,1,17,1,16,50,10,4
2,137,1,0,1,17,-16,18,10,4
2,68,1,1,17,1,16,20,10,4
3,895,1,0,1,17,-16,36,10,4
3,699,1,1,17,1,16,51,10,4
3,415,1,0,1,24,-23,46,10,4
3,323,1,0,1,25,-24,35,10,4
3,39,1,0,15,25,-10,40,10,4
3,6,2,0,15,25,-10,31,1,4
4,880,1,0,15,28,-13,35,10,4
4,702,1,0,15,28,-13,49,10,4
4,675,1,0,15,28,-13,36,10,4
4,640,2,0,15,28,-13,32,6,4
4,563,2,0,15,28,-13,13,3,4
4,376,1,0,15,34,-19,42,10,4
4,267,2,0,15,34,-19,17,4,4
4,135,1,0,15,48,-33,24,10,4
4,127,1,0,15,48,-33,36,10,4
4,16,1,1,48,15,33,39,10,4
1,885,1,1,0,0,0,41,10,4
1,852,2,1,0,0,0,31,0,4
1,650,2,1,0,3,-3,53,2,4
1,618,1,0,3,0,3,50,10,4
1,565,1,0,3,7,-4,41,10,4
1,364,1,1,7,3,4,1,1,4
1,339,1,1,7,10,-3,32,10,4
1,305,2,1,7,10,-3,40,2,4
1,120,1,1,7,10,-3,42,10,4
2,877,1,0,10,10,0,35,10,4
2,581,2,1,10,10,0,26,0,4
2,472,1,0,10,10,0,10,10,4
2,314,3,0,10,10,0,31,1,4
2,184,2,0,16,10,6,47,3,4
2,157,1,0,16,10,6,40,10,4
2,144,2,0,16,10,6,32,2,4
3,815,1,1,13,19,-6,45,10,4
3,766,2,1,13,19,-6,55,0,4
3,647,1,0,19,20,-1,47,10,4
3,554,1,1,20,19,1,30,10,4
3,424,1,1,20,19,1,25,10,4
3,342,1,1,20,22,-2,33,10,4
3,121,1,0,22,23,-1,22,10,4
4,877,1,0,22,23,-1,35,10,4
4,837,2,0,22,23,-1,27,2,4
4,720,1,0,22,23,-1,10,10,4
4,570,1,1,30,22,8,22,10,4
4,492,1,1,30,28,2,25,10,4
4,342,1,1,30,28,2,26,10,4
4,261,1,1,30,28,2,50,10,4
4,179,1,0,28,30,-2,15,10,4
4,134,2,0,28,33,-5,35,10,4
1,895,1,0,0,0,0,18,10,4
1,765,2,1,0,0,0,40,10,4
1,665,1,1,0,0,0,29,10,4
1,408,2,1,0,0,0,16,4,4
1,365,1,1,0,0,0,21,10,4
1,290,1,1,0,0,0,40,10,4
1,190,2,1,0,0,0,50,10,4
2,900,1,1,1,0,1,29,10,4
2,818,1,0,0,1,-1,44,10,4
2,566,1,1,1,0,1,51,10,4
2,443,1,0,0,1,-1,45,10,4
2,418,1,1,1,7,-6,25,10,4
2,381,2,1,1,7,-6,32,3,4
2,257,1,0,7,1,6,12,10,4
2,201,1,0,7,1,6,32,10,4
2,147,2,0,7,1,6,47,10,4
2,122,2,1,1,7,-6,25,7,4
3,690,1,1,10,7,3,38,10,4
3,665,2,1,10,7,3,45,3,4
3,595,1,1,10,7,3,53,5,4
3,476,1,0,7,11,-4,35,10,4
3,414,1,0,7,11,-4,45,10,4
3,310,1,1,11,7,4,3,10,4
3,193,1,1,11,7,4,27,10,4
3,16,2,0,8,11,-3,40,1,4
4,900,1,0,8,11,-3,34,10,4
4,799,2,0,8,18,-10,23,2,4
4,758,3,0,8,18,-10,25,0,4
4,724,1,0,8,18,-10,25,10,4
4,695,1,0,8,18,-10,14,10,4
4,225,1,1,25,11,14,20,10,4
4,181,1,1,25,11,14,44,10,4
4,127,1,1,27,11,16,35,10,4
4,48,2,1,27,11,16,44,4,4
1,873,1,0,0,0,0,45,10,4
1,458,2,0,3,3,0,33,2,4
1,436,3,0,3,3,0,32,1,4
1,353,1,0,3,3,0,15,10,4
1,212,1,1,6,3,3,37,10,4
1,116,1,0,3,6,-3,14,10,4
1,57,1,0,3,6,-3,46,10,4
2,889,1,1,6,10,-4,34,10,4
2,847,2,1,6,10,-4,41,3,4
2,538,2,1,6,17,-11,43,2,4
2,492,1,1,6,17,-11,48,10,4
2,456,2,1,6,17,-11,52,6,4
2,396,1,0,17,6,11,16,10,4
2,303,1,0,17,6,11,27,10,4
2,294,2,0,17,6,11,35,2,4
2,210,1,0,17,6,11,48,10,4
2,40,2,0,17,9,8,35,10,4
2,25,1,0,17,9,8,51,10,4
2,11,1,1,9,17,-8,39,10,4
3,893,1,0,17,9,8,23,10,4
3,753,1,1,9,17,-8,28,10,4
3,602,2,0,24,9,15,45,2,4
3,454,2,0,24,12,12,44,1,4
3,418,3,0,24,12,12,45,0,4
3,171,1,0,31,15,16,35,10,4
4,882,1,0,31,15,16,48,10,4
4,810,2,1,15,31,-16,54,2,4
4,754,1,1,15,31,-16,34,10,4
4,659,1,1,15,31,-16,10,10,4
4,517,2,0,34,15,19,49,1,4
4,421,1,1,15,34,-19,40,10,4
4,342,1,1,15,34,-19,18,10,4
4,189,2,0,34,15,19,53,3,4
4,139,1,0,34,15,19,53,10,4
4,126,2,0,34,15,19,55,8,4
4,62,0,0,34,15,19,42,0,4
1,858,1,0,0,0,0,52,10,4
1,793,1,1,0,1,-1,35,10,4
1,738,1,1,0,1,-1,45,10,4
1,687,2,1,0,1,-1,52,3,4
1,667,3,1,0,1,-1,54,1,4
1,539,2,0,1,0,1,18,2,4
1,478,1,0,1,0,1,37,10,4
1,321,1,1,0,1,-1,35,10,4
1,258,2,1,0,1,-1,12,3,4
1,139,1,1,0,4,-4,35,10,4
1,111,1,1,0,4,-4,46,10,4
1,24,1,0,4,0,4,52,10,4
1,1,1,1,0,11,-11,27,10,4
2,836,1,1,0,11,-11,52,10,4
2,798,2,0,11,0,11,50,2,4
2,650,1,0,11,3,8,35,10,4
2,584,1,1,3,11,-8,38,10,4
2,530,1,0,11,3,8,43,10,4
2,346,1,0,11,6,5,40,10,4
2,224,1,0,11,6,5,28,10,4
2,143,1,0,11,13,-2,30,10,4
2,70,2,1,13,11,2,51,10,4
2,38,1,1,13,11,2,17,10,4
3,892,1,0,14,13,1,45,10,4
3,825,1,1,13,14,-1,49,10,4
3,817,2,1,13,14,-1,41,2,4
3,789,1,1,13,14,-1,39,10,4
3,706,1,1,13,14,-1,16,10,4
3,643,1,0,14,13,1,40,10,4
3,568,1,0,14,13,1,52,10,4
3,479,1,1,13,14,-1,12,10,4
3,444,2,1,13,14,-1,9,13,4
3,347,1,0,14,13,1,55,10,4
3,169,1,0,16,13,3,52,10,4
3,112,2,1,13,16,-3,49,1,4
3,71,1,1,13,16,-3,28,10,4
4,877,1,1,13,16,-3,50,10,4
4,813,1,1,13,16,-3,39,10,4
4,771,2,1,13,16,-3,31,2,4
4,597,1,0,19,13,6,46,10,4
4,537,1,1,13,19,-6,37,10,4
4,403,1,1,13,19,-6,18,10,4
4,153,1,1,13,26,-13,41,10,4
4,133,2,1,13,26,-13,37,6,4
4,114,3,1,13,26,-13,33,2,4
4,92,1,0,26,13,13,52,10,4
4,73,2,0,26,13,13,51,11,4
1,894,1,1,0,0,0,9,10,4
1,800,2,0,0,0,0,45,10,4
1,742,3,0,0,0,0,55,0,4
1,704,1,1,0,0,0,54,10,4
1,666,2,1,0,0,0,52,8,4
1,493,1,1,0,7,-7,28,10,4
1,424,1,1,0,7,-7,50,10,4
1,233,1,1,0,7,-7,44,10,4
1,165,1,0,7,0,7,30,10,4
1,89,1,1,0,7,-7,42,10,4
2,900,1,0,7,0,7,21,10,4
2,839,1,0,7,0,7,40,10,4
2,720,2,1,0,7,-7,39,2,4
2,615,2,1,0,7,-7,19,10,4
2,360,2,0,10,0,10,45,10,4
2,166,1,1,0,13,-13,35,10,4
2,157,2,1,0,13,-13,42,3,4
2,61,2,0,13,3,10,35,10,4
3,895,1,0,13,3,10,23,10,4
3,752,1,1,3,13,-10,43,10,4
3,617,2,0,13,3,10,54,1,4
3,444,2,1,3,13,-10,15,0,4
3,366,2,1,3,13,-10,25,1,4
3,339,1,1,3,13,-10,26,10,4
3,280,1,1,3,13,-10,55,10,4
3,223,1,0,13,3,10,39,10,4
3,174,1,0,13,3,10,18,10,4
4,900,1,0,13,3,10,40,10,4
4,875,2,0,13,3,10,43,7,4
4,822,3,0,13,3,10,48,2,4
4,777,1,0,13,3,10,51,10,4
4,741,1,1,3,13,-10,45,10,4
4,698,1,1,3,13,-10,24,10,4
4,661,2,1,3,13,-10,16,2,4
4,583,1,1,3,20,-17,7,10,4
4,499,1,1,3,20,-17,41,10,4
4,474,1,1,3,20,-17,27,10,4
4,416,1,1,3,23,-20,35,10,4
4,337,1,0,23,3,20,40,10,4
4,250,1,1,3,23,-20,27,10,4
4,127,1,0,26,3,23,23,10,4
4,122,2,0,26,3,23,30,3,4
4,99,1,0,26,3,23,34,10,4
4,77,1,0,26,3,23,46,10,4
1,750,3,1,0,0,0,51,1,4
1,706,1,1,0,0,0,49,10,4
1,675,2,1,0,0,0,40,1,4
1,576,1,1,0,3,-3,33,10,4
1,486,1,0,3,0,3,7,10,4
1,425,1,0,3,0,3,51,10,4
1,320,1,0,3,0,3,21,10,4
1,252,1,0,3,3,0,31,10,4
1,162,2,1,3,3,0,48,10,4
1,93,1,0,3,3,0,35,10,4
2,900,2,1,3,3,0,51,6,4
2,750,3,1,3,4,-1,35,10,4
2,730,1,0,4,3,1,41,10,4
2,235,1,0,7,6,1,30,10,4
2,190,2,0,7,6,1,36,4,4
2,156,1,1,6,7,-1,21,10,4
2,136,1,1,6,7,-1,49,10,4
2,108,2,0,7,6,1,52,2,4
2,91,3,0,7,6,1,51,0,4
3,827,2,1,9,7,2,30,25,4
3,611,2,0,7,9,-2,35,1,4
3,525,1,1,9,7,2,35,10,4
3,81,1,0,7,12,-5,51,10,4
4,833,1,1,12,14,-2,28,10,4
4,698,1,0,14,12,2,41,10,4
4,399,1,0,14,12,2,47,10,4
4,307,1,0,14,15,-1,35,10,4
4,268,2,0,14,15,-1,35,10,4
4,233,3,0,14,15,-1,45,0,4
4,142,1,1,15,14,1,39,10,4
4,86,2,1,15,17,-2,40,5,4
4,60,1,0,17,15,2,21,10,4
4,37,2,0,17,15,2,21,10,4
1,898,1,1,0,1,-1,35,10,4
1,674,1,1,0,1,-1,28,10,4
1,579,1,1,0,1,-1,49,10,4
1,496,2,1,0,1,-1,15,10,4
1,433,1,1,0,1,-1,50,10,4
1,215,1,1,0,1,-1,34,10,4
1,55,1,1,0,4,-4,47,10,4
2,788,1,1,0,4,-4,25,10,4
2,775,2,1,0,4,-4,34,1,4
2,481,1,0,4,0,4,26,10,4
2,468,1,0,4,7,-3,28,10,4
2,389,1,0,4,7,-3,41,10,4
2,356,1,1,7,4,3,36,5,4
2,320,2,1,7,4,3,32,1,4
2,215,1,1,7,4,3,35,10,4
2,180,2,1,7,4,3,43,2,4
2,159,3,1,7,4,3,45,0,4
2,111,1,0,4,7,-3,13,10,4
2,106,2,0,4,7,-3,20,3,4
2,48,1,0,4,7,-3,5,10,4
2,40,2,0,4,7,-3,4,11,4
3,790,1,0,4,7,-3,52,10,4
3,680,1,1,7,4,3,41,10,4
3,489,1,0,4,7,-3,26,5,4
3,443,2,0,4,7,-3,28,3,4
3,384,1,1,7,4,3,5,10,4
3,125,1,0,7,7,0,54,10,4
3,65,3,1,7,7,0,46,0,4
3,29,1,1,7,7,0,44,10,4
4,654,1,1,7,7,0,20,10,4
4,620,2,1,7,7,0,30,0,4
4,341,2,1,10,7,3,35,0,4
4,265,2,1,10,7,3,25,1,4
4,114,2,1,10,7,3,35,5,4
4,58,1,0,7,10,-3,49,10,4
4,54,2,0,7,10,-3,45,6,4
1,690,1,0,3,0,3,32,10,4
1,603,1,0,3,3,0,36,10,4
1,564,2,0,3,3,0,41,5,4
1,344,1,1,3,10,-7,23,10,4
1,260,1,0,10,3,7,35,10,4
1,230,2,0,10,3,7,37,8,4
1,110,1,1,3,10,-7,32,10,4
1,75,1,1,3,10,-7,52,10,4
1,49,2,0,10,3,7,53,5,4
2,877,1,0,10,3,7,1,1,4
2,863,1,0,10,10,0,20,10,4
2,617,1,0,10,10,0,31,10,4
2,555,2,0,10,10,0,50,3,4
2,367,1,1,10,10,0,30,10,4
2,305,1,1,10,10,0,45,10,4
2,273,2,1,10,10,0,40,5,4
2,148,1,0,13,10,3,47,10,4
2,101,1,0,13,10,3,36,10,4
2,70,1,0,13,13,0,35,10,4
2,29,2,1,13,13,0,6,10,4
2,26,3,1,13,13,0,6,10,4
3,893,1,1,13,20,-7,33,10,4
3,811,1,0,20,13,7,25,10,4
3,726,0,0,20,13,7,40,0,4
3,584,2,0,20,13,7,30,3,4
3,548,3,0,20,13,7,32,1,4
3,479,1,0,20,20,0,19,15,4
3,424,1,1,20,20,0,24,10,4
3,300,1,1,20,20,0,44,10,4
3,188,2,1,20,20,0,19,2,4
3,75,1,1,20,23,-3,35,10,4
3,20,1,1,20,23,-3,52,10,4
3,1,2,1,20,23,-3,55,7,4
4,886,1,0,23,20,3,25,10,4
4,800,1,0,23,20,3,47,10,4
4,771,2,0,23,20,3,54,3,4
4,493,1,1,20,26,-6,45,10,4
4,452,2,0,26,20,6,54,10,4
4,391,1,0,26,20,6,20,10,4
4,363,2,0,26,20,6,29,1,4
4,176,1,0,26,20,6,25,10,4
4,65,2,0,26,20,6,18,12,4
1,890,1,0,0,0,0,40,10,4
1,806,1,1,0,0,0,17,15,4
1,725,1,1,0,0,0,38,10,4
1,635,1,1,0,0,0,46,10,4
1,581,1,1,0,0,0,16,10,4
1,506,1,1,0,3,-3,25,10,4
1,477,2,1,0,3,-3,34,1,4
1,413,1,0,3,0,3,39,10,4
1,373,2,0,3,0,3,47,2,4
1,334,1,0,3,0,3,51,10,4
1,293,2,1,0,3,-3,50,1,4
1,223,1,1,0,3,-3,28,10,4
1,184,2,1,0,3,-3,21,3,4
1,12,1,0,6,0,6,51,10,4
2,855,1,1,0,6,-6,32,10,4
2,819,2,1,0,6,-6,41,1,4
2,677,2,1,0,6,-6,27,10,4
2,574,1,1,0,9,-9,38,10,4
2,536,1,1,0,9,-9,49,10,4
2,486,1,0,9,0,9,33,10,4
2,362,1,0,9,0,9,18,10,4
2,282,1,0,9,0,9,6,6,4
2,133,2,1,3,9,-6,24,1,4
2,119,3,1,3,9,-6,23,0,4
2,67,1,1,3,9,-6,52,10,4
2,46,0,1,3,9,-6,49,0,4
3,851,1,1,6,9,-3,47,10,4
3,644,1,1,6,9,-3,42,10,4
3,561,1,1,6,12,-6,35,10,4
3,364,1,1,6,20,-14,35,10,4
3,326,2,1,6,20,-14,43,2,4
3,275,3,1,6,20,-14,44,1,4
3,151,2,1,6,20,-14,46,0,4
3,37,1,1,6,23,-17,35,10,4
3,25,1,1,6,23,-17,47,10,4
4,874,1,0,23,6,17,34,10,4
4,805,1,0,23,6,17,49,10,4
4,408,1,1,6,23,-17,45,10,4
4,270,1,0,23,6,17,21,10,4
4,228,2,0,23,6,17,19,12,4
4,186,1,0,23,6,17,34,10,4
4,135,1,0,23,6,17,48,10,4
1,818,1,0,0,7,-7,14,10,4
1,720,2,1,7,0,7,52,1,4
1,621,1,1,7,0,7,38,10,4
1,400,2,1,7,7,0,29,10,4
1,329,1,0,7,7,0,47,10,4
1,304,1,0,7,14,-7,39,10,4
1,233,1,1,14,7,7,9,10,4
1,144,2,1,14,7,7,49,2,4
1,92,3,1,14,7,7,47,0,4
1,66,1,1,14,7,7,46,10,4
1,44,2,1,14,7,7,36,0,4
1,1,2,1,14,7,7,29,4,4
2,900,3,1,14,7,7,25,0,4
2,746,1,1,14,14,0,30,10,4
2,532,1,1,14,14,0,23,10,4
2,471,1,1,14,14,0,3,3,4
2,386,1,1,14,17,-3,30,15,4
2,337,1,1,14,17,-3,47,10,4
2,252,3,1,14,17,-3,55,2,4
2,221,1,0,17,14,3,53,10,4
2,166,1,0,17,14,3,24,10,4
2,148,1,0,17,14,3,5,5,4
3,848,1,0,17,20,-3,50,10,4
3,697,1,0,17,20,-3,45,10,4
3,369,1,0,20,23,-3,35,10,4
3,299,1,1,23,20,3,22,10,4
3,260,2,1,23,20,3,24,8,4
3,174,1,0,20,23,-3,28,10,4
4,619,1,1,23,23,0,35,10,4
4,600,2,1,23,23,0,41,4,4
4,558,1,0,23,23,0,28,10,4
4,544,1,0,23,23,0,38,10,4
4,370,1,0,23,23,0,1,1,4
4,316,2,0,23,23,0,1,1,4
4,239,1,0,23,30,-7,47,10,4
4,144,1,0,23,30,-7,42,10,4
4,139,2,0,23,30,-7,35,3,4
4,127,1,0,23,30,-7,28,10,4
4,103,2,0,23,30,-7,25,7,4
1,891,1,0,0,0,0,42,10,4
1,829,1,0,0,0,0,23,10,4
1,814,2,0,0,0,0,16,3,4
1,756,1,0,0,0,0,10,10,4
1,681,1,0,0,7,-7,27,10,4
1,635,2,0,0,7,-7,20,3,4
1,503,1,1,14,0,14,42,10,4
1,443,1,1,14,0,14,40,10,4
1,393,2,1,14,0,14,18,2,4
1,363,1,1,14,0,14,11,10,4
1,280,1,1,14,3,11,35,10,4
1,100,1,1,14,6,8,35,10,4
2,855,1,1,14,6,8,32,10,4
2,386,2,0,6,14,-8,38,3,4
2,217,1,0,6,14,-8,3,3,4
2,99,1,0,6,21,-15,2,2,4
2,75,2,0,6,28,-22,53,0,4
2,41,2,0,6,28,-22,41,10,4
3,891,1,1,28,6,22,36,10,4
3,810,1,0,6,28,-22,20,10,4
3,779,2,0,6,28,-22,29,1,4
3,730,3,0,6,28,-22,29,1,4
3,700,1,0,6,28,-22,31,10,4
3,567,2,0,6,28,-22,31,1,4
3,502,1,0,6,31,-25,35,10,4
3,448,2,1,31,6,25,51,3,4
3,306,1,1,31,6,25,35,10,4
3,268,2,1,31,6,25,27,2,4
3,113,1,1,31,9,22,35,10,4
4,854,1,0,9,31,-22,46,10,4
4,829,1,0,9,31,-22,35,10,4
4,717,1,0,9,34,-25,37,10,4
4,589,1,1,34,9,25,32,10,4
4,572,1,0,9,34,-25,40,10,4
4,415,1,1,37,9,28,30,10,4
4,329,1,0,9,37,-28,39,10,4
4,216,2,1,37,9,28,35,10,4
4,114,1,1,37,9,28,24,10,4
1,770,1,1,0,0,0,26,10,4
1,696,2,1,0,0,0,10,4,4
1,550,2,0,3,0,3,35,3,4
1,510,1,0,3,0,3,51,10,4
1,305,1,1,0,3,-3,24,10,4
1,166,2,1,0,6,-6,38,7,4
1,101,1,0,6,0,6,18,10,4
1,20,1,0,6,0,6,44,10,4
2,781,1,0,6,6,0,52,10,4
2,547,1,0,6,6,0,16,10,4
2,459,1,1,6,6,0,51,10,4
2,178,2,1,6,6,0,24,1,4
2,107,1,1,6,6,0,3,3,4
2,93,2,1,6,13,-7,25,2,4
2,25,2,1,6,13,-7,45,4,4
3,833,1,1,6,13,-7,34,10,4
3,742,1,1,6,13,-7,16,10,4
3,582,1,1,6,20,-14,48,10,4
3,480,1,0,20,13,7,16,10,4
3,448,1,0,20,13,7,31,10,4
3,70,2,0,20,13,7,47,1,4
3,2,2,0,20,13,7,9,5,4
4,888,1,0,20,13,7,2,2,4
4,735,1,0,20,27,-7,33,10,4
4,443,1,1,29,20,9,42,10,4
4,318,1,1,29,20,9,43,10,4
4,167,2,0,20,29,-9,15,5,4
4,140,1,1,29,20,9,45,10,4
4,92,1,0,20,29,-9,30,10,4
4,16,1,1,29,20,9,2,2,4
1,882,1,1,0,0,0,37,10,4
1,836,1,0,0,0,0,53,10,4
1,797,2,0,0,0,0,46,3,4
1,726,2,0,0,1,-1,35,10,4
1,609,2,0,0,1,-1,51,2,4
1,533,2,0,0,1,-1,41,2,4
1,495,1,0,0,1,-1,37,10,4
1,339,1,1,4,0,4,28,10,4
1,84,2,1,4,0,4,28,1,4
1,36,2,1,4,0,4,27,10,4
2,885,1,1,4,3,1,51,10,4
2,626,1,1,5,3,2,45,10,4
2,546,1,0,3,5,-2,20,10,4
2,422,1,1,5,3,2,46,10,4
2,233,2,1,5,3,2,34,10,4
2,191,3,1,5,3,2,43,1,4
2,37,1,1,5,10,-5,28,10,4
2,30,2,1,5,10,-5,36,2,4
3,824,2,1,5,10,-5,37,5,4
3,786,1,1,5,10,-5,29,10,4
3,660,1,0,17,5,12,46,10,4
3,601,1,0,17,5,12,11,10,4
3,572,2,0,17,5,12,15,6,4
3,544,1,0,17,5,12,22,10,4
3,479,1,1,5,17,-12,52,10,4
3,264,1,0,17,5,12,51,10,4
3,127,1,1,5,17,-12,25,10,4
3,10,1,0,17,5,12,47,10,4
4,663,1,1,5,19,-14,9,10,4
4,595,1,0,21,5,16,40,10,4
4,533,1,1,5,21,-16,51,10,4
4,351,1,0,21,5,16,22,10,4
4,308,2,0,21,5,16,27,5,4
4,157,1,1,5,21,-16,43,10,4
4,153,2,1,5,21,-16,42,9,4
4,56,1,1,5,31,-26,45,10,4
4,47,2,1,5,31,-26,42,7,4
4,28,3,1,5,31,-26,37,2,4
1,870,2,1,0,0,0,27,10,4
1,778,1,0,0,0,0,45,10,4
1,487,1,1,0,10,-10,35,10,4
1,432,1,1,0,10,-10,45,10,4
1,285,2,1,0,10,-10,1,1,4
1,248,1,1,0,17,-17,43,10,4
1,112,1,1,0,17,-17,1,1,4
2,837,2,0,24,0,24,34,1,4
2,781,2,0,24,0,24,45,1,4
2,746,1,0,24,0,24,51,10,4
2,599,1,1,0,24,-24,50,10,4
2,581,1,0,24,0,24,40,10,4
2,432,2,1,0,32,-32,39,6,4
2,387,1,1,0,32,-32,46,10,4
2,267,1,0,32,7,25,46,10,4
2,59,2,1,7,32,-25,15,2,4
3,874,2,1,7,32,-25,38,2,4
3,833,1,0,32,7,25,15,10,4
3,760,1,0,32,7,25,55,10,4
3,650,2,1,7,32,-25,24,12,4
3,596,1,0,32,7,25,33,10,4
3,561,1,1,7,32,-25,54,10,4
3,509,1,1,7,32,-25,16,10,4
3,358,1,1,7,35,-28,49,10,4
3,128,1,1,7,35,-28,54,10,4
3,95,2,0,35,7,28,52,6,4
3,54,3,0,35,7,28,51,5,4
4,861,1,0,35,7,28,31,10,4
4,834,2,0,35,7,28,40,1,4
4,540,1,1,7,35,-28,28,10,4
4,344,1,0,38,14,24,45,10,4
4,282,2,0,38,14,24,33,22,4
4,195,2,1,14,38,-24,46,1,4
4,167,1,0,38,14,24,13,10,4
4,162,2,0,38,14,24,17,6,4
4,137,1,0,38,14,24,25,10,4
4,43,1,0,38,14,24,38,10,4
4,26,2,0,38,14,24,42,6,4
1,894,1,1,0,0,0,40,10,4
1,817,1,1,0,0,0,50,10,4
1,680,1,0,0,0,0,53,10,4
1,418,2,1,0,3,-3,37,3,4
1,357,1,0,3,0,3,6,25,4
1,228,1,0,3,0,3,39,10,4
1,53,2,0,3,3,0,35,10,4
2,855,1,0,3,3,0,52,10,4
2,778,1,0,3,3,0,49,10,4
2,639,2,1,3,3,0,40,10,4
2,602,1,1,3,3,0,54,10,4
2,478,1,0,3,3,0,30,10,4
2,409,3,0,3,3,0,20,0,4
2,327,1,0,3,3,0,7,7,4
2,307,1,0,3,10,-7,45,10,4
2,242,1,1,10,3,7,43,10,4
2,154,1,1,10,3,7,8,10,4
2,97,1,1,10,3,7,45,15,4
2,37,1,0,3,10,-7,23,10,4
3,893,1,0,3,10,-7,31,10,4
3,719,3,1,10,3,7,39,0,4
3,685,1,1,10,3,7,42,10,4
3,342,1,0,3,10,-7,17,10,4
3,293,2,0,3,10,-7,25,2,4
3,170,1,1,10,3,7,27,10,4
3,102,1,1,10,10,0,24,10,4
3,63,2,1,10,10,0,18,4,4
3,22,1,1,10,10,0,10,10,4
4,766,1,0,13,11,2,20,10,4
4,737,2,0,13,11,2,21,9,4
4,664,1,0,13,11,2,44,10,4
4,632,2,0,13,11,2,53,1,4
4,594,1,0,13,11,2,55,10,4
4,563,2,1,11,13,-2,45,0,4
4,525,1,1,11,13,-2,39,10,4
4,482,2,1,11,13,-2,34,5,4
4,294,1,0,16,17,-1,33,10,4
4,260,2,0,16,17,-1,41,2,4
4,230,1,0,16,17,-1,50,10,4
4,164,1,1,17,16,1,19,10,4
4,113,1,1,17,22,-5,52,10,4
4,106,2,1,17,22,-5,47,5,4
4,80,1,1,17,22,-5,27,10,4
4,57,2,1,17,22,-5,22,5,4
1,815,1,0,0,0,0,51,10,4
1,777,2,0,0,0,0,55,6,4
1,715,1,1,0,7,-7,35,10,4
1,520,2,0,7,1,6,42,3,4
1,455,1,1,1,7,-6,20,10,4
1,254,1,1,1,10,-9,53,10,4
1,130,1,0,10,2,8,23,10,4
1,35,1,0,10,5,5,29,10,4
2,796,1,0,10,5,5,13,10,4
2,676,1,0,10,8,2,35,10,4
2,608,1,0,10,8,2,52,10,4
2,542,1,1,8,17,-9,34,10,4
2,468,1,1,8,20,-12,35,10,4
2,387,1,0,20,8,12,16,10,4
2,353,2,0,20,8,12,22,4,4
2,314,1,0,20,8,12,34,10,4
2,152,0,0,27,8,19,28,0,4
2,109,1,0,27,8,19,48,10,4
3,892,1,0,30,8,22,20,10,4
3,857,2,0,30,8,22,29,1,4
3,818,1,0,30,8,22,35,10,4
3,648,1,1,8,30,-22,48,10,4
3,615,2,1,8,30,-22,55,3,4
3,536,2,0,30,8,22,40,4,4
3,493,3,0,30,8,22,38,2,4
3,297,1,0,30,11,19,50,10,4
3,184,2,1,11,30,-19,25,2,4
3,74,3,1,11,30,-19,39,1,4
4,900,1,1,11,30,-19,52,10,4
4,874,1,0,30,11,19,47,10,4
4,832,2,0,30,11,19,40,3,4
4,798,3,0,30,11,19,39,2,4
4,693,1,0,30,14,16,35,10,4
4,664,2,0,30,14,16,32,13,4
4,471,1,0,30,14,16,33,10,4
4,432,2,0,30,14,16,37,6,4
4,378,2,0,30,14,16,49,10,4
4,182,2,0,30,17,13,43,2,4
4,110,1,1,17,30,-13,40,10,4
1,844,1,0,0,0,0,47,10,4
1,765,1,0,0,0,0,20,10,4
1,585,1,0,0,3,-3,52,10,4
1,554,2,0,0,3,-3,50,8,4
1,414,1,0,0,10,-10,35,10,4
1,366,2,1,10,0,10,7,5,4
1,312,1,0,3,10,-7,47,10,4
1,274,2,0,3,10,-7,45,12,4
1,164,1,1,10,3,7,42,10,4
1,0,1,0,3,10,-7,19,10,4
2,802,1,1,17,3,14,7,7,4
2,718,1,1,17,6,11,39,10,4
2,600,1,0,6,17,-11,55,10,4
2,405,1,1,17,13,4,24,10,4
2,351,1,1,17,13,4,38,10,4
2,95,1,1,17,16,1,27,10,4
3,727,2,0,19,17,2,55,3,4
3,679,1,0,19,17,2,45,10,4
3,302,1,0,19,20,-1,4,4,4
3,171,2,1,27,19,8,20,0,4
3,107,1,1,27,19,8,1,1,4
3,89,1,1,27,26,1,33,10,4
4,900,1,0,26,27,-1,44,10,4
4,768,1,1,27,26,1,32,10,4
4,360,1,0,29,30,-1,52,10,4
4,301,1,0,29,30,-1,50,10,4
4,116,1,1,33,29,4,38,10,4
4,91,1,1,33,29,4,48,10,4
4,61,1,0,29,33,-4,49,10,4
4,56,1,0,29,33,-4,38,10,4
4,50,2,0,29,33,-4,34,6,4
1,896,1,0,0,0,0,34,10,4
1,814,1,1,0,0,0,33,10,4
1,557,2,0,0,0,0,19,1,4
1,427,3,0,0,0,0,8,2,4
1,407,1,0,0,7,-7,19,10,4
1,134,1,1,7,0,7,35,10,4
1,93,2,1,7,0,7,43,2,4
2,789,1,0,0,7,-7,29,10,4
2,674,2,0,0,14,-14,33,1,4
2,636,1,0,0,14,-14,34,10,4
2,585,2,0,0,14,-14,43,1,4
2,548,1,0,0,14,-14,45,10,4
2,307,1,0,0,14,-14,32,10,4
2,228,1,0,0,14,-14,17,10,4
2,96,1,1,21,0,21,1,1,4
2,35,2,0,7,28,-21,30,15,4
3,889,1,1,28,7,21,37,10,4
3,822,1,1,28,7,21,50,10,4
3,606,1,0,7,28,-21,3,3,4
3,513,1,0,7,31,-24,51,10,4
3,393,2,1,31,7,24,38,3,4
3,181,1,0,14,31,-17,38,10,4
3,6,1,1,32,14,18,31,10,4
4,843,1,1,32,17,15,35,10,4
4,689,1,0,17,32,-15,42,10,4
4,522,2,0,17,35,-18,39,6,4
4,402,2,0,17,35,-18,24,5,4
4,337,2,0,17,38,-21,45,0,4
4,135,2,1,38,17,21,22,4,4
4,131,1,1,38,17,21,29,10,4
4,78,1,1,38,17,21,48,10,4
4,54,2,1,38,17,21,53,5,4
1,864,1,1,0,0,0,20,15,4
1,789,1,1,0,0,0,37,10,4
1,628,1,1,0,0,0,49,10,4
1,368,1,0,7,0,7,48,5,4
1,324,1,0,7,0,7,54,10,4
1,228,1,1,0,7,-7,20,10,4
1,203,2,1,0,7,-7,27,3,4
2,900,2,1,0,7,-7,35,1,4
2,870,1,1,0,7,-7,41,10,4
2,817,2,0,7,0,7,33,0,4
2,714,1,0,7,0,7,19,10,4
2,689,1,0,7,7,0,30,10,4
2,461,1,1,7,7,0,20,10,4
2,440,2,1,7,7,0,29,1,4
2,297,1,1,7,7,0,27,10,4
2,191,1,0,14,7,7,46,10,4
3,885,1,0,14,21,-7,16,10,4
3,598,2,1,21,14,7,17,7,4
3,571,3,1,21,14,7,11,1,4
3,508,1,1,21,14,7,8,8,4
3,247,3,1,21,21,0,49,1,4
3,178,1,0,21,21,0,48,10,4
3,2,1,0,21,21,0,25,10,4
4,900,2,0,21,21,0,16,1,4
4,695,1,0,21,28,-7,50,10,4
4,664,1,0,21,28,-7,31,10,4
4,586,1,0,21,28,-7,14,10,4
4,365,1,1,31,21,10,45,10,4
4,335,1,0,21,31,-10,47,10,4
4,293,2,0,21,31,-10,40,3,4
4,249,1,0,21,31,-10,33,10,4
4,107,2,1,38,21,17,41,16,4
4,79,1,1,38,21,17,34,10,4
4,73,2,1,38,21,17,39,5,4
1,893,1,1,0,0,0,40,10,4
1,671,1,0,0,1,-1,35,10,4
1,565,1,1,1,0,1,12,10,4
1,484,1,0,0,1,-1,31,10,4
1,417,1,1,1,0,1,51,10,4
1,247,1,0,0,1,-1,22,10,4
1,109,1,0,0,4,-4,35,10,4
1,67,2,0,0,4,-4,41,4,4
1,22,1,1,4,0,4,54,10,4
2,833,1,0,1,4,-3,20,10,4
2,690,1,1,7,1,6,45,10,4
2,527,1,0,4,7,-3,40,10,4
2,465,2,0,4,7,-3,47,17,4
2,416,1,0,4,8,-4,35,10,4
2,397,1,0,4,8,-4,48,10,4
2,308,1,1,8,4,4,21,10,4
2,225,1,1,8,4,4,37,10,4
2,159,1,0,4,8,-4,8,10,4
2,58,1,0,4,8,-4,32,10,4
2,38,1,1,8,4,4,48,10,4
3,764,1,1,8,4,4,31,10,4
3,659,2,1,8,4,4,11,2,4
3,560,1,1,8,4,4,27,10,4
3,325,2,1,8,4,4,35,5,4
3,215,1,1,8,7,1,35,10,4
3,144,1,0,7,8,-1,32,10,4
3,79,1,0,7,8,-1,45,10,4
4,900,1,1,8,7,1,51,10,4
4,865,2,0,7,8,-1,52,4,4
4,686,1,1,8,7,1,37,10,4
4,643,2,1,8,7,1,31,4,4
4,597,1,1,8,7,1,21,10,4
4,556,2,1,8,7,1,21,10,4
4,512,3,1,8,7,1,12,1,4
4,432,2,1,8,7,1,19,2,4
4,406,1,1,8,7,1,24,10,4
4,157,1,0,7,8,-1,42,10,4
4,146,1,0,7,8,-1,55,10,4
4,67,2,1,8,7,1,32,1,4
4,63,1,1,8,7,1,26,10,4
4,41,2,1,8,7,1,24,8,4
1,684,1,0,0,0,0,28,10,4
1,644,2,0,0,0,0,33,5,4
1,576,1,1,0,0,0,49,5,4
1,510,1,1,0,0,0,30,10,4
1,419,2,1,0,0,0,14,10,4
1,398,1,1,0,7,-7,30,10,4
1,259,1,1,7,7,0,46,10,4
1,85,1,1,7,10,-3,37,10,4
1,17,1,1,7,10,-3,49,10,4
2,869,1,1,7,10,-3,7,10,4
2,829,2,1,7,10,-3,16,1,4
2,695,1,0,10,7,3,30,10,4
2,650,1,0,10,7,3,52,10,4
2,527,1,1,7,10,-3,43,10,4
2,499,2,1,7,10,-3,52,1,4
2,380,3,0,10,7,3,48,2,4
2,94,3,0,17,7,10,40,0,4
2,43,1,1,7,17,-10,26,10,4
3,892,1,0,17,7,10,37,10,4
3,668,2,1,7,17,-10,33,1,4
3,631,1,1,7,17,-10,37,10,4
3,526,1,0,17,7,10,44,10,4
3,337,1,1,7,20,-13,46,10,4
3,303,1,0,20,7,13,50,10,4
3,28,1,0,20,10,10,33,10,4
4,864,1,1,17,20,-3,50,10,4
4,756,1,1,17,20,-3,11,10,4
4,654,2,1,17,20,-3,36,11,4
4,547,1,0,23,17,6,40,10,4
4,464,3,0,23,17,6,31,1,4
4,342,1,0,23,20,3,39,10,4
4,308,2,0,23,20,3,49,0,4
4,227,1,1,20,23,-3,49,10,4
4,187,2,1,20,23,-3,45,6,4
4,146,2,1,20,23,-3,19,1,4
4,109,1,1,20,23,-3,30,10,4
4,102,2,1,20,23,-3,24,4,4
4,79,1,1,20,23,-3,12,10,4
4,33,3,1,20,23,-3,2,0,4
1,800,1,0,0,0,0,46,10,4
1,702,2,1,0,0,0,40,3,4
1,566,1,1,0,0,0,18,10,4
1,492,1,0,0,0,0,40,10,4
1,472,2,0,0,0,0,48,2,4
1,382,1,1,0,0,0,40,10,4
1,111,1,0,0,1,-1,35,10,4
1,58,3,0,0,1,-1,44,1,4
1,1,1,0,0,1,-1,51,10,4
2,900,2,1,1,0,1,53,4,4
2,855,1,1,1,1,0,35,10,4
2,757,2,0,1,1,0,52,2,4
2,565,1,0,1,4,-3,38,10,4
2,533,2,0,1,4,-3,45,3,4
2,468,2,0,1,4,-3,51,10,4
2,425,1,1,4,1,3,42,10,4
2,250,2,1,4,4,0,41,17,4
2,99,2,1,4,4,0,38,2,4
2,28,3,0,4,4,0,43,1,4
3,803,1,0,4,4,0,46,10,4
3,722,1,0,4,5,-1,35,10,4
3,660,1,0,4,5,-1,50,10,4
3,555,1,1,5,4,1,24,10,4
3,511,1,1,5,4,1,41,10,4
3,447,1,1,5,4,1,52,10,4
3,413,2,0,4,5,-1,52,4,4
3,362,1,0,4,5,-1,30,10,4
3,333,2,0,4,5,-1,38,2,4
3,136,1,0,4,5,-1,22,10,4
3,45,1,1,5,4,1,48,10,4
4,815,1,1,12,4,8,48,10,4
4,751,1,1,12,4,8,6,10,4
4,722,1,1,12,4,8,31,10,4
4,615,2,1,12,4,8,49,2,4
4,562,2,1,12,4,8,55,10,4
4,430,1,0,4,12,-8,34,10,4
4,363,3,0,4,12,-8,25,1,4
4,186,1,1,12,11,1,41,10,4
4,100,1,0,11,13,-2,45,10,4
4,69,2,0,11,13,-2,50,15,4
4,61,1,0,11,13,-2,33,10,4
4,39,2,0,11,13,-2,25,2,4
1,821,1,1,0,0,0,14,10,4
1,752,0,0,0,0,0,30,0,4
1,669,3,1,0,0,0,39,1,4
1,564,1,1,0,0,0,8,8,4
1,511,2,1,0,0,0,3,3,4
1,401,1,0,7,0,7,55,10,4
1,379,1,1,0,7,-7,38,10,4
1,200,1,1,0,10,-10,54,10,4
1,30,1,0,10,0,10,37,10,4
2,900,1,1,0,10,-10,48,10,4
2,826,1,0,10,0,10,36,10,4
2,763,1,0,10,0,10,24,10,4
2,660,1,0,10,3,7,35,10,4
2,360,3,0,10,6,4,39,1,4
2,197,1,0,10,6,4,32,10,4
2,165,1,1,6,10,-4,52,10,4
2,125,1,1,6,13,-7,35,10,4
3,894,1,1,9,13,-4,53,10,4
3,822,1,0,13,9,4,16,10,4
3,778,2,0,13,9,4,21,5,4
3,701,1,0,13,9,4,55,10,4
3,604,1,1,9,13,-4,15,10,4
3,508,2,1,9,13,-4,37,1,4
3,438,1,0,13,9,4,26,10,4
3,422,2,0,13,9,4,33,3,4
3,330,1,1,9,13,-4,51,10,4
3,34,1,0,13,10,3,38,10,4
4,862,1,0,13,17,-4,42,10,4
4,729,1,1,17,16,1,35,10,4
4,713,2,1,17,16,1,42,3,4
4,640,1,1,17,16,1,22,10,4
4,487,1,0,19,17,2,43,10,4
4,460,1,0,19,17,2,53,10,4
4,284,1,0,26,17,9,16,10,4
4,261,1,0,26,17,9,35,10,4
4,190,1,0,26,17,9,47,10,4
4,110,1,1,17,33,-16,5,10,4
4,68,1,1,17,33,-16,22,10,4
4,63,2,1,17,33,-16,19,7,4
4,56,1,1,17,33,-16,9,9,4
4,32,2,1,17,33,-16,5,5,4
1,895,1,1,0,0,0,31,10,4
1,658,1,0,0,0,0,43,10,4
1,543,1,0,0,0,0,45,10,4
1,462,1,0,0,1,-1,35,10,4
1,385,3,0,0,1,-1,44,1,4
1,150,1,1,1,0,1,50,10,4
2,900,1,0,0,1,-1,44,10,4
2,849,1,0,0,1,-1,41,10,4
2,823,2,0,0,1,-1,43,8,4
2,785,3,0,0,1,-1,50,1,4
2,714,2,1,1,0,1,51,3,4
2,630,0,0,0,1,-1,12,0,4
2,565,1,1,1,0,1,48,10,4
2,472,2,1,1,0,1,23,4,4
2,347,1,1,1,3,-2,36,10,4
2,307,2,1,1,3,-2,39,7,4
2,269,1,1,1,3,-2,40,10,4
2,216,2,1,1,3,-2,20,18,4
2,165,2,1,1,3,-2,34,1,4
2,158,1,1,1,3,-2,36,10,4
2,9,2,1,1,3,-2,12,10,4
3,816,1,0,6,8,-2,35,10,4
3,780,2,0,6,8,-2,36,9,4
3,512,1,0,6,8,-2,54,10,4
3,472,2,1,8,6,2,49,3,4
3,424,3,1,8,6,2,47,1,4
3,392,1,1,8,6,2,47,10,4
3,357,2,1,8,6,2,55,2,4
3,224,2,1,8,6,2,22,3,4
3,150,1,1,8,6,2,5,5,4
3,92,1,1,8,6,2,1,1,4
3,28,2,1,8,13,-5,43,1,4
4,900,1,0,13,8,5,42,10,4
4,735,1,1,11,13,-2,46,10,4
4,652,1,0,13,11,2,16,10,4
4,517,1,1,14,13,1,51,10,4
4,395,2,1,14,13,1,22,2,4
4,357,1,1,14,13,1,19,10,4
4,315,2,1,14,13,1,14,5,4
4,157,1,0,16,14,2,38,10,4
4,128,1,0,16,14,2,26,10,4
4,104,1,0,16,21,-5,8,8,4
4,99,2,0,16,21,-5,14,14,4
1,654,1,0,0,0,0,55,10,4
1,539,1,1,0,0,0,26,10,4
1,473,1,1,0,0,0,40,10,4
1,394,1,1,0,0,0,41,10,4
1,323,1,1,0,0,0,31,10,4
1,251,1,1,0,0,0,19,10,4
1,90,1,1,0,7,-7,49,5,4
1,75,1,0,7,7,0,25,10,4
2,822,2,0,7,7,0,18,10,4
2,780,1,0,7,7,0,33,10,4
2,555,1,0,7,14,-7,52,10,4
2,545,2,0,7,14,-7,43,1,4
2,464,1,0,7,17,-10,35,10,4
2,318,2,0,7,24,-17,26,12,4
2,269,1,1,24,7,17,24,10,4
2,136,1,0,7,24,-17,54,10,4
2,119,2,0,7,24,-17,34,10,4
2,98,2,0,7,24,-17,28,4,4
2,63,1,0,7,24,-17,5,5,4
2,43,0,0,7,31,-24,52,0,4
2,18,1,1,31,7,24,31,10,4
3,894,1,1,31,10,21,26,10,4
3,852,1,1,31,10,21,37,10,4
3,574,1,0,13,31,-18,52,10,4
3,437,1,1,31,16,15,35,10,4
3,362,1,0,16,31,-15,53,10,4
3,324,2,1,31,16,15,49,2,4
3,252,1,1,31,16,15,15,10,4
3,184,1,1,31,23,8,26,10,4
3,62,2,1,31,23,8,50,3,4
4,860,2,0,23,31,-8,40,1,4
4,842,3,0,23,31,-8,41,0,4
4,813,1,0,23,31,-8,43,10,4
4,773,2,0,23,31,-8,48,5,4
4,641,1,0,24,31,-7,30,10,4
4,624,1,0,24,31,-7,20,10,4
4,342,1,1,34,24,10,38,10,4
4,182,1,0,24,34,-10,24,10,4
4,104,1,1,34,27,7,35,10,4
4,77,1,0,27,34,-7,50,10,4
1,890,1,0,0,0,0,26,10,4
1,783,1,0,0,7,-7,29,10,4
1,485,1,1,7,0,7,52,10,4
1,429,1,1,7,0,7,39,10,4
1,395,2,1,7,0,7,31,2,4
1,329,1,1,7,0,7,37,20,4
1,304,2,1,7,0,7,27,10,4
1,273,1,1,7,0,7,15,10,4
1,185,3,1,7,0,7,7,2,4
1,19,1,1,7,7,0,40,10,4
2,798,1,1,7,8,-1,35,10,4
2,723,1,0,8,7,1,9,10,4
2,632,1,0,8,7,1,31,10,4
2,531,1,1,7,8,-1,31,10,4
2,451,1,1,7,8,-1,55,10,4
2,412,2,0,8,7,1,50,5,4
2,371,1,0,8,7,1,40,10,4
2,205,1,0,8,7,1,19,10,4
2,131,0,0,8,7,1,53,0,4
2,80,2,0,8,7,1,34,1,4
2,38,1,1,7,8,-1,25,10,4
2,33,2,1,7,8,-1,28,7,4
3,894,1,1,7,8,-1,31,10,4
3,872,1,1,7,8,-1,46,10,4
3,802,1,0,8,7,1,52,10,4
3,708,1,0,8,7,1,20,10,4
3,687,2,0,8,7,1,28,2,4
3,608,1,1,7,8,-1,19,10,4
3,311,1,1,7,8,-1,45,10,4
3,297,1,1,7,8,-1,26,10,4
3,131,1,0,11,7,4,32,10,4
3,42,1,1,7,11,-4,37,10,4
4,900,1,1,7,11,-4,55,10,4
4,800,1,1,7,11,-4,45,10,4
4,764,2,1,7,11,-4,42,7,4
4,616,2,1,7,11,-4,13,1,4
4,522,1,1,7,11,-4,34,10,4
4,484,2,1,7,11,-4,25,1,4
4,385,1,1,7,11,-4,20,10,4
4,130,1,1,7,25,-18,15,10,4
4,111,3,1,7,32,-25,45,0,4
1,855,1,0,0,0,0,39,10,4
1,747,1,0,0,3,-3,34,10,4
1,588,2,0,0,10,-10,46,1,4
1,516,2,0,0,10,-10,55,5,4
1,320,1,1,10,0,10,52,10,4
1,254,1,0,0,10,-10,43,10,4
1,106,1,1,10,0,10,54,10,4
1,71,2,1,10,0,10,45,1,4
1,38,1,1,10,0,10,40,10,4
2,794,1,0,3,10,-7,44,10,4
2,741,1,1,10,3,7,51,10,4
2,665,1,1,10,3,7,12,10,4
2,630,1,1,10,3,7,24,10,4
2,522,1,1,10,3,7,48,10,4
2,335,1,0,3,13,-10,35,10,4
2,250,1,1,13,3,10,23,10,4
2,189,1,1,13,3,10,8,8,4
2,144,1,1,13,6,7,45,10,4
2,102,1,0,6,13,-7,13,10,4
2,96,2,0,6,13,-7,16,7,4
3,736,1,0,9,16,-7,35,10,4
3,705,2,0,9,16,-7,42,3,4
3,627,1,1,16,9,7,39,10,4
3,556,1,1,16,12,4,35,10,4
3,410,1,1,16,12,4,34,10,4
3,305,1,0,12,16,-4,20,10,4
3,235,1,0,12,16,-4,36,10,4
3,147,3,0,12,16,-4,45,1,4
3,108,1,1,16,12,4,53,10,4
3,70,2,1,16,12,4,45,2,4
4,746,2,0,19,16,3,53,4,4
4,680,1,1,16,19,-3,16,10,4
4,654,2,1,16,19,-3,22,4,4
4,523,1,1,16,19,-3,31,10,4
4,362,1,0,19,16,3,48,10,4
4,280,1,0,19,16,3,16,10,4
4,217,1,0,19,16,3,49,10,4
4,180,1,1,16,19,-3,51,10,4
4,96,1,0,20,16,4,27,10,4
4,91,2,0,20,16,4,31,6,4
4,66,1,0,20,16,4,42,10,4
4,44,2,0,20,16,4,50,2,4
1,893,1,0,0,0,0,39,10,4
1,854,2,0,0,0,0,49,0,4
1,697,1,1,0,3,-3,33,10,4
1,620,1,1,0,3,-3,50,10,4
1,529,2,0,3,0,3,25,10,4
1,475,1,1,0,3,-3,35,10,4
1,442,2,1,0,3,-3,41,4,4
1,324,2,0,3,0,3,28,2,4
1,286,1,0,3,0,3,6,6,4
1,164,1,0,3,0,3,1,1,4
1,89,1,0,3,7,-4,30,10,4
1,6,1,1,7,3,4,46,10,4
2,900,2,1,7,3,4,52,4,4
2,644,1,1,8,3,5,50,10,4
2,561,1,0,3,8,-5,41,10,4
2,516,2,0,3,8,-5,32,1,4
2,451,1,0,3,8,-5,8,10,4
2,360,1,0,3,8,-5,19,10,4
2,167,1,1,8,3,5,46,10,4
2,127,1,0,3,8,-5,25,10,4
2,116,1,0,3,8,-5,7,7,4
2,44,1,0,3,8,-5,37,10,4
3,885,1,1,8,3,5,20,10,4
3,790,2,1,8,3,5,50,10,4
3,723,1,0,3,9,-6,35,10,4
3,656,1,1,9,3,6,30,10,4
3,506,1,0,3,9,-6,32,10,4
3,413,1,1,9,3,6,32,10,4
3,379,2,1,9,3,6,38,4,4
3,345,1,1,9,3,6,43,10,4
3,120,1,0,3,12,-9,49,10,4
4,900,1,1,13,3,10,43,10,4
4,634,1,1,13,3,10,52,10,4
4,452,1,1,13,3,10,44,10,4
4,246,2,1,20,10,10,53,1,4
4,152,1,1,20,10,10,27,10,4
4,148,2,1,20,10,10,32,5,4
4,124,2,0,10,20,-10,45,1,4
4,95,1,1,20,10,10,38,10,4
4,90,2,1,20,10,10,30,2,4
4,84,3,1,20,10,10,29,1,4
4,79,1,1,20,10,10,14,25,4
4,74,2,1,20,10,10,15,24,4
1,759,1,1,0,0,0,46,10,4
1,708,1,1,0,0,0,27,10,4
1,565,1,1,0,0,0,31,10,4
1,473,1,1,0,0,0,6,10,4
1,420,1,1,0,7,-7,41,10,4
1,248,1,1,0,7,-7,18,10,4
1,135,2,1,0,7,-7,37,3,4
1,1,1,0,7,0,7,45,10,4
2,632,1,1,2,7,-5,45,10,4
2,546,1,0,7,2,5,3,10,4
2,391,1,0,7,4,3,5,5,4
2,372,1,0,7,11,-4,15,10,4
2,300,1,0,7,11,-4,25,10,4
2,152,3,0,7,11,-4,43,0,4
2,148,1,0,7,11,-4,41,10,4
2,33,2,0,7,14,-7,38,17,4
3,868,1,0,7,14,-7,50,10,4
3,772,2,0,7,14,-7,34,1,4
3,722,1,0,7,14,-7,15,10,4
3,637,3,0,7,14,-7,6,1,4
3,590,1,0,7,14,-7,5,5,4
3,515,2,0,7,14,-7,3,3,4
3,495,1,0,7,21,-14,51,10,4
3,278,2,1,21,7,14,11,8,4
3,152,1,1,21,21,0,35,10,4
3,53,1,0,21,21,0,41,10,4
3,1,2,0,21,21,0,49,2,4
4,900,3,0,21,21,0,50,1,4
4,870,1,0,21,21,0,52,10,4
4,789,1,1,21,21,0,22,10,4
4,686,1,1,21,24,-3,35,10,4
4,664,2,1,21,24,-3,42,3,4
4,536,1,1,21,24,-3,44,10,4
4,461,1,1,21,27,-6,40,10,4
4,435,2,1,21,27,-6,48,2,4
4,314,1,0,27,28,-1,27,10,4
4,259,1,1,28,27,1,43,10,4
4,230,2,1,28,27,1,38,5,4
4,164,2,1,28,30,-2,35,10,4
4,155,3,1,28,30,-2,45,0,4
4,129,1,0,30,28,2,51,10,4
4,107,2,0,30,28,2,42,1,4
4,103,1,0,30,28,2,39,10,4
4,73,1,0,30,28,2,23,10,4
4,28,2,0,30,28,2,15,2,4
1,890,1,0,0,0,0,26,10,4
1,808,1,0,0,3,-3,30,10,4
1,677,2,1,3,1,2,45,0,4
1,639,1,1,3,1,2,46,10,4
1,535,1,0,1,3,-2,11,10,4
1,381,1,1,10,1,9,2,10,4
1,345,2,1,10,1,9,8,4,4
1,24,1,1,10,3,7,1,10,4
1,10,2,1,10,3,7,3,8,4
2,900,1,1,10,3,7,11,10,4
2,843,1,1,10,3,7,29,10,4
2,748,1,0,3,10,-7,48,10,4
2,624,2,1,10,3,7,47,1,4
2,485,1,0,3,10,-7,15,10,4
2,270,2,0,3,10,-7,18,1,4
2,58,1,1,13,3,10,36,10,4
2,17,1,1,13,10,3,34,10,4
3,896,1,0,10,13,-3,33,10,4
3,811,1,1,13,10,3,4,10,4
3,701,3,0,12,13,-1,42,1,4
3,439,1,1,13,12,1,52,10,4
3,361,1,0,12,13,-1,35,10,4
3,232,2,0,12,13,-1,54,2,4
3,44,1,1,13,12,1,30,10,4
4,781,2,0,12,13,-1,47,1,4
4,634,1,0,12,13,-1,11,10,4
4,247,2,0,12,13,-1,47,3,4
4,140,0,1,13,12,1,20,0,4
4,84,1,0,12,13,-1,45,10,4
4,80,2,0,12,13,-1,39,4,4
4,76,1,0,12,13,-1,35,10,4
4,20,2,0,12,13,-1,35,3,4
1,807,1,0,0,0,0,40,10,4
1,755,2,0,0,0,0,35,5,4
1,731,1,0,0,0,0,27,10,4
1,617,1,0,0,0,0,1,1,4
1,525,1,1,8,0,8,53,10,4
1,491,2,0,0,8,-8,52,5,4
1,324,1,0,7,8,-1,8,10,4
1,114,1,0,7,8,-1,43,10,4
2,865,3,0,7,8,-1,18,0,4
2,828,1,0,7,8,-1,21,10,4
2,811,1,0,7,8,-1,48,10,4
2,742,1,1,8,7,1,19,10,4
2,708,1,1,8,7,1,33,10,4
2,667,1,1,8,7,1,47,10,4
2,443,1,1,15,7,8,28,10,4
2,293,1,1,15,7,8,31,10,4
2,134,2,0,10,15,-5,43,3,4
2,93,2,0,10,15,-5,46,11,4
2,61,1,1,15,10,5,5,10,4
2,50,1,1,15,10,5,26,10,4
2,28,2,1,15,10,5,32,15,4
2,12,3,1,15,10,5,41,6,4
3,758,2,0,10,15,-5,42,0,4
3,628,1,0,10,18,-8,35,10,4
3,600,2,0,10,18,-8,40,5,4
3,464,1,0,10,18,-8,38,10,4
3,430,2,0,10,18,-8,44,4,4
3,403,1,0,10,18,-8,50,10,4
3,317,1,1,18,10,8,17,10,4
3,292,2,1,18,10,8,23,4,4
3,255,1,1,18,10,8,32,10,4
3,170,1,1,18,10,8,52,10,4
3,62,1,0,10,18,-8,53,10,4
4,795,1,0,10,18,-8,48,10,4
4,707,1,0,10,18,-8,33,10,4
4,620,1,0,10,18,-8,16,10,4
4,550,1,0,10,18,-8,3,3,4
4,403,3,1,25,10,15,34,1,4
4,370,1,1,25,10,15,30,10,4
4,277,1,1,25,13,12,35,10,4
4,221,1,0,13,25,-12,31,10,4
4,121,2,0,13,28,-15,54,2,4
4,56,1,1,28,13,15,28,10,4
4,39,2,1,28,13,15,36,2,4
1,893,1,1,0,0,0,40,10,4
1,780,1,0,0,0,0,46,10,4
1,661,1,1,0,0,0,31,10,4
1,604,1,0,0,0,0,51,10,4
1,522,1,1,0,0,0,49,10,4
1,482,2,1,0,0,0,44,5,4
1,10,1,0,3,0,3,40,10,4
2,846,1,1,0,3,-3,32,10,4
2,755,1,0,3,0,3,34,10,4
2,431,2,1,7,3,4,52,2,4
2,419,3,1,7,3,4,50,0,4
2,315,1,1,7,10,-3,36,10,4
2,243,1,0,10,7,3,51,10,4
2,203,2,1,7,10,-3,52,3,4
2,150,1,1,7,10,-3,1,1,4
3,896,1,0,17,10,7,28,10,4
3,873,1,0,17,10,7,38,10,4
3,791,1,0,17,10,7,55,10,4
3,715,1,1,10,17,-7,17,10,4
3,568,1,0,24,10,14,20,10,4
3,485,1,0,24,10,14,32,10,4
3,457,1,0,24,10,14,47,10,4
3,295,1,1,10,24,-14,20,10,4
3,269,1,1,10,31,-21,30,10,4
3,231,1,1,10,31,-21,45,10,4
3,199,2,1,10,31,-21,49,6,4
3,116,1,0,31,10,21,14,10,4
4,900,1,0,31,10,21,18,10,4
4,859,2,0,31,10,21,10,2,4
4,807,1,0,31,13,18,35,10,4
4,775,2,0,31,13,18,43,2,4
4,562,1,1,13,31,-18,2,10,4
4,484,2,1,13,31,-18,33,10,4
4,154,1,0,34,20,14,2,2,4
4,139,1,1,27,34,-7,36,10,4
4,93,1,1,27,34,-7,10,10,4
4,70,2,1,27,41,-14,55,5,4
1,895,1,0,0,0,0,42,10,4
1,856,2,0,0,0,0,44,8,4
1,680,1,1,7,0,7,18,10,4
1,605,1,0,0,7,-7,49,10,4
1,540,1,1,7,0,7,48,10,4
1,344,2,1,7,10,-3,22,15,4
1,308,1,0,10,7,3,55,10,4
1,158,2,1,7,10,-3,16,0,4
1,30,1,1,7,10,-3,3,3,4
2,838,1,1,7,17,-10,47,10,4
2,763,1,0,17,7,10,52,10,4
2,658,1,0,17,7,10,7,10,4
2,585,1,0,17,7,10,47,10,4
2,511,1,1,7,17,-10,25,10,4
2,450,3,1,7,17,-10,34,1,4
2,183,1,1,7,17,-10,21,10,4
3,861,2,1,7,21,-14,42,5,4
3,718,1,0,21,10,11,49,10,4
3,698,2,1,10,21,-11,54,3,4
3,662,3,1,10,21,-11,51,0,4
3,614,1,1,10,21,-11,35,10,4
3,586,2,1,10,21,-11,28,3,4
3,322,1,0,24,10,14,1,1,4
3,265,2,0,24,10,14,1,1,4
3,134,1,1,17,24,-7,44,10,4
4,894,1,0,24,24,0,25,10,4
4,861,2,0,24,24,0,31,4,4
4,775,2,0,24,31,-7,35,10,4
4,610,1,1,31,24,7,17,10,4
4,581,2,1,31,24,7,24,3,4
4,496,2,1,31,24,7,42,4,4
4,427,1,0,24,31,-7,30,10,4
4,339,3,0,24,31,-7,39,1,4
4,316,1,0,24,31,-7,40,10,4
4,175,1,0,24,31,-7,1,1,4
4,73,1,1,38,24,14,33,10,4
1,603,3,1,0,0,0,49,0,4
1,570,1,1,0,0,0,50,10,4
1,505,1,0,0,0,0,7,10,4
1,428,1,1,2,0,2,49,10,4
1,390,2,1,2,0,2,43,16,4
1,326,1,0,0,2,-2,37,10,4
1,289,2,0,0,2,-2,37,10,4
1,223,1,1,2,0,2,43,10,4
1,180,2,1,2,0,2,52,1,4
1,141,1,1,2,0,2,54,10,4
1,90,1,0,0,2,-2,41,10,4
1,44,2,0,0,2,-2,39,8,4
2,853,1,0,0,5,-5,55,10,4
2,813,2,1,5,0,5,49,4,4
2,770,1,1,5,0,5,50,20,4
2,659,1,1,5,3,2,31,10,4
2,605,2,0,3,5,-2,54,2,4
2,545,1,0,3,5,-2,42,5,4
2,327,1,0,3,6,-3,35,10,4
2,308,2,0,3,6,-3,42,3,4
2,159,1,0,3,6,-3,53,10,4
2,60,2,1,6,3,3,11,4,4
3,722,1,0,6,9,-3,35,10,4
3,695,2,0,6,9,-3,42,3,4
3,647,1,1,9,6,3,22,10,4
3,613,2,1,9,6,3,28,4,4
3,425,2,1,9,6,3,41,3,4
3,388,1,1,9,6,3,35,10,4
3,270,2,1,9,9,0,42,3,4
3,213,1,1,9,9,0,50,10,4
3,140,1,0,9,9,0,42,10,4
4,743,3,0,16,12,4,1,1,4
4,637,1,0,16,19,-3,38,10,4
4,560,2,0,16,19,-3,17,1,4
4,432,2,0,16,19,-3,20,15,4
4,273,1,1,26,16,10,52,10,4
4,187,1,0,16,26,-10,40,10,4
4,132,1,0,16,26,-10,28,10,4
4,122,1,0,16,26,-10,11,10,4
4,97,2,0,16,26,-10,7,6,4
4,88,1,0,16,33,-17,41,10,4
1,862,2,0,0,0,0,20,1,4
1,809,2,0,0,3,-3,43,2,4
1,700,2,1,3,0,3,18,2,4
1,448,2,1,3,7,-4,25,0,4
1,338,1,1,3,15,-12,35,10,4
1,278,1,1,3,15,-12,54,10,4
1,148,3,0,15,3,12,35,1,4
1,92,1,0,15,3,12,18,10,4
2,756,1,1,3,15,-12,18,10,4
2,637,2,1,3,15,-12,11,2,4
2,529,1,1,3,22,-19,28,10,4
2,492,2,1,3,22,-19,38,0,4
2,360,2,1,3,22,-19,33,5,4
2,164,1,0,29,3,26,27,10,4
2,80,2,0,29,3,26,47,6,4
3,893,1,1,10,29,-19,7,10,4
3,681,2,1,10,29,-19,36,10,4
3,585,2,1,10,32,-22,20,10,4
3,530,1,1,10,32,-22,31,10,4
3,371,2,0,32,18,14,21,1,4
3,254,2,0,32,25,7,17,12,4
3,212,2,0,32,25,7,37,2,4
3,58,1,0,32,25,7,29,10,4
4,830,2,1,25,32,-7,50,1,4
4,645,1,0,33,25,8,31,10,4
4,560,1,0,33,25,8,45,10,4
4,440,1,0,33,25,8,37,10,4
4,385,1,0,33,25,8,25,10,4
4,159,1,0,33,33,0,26,10,4
4,48,3,1,40,33,7,47,1,4
1,728,1,1,0,0,0,11,10,4
1,688,2,1,0,0,0,20,1,4
1,606,2,1,0,0,0,32,1,4
1,431,1,1,0,0,0,47,10,4
1,358,3,1,0,0,0,38,1,4
1,317,1,1,0,0,0,37,10,4
1,231,2,1,0,0,0,21,6,4
1,85,1,0,3,0,3,37,10,4
2,831,1,0,3,3,0,47,10,4
2,665,1,0,3,6,-3,20,10,4
2,619,2,0,3,6,-3,19,11,4
2,445,1,1,6,3,3,32,10,4
2,371,1,1,6,3,3,52,10,4
2,250,1,0,3,6,-3,20,10,4
2,75,1,0,3,8,-5,5,5,4
3,687,1,1,15,3,12,38,10,4
3,598,1,1,15,3,12,35,10,4
3,497,1,1,15,6,9,46,10,4
3,399,1,0,6,15,-9,38,10,4
3,257,1,0,6,16,-10,52,10,4
4,874,1,1,16,6,10,7,10,4
4,803,1,1,16,6,10,45,10,4
4,727,1,1,16,9,7,35,10,4
4,660,1,1,16,9,7,47,10,4
4,625,1,0,9,16,-7,53,10,4
4,588,1,0,9,16,-7,38,10,4
4,547,2,0,9,16,-7,32,4,4
4,411,1,1,19,9,10,43,10,4
4,257,1,0,9,19,-10,37,10,4
4,137,1,1,26,9,17,30,10,4
4,130,1,1,26,9,17,42,10,4
4,107,2,1,26,9,17,48,4,4
4,82,1,1,26,9,17,54,10,4
4,75,2,0,9,26,-17,53,7,4
4,46,1,0,9,26,-17,35,10,4
4,42,2,0,9,26,-17,31,6,4
1,772,1,0,0,0,0,49,10,4
1,735,2,0,0,0,0,43,4,4
1,682,1,0,0,3,-3,35,10,4
1,558,1,0,0,3,-3,50,10,4
1,469,1,0,0,6,-6,35,10,4
1,395,2,1,6,0,6,52,0,4
1,362,3,1,6,0,6,52,0,4
1,310,1,1,6,0,6,39,10,4
1,103,1,0,0,6,-6,35,10,4
2,900,1,0,0,6,-6,33,10,4
2,890,1,0,0,6,-6,16,10,4
2,709,1,1,13,0,13,26,10,4
2,619,1,0,0,13,-13,46,10,4
2,587,2,0,0,13,-13,53,3,4
2,441,2,1,13,0,13,48,0,4
2,391,1,1,13,0,13,35,10,4
2,367,2,1,13,0,13,29,4,4
2,251,1,1,13,0,13,3,3,4
2,102,1,1,13,3,10,48,10,4
2,34,2,0,3,13,-10,23,4,4
3,893,1,0,3,13,-10,22,10,4
3,774,2,0,3,13,-10,45,2,4
3,756,3,0,3,13,-10,44,1,4
3,436,1,0,3,20,-17,26,10,4
3,311,1,1,20,3,17,27,10,4
3,250,1,0,3,20,-17,54,10,4
3,127,1,0,3,20,-17,12,10,4
3,74,1,0,3,20,-17,15,20,4
4,831,1,0,3,20,-17,45,10,4
4,583,1,0,3,20,-17,26,10,4
4,430,2,1,20,3,17,45,1,4
4,400,1,1,20,3,17,47,10,4
4,379,2,1,20,3,17,45,12,4
4,146,1,0,3,27,-24,43,10,4
4,142,2,0,3,27,-24,38,5,4
4,90,1,0,3,28,-25,20,10,4
4,84,2,0,3,28,-25,28,2,4
1,872,1,0,0,0,0,41,10,4
1,838,2,0,0,0,0,36,5,4
1,753,2,0,0,0,0,15,1,4
1,709,2,0,0,0,0,45,1,4
1,679,1,0,0,0,0,47,10,4
1,361,1,1,0,4,-4,35,10,4
1,176,1,1,0,4,-4,18,10,4
1,156,1,1,0,4,-4,32,10,4
1,11,1,1,0,4,-4,51,10,4
2,831,1,1,0,11,-11,42,10,4
2,504,1,0,18,1,17,43,10,4
2,302,1,0,18,8,10,38,10,4
2,172,1,1,8,18,-10,37,10,4
2,123,2,0,18,8,10,34,1,4
2,80,2,0,18,9,9,44,1,4
2,36,2,1,9,18,-9,42,10,4
3,782,1,1,9,21,-12,30,10,4
3,573,1,1,9,21,-12,29,10,4
3,368,1,1,9,28,-19,10,10,4
3,324,1,1,9,28,-19,38,10,4
3,124,1,0,28,9,19,45,10,4
4,705,1,0,30,9,21,27,10,4
4,454,1,0,30,16,14,34,10,4
4,372,1,1,16,30,-14,45,10,4
4,184,2,0,33,16,17,45,1,4
4,131,1,0,33,16,17,1,1,4
4,109,2,0,33,16,17,1,1,4
4,109,1,1,23,33,-10,44,10,4
4,104,1,1,23,33,-10,31,10,4
4,53,2,1,23,33,-10,26,5,4
1,873,2,1,0,0,0,16,9,4
1,821,1,1,0,0,0,27,10,4
1,762,1,0,0,0,0,43,10,4
1,649,3,1,0,0,0,43,0,4
1,614,1,1,0,0,0,41,10,4
1,259,2,0,0,0,0,54,2,4
2,638,2,0,1,3,-2,40,10,4
2,124,2,1,3,15,-12,41,9,4
3,842,1,0,15,3,12,25,5,4
3,810,2,0,15,3,12,22,2,4
3,779,3,0,15,3,12,20,0,4
3,499,2,1,6,15,-9,20,18,4
3,457,1,0,15,6,9,25,10,4
3,374,2,0,15,6,9,52,1,4
3,236,2,0,15,7,8,35,10,4
4,710,1,0,15,10,5,1,1,4
4,656,2,0,15,17,-2,44,1,4
4,609,3,0,15,17,-2,44,2,4
4,565,1,0,15,17,-2,47,10,4
4,446,0,0,15,17,-2,13,0,4
4,234,2,0,16,17,-1,50,3,4
4,134,1,0,16,24,-8,42,10,4
4,131,2,0,16,24,-8,38,6,4
1,786,1,1,0,0,0,14,10,4
1,716,1,1,0,0,0,50,10,4
1,683,2,1,0,0,0,41,1,4
1,450,1,1,0,0,0,19,10,4
1,397,1,1,0,0,0,30,10,4
1,326,1,0,0,0,0,43,10,4
1,290,2,0,0,0,0,52,1,4
1,176,2,1,0,0,0,40,2,4
1,140,1,1,0,0,0,44,10,4
1,65,1,0,0,0,0,53,10,4
2,880,1,0,0,0,0,3,3,4
2,834,2,0,0,0,0,1,1,4
2,817,1,0,0,7,-7,38,10,4
2,778,2,0,0,7,-7,46,2,4
2,724,1,1,7,0,7,37,10,4
2,643,1,1,7,0,7,50,20,4
2,458,2,1,8,1,7,43,2,4
2,423,3,1,8,1,7,44,1,4
2,325,1,0,1,8,-7,21,10,4
2,190,1,0,1,15,-14,55,10,4
2,180,2,1,15,1,14,50,5,4
2,166,1,1,15,1,14,35,10,4
2,141,1,1,15,1,14,24,10,4
2,121,2,1,15,1,14,15,1,4
2,80,2,1,15,1,14,3,0,4
2,60,1,1,15,1,14,3,3,4
2,22,2,1,15,1,14,1,1,4
3,781,1,1,15,8,7,49,10,4
3,703,1,1,15,8,7,6,6,4
3,682,1,1,15,15,0,28,10,4
3,644,1,1,15,15,0,45,10,4
3,584,1,0,15,15,0,54,10,4
3,550,2,0,15,15,0,48,4,4
3,492,1,0,15,15,0,15,10,4
3,360,1,0,15,15,0,54,10,4
3,330,2,0,15,15,0,47,3,4
3,311,3,0,15,15,0,45,1,4
3,190,2,0,15,15,0,27,7,4
3,145,1,0,15,15,0,19,10,4
3,24,1,0,15,18,-3,21,10,4
4,879,1,0,15,18,-3,45,10,4
4,752,2,0,15,18,-3,12,1,4
4,607,1,0,15,25,-10,44,10,4
4,409,1,1,28,15,13,44,10,4
4,381,2,1,28,15,13,50,4,4
4,245,1,0,15,28,-13,43,10,4
4,184,1,0,15,28,-13,25,10,4
4,135,1,0,15,31,-16,46,10,4
4,122,2,0,15,31,-16,44,8,4
4,90,2,0,15,31,-16,8,10,4
4,45,1,1,31,15,16,33,10,4
1,894,1,0,0,0,0,25,10,4
1,821,1,0,0,0,0,39,10,4
1,759,1,0,0,0,0,55,10,4
1,719,1,1,0,0,0,30,10,4
1,614,1,1,0,0,0,9,10,4
1,588,2,1,0,0,0,13,6,4
1,488,1,1,0,0,0,8,8,4
1,473,1,1,0,7,-7,24,10,4
1,431,1,1,0,7,-7,34,10,4
1,351,1,1,0,7,-7,50,10,4
1,323,2,0,7,0,7,53,3,4
1,285,1,0,7,0,7,50,10,4
1,250,1,0,7,0,7,35,10,4
1,102,1,1,3,7,-4,28,10,4
2,883,1,1,3,8,-5,35,10,4
2,853,2,1,3,8,-5,39,6,4
2,551,3,1,3,8,-5,20,1,4
2,477,2,1,3,8,-5,9,1,4
2,280,1,0,15,3,12,27,10,4
2,2,2,1,10,22,-12,41,10,4
3,623,1,1,17,22,-5,41,10,4
3,558,1,1,17,22,-5,30,10,4
3,537,2,1,17,22,-5,24,4,4
3,442,1,1,17,29,-12,39,10,4
3,78,1,0,29,17,12,26,10,4
4,900,1,1,17,29,-12,49,10,4
4,817,1,0,29,24,5,34,10,4
4,665,1,1,24,29,-5,30,10,4
4,564,3,1,24,29,-5,52,1,4
4,530,1,1,24,29,-5,53,10,4
4,491,2,1,24,29,-5,50,13,4
4,247,1,0,29,24,5,53,10,4
4,220,2,1,24,29,-5,50,3,4
4,186,1,1,24,29,-5,21,10,4
4,158,2,1,24,29,-5,20,9,4
4,49,1,0,32,24,8,1,10,4
4,39,2,0,32,32,0,38,10,4
5,0,1,0,32,32,0,35,10,4
5,0,2,0,32,32,0,35,10,4
5,0,1,0,32,32,0,19,10,4
1,822,1,0,0,0,0,28,10,4
1,755,3,0,0,0,0,37,1,4
1,716,1,0,0,0,0,36,10,4
1,556,2,1,7,0,7,22,11,4
1,407,2,0,0,7,-7,49,2,4
1,372,1,0,0,7,-7,47,10,4
1,270,2,0,0,7,-7,35,10,4
1,158,1,0,0,10,-10,29,10,4
1,45,2,1,10,0,10,53,3,4
1,28,3,1,10,0,10,55,1,4
2,853,1,0,0,10,-10,6,10,4
2,780,1,1,12,0,12,47,10,4
2,757,1,0,0,12,-12,44,10,4
2,700,2,0,0,12,-12,50,16,4
2,590,2,0,0,13,-13,48,1,4
2,556,1,1,13,0,13,14,10,4
2,431,1,0,0,13,-13,40,10,4
2,403,1,0,0,13,-13,50,10,4
2,297,1,1,13,0,13,4,10,4
2,260,1,0,0,13,-13,46,10,4
2,141,1,0,0,14,-14,43,10,4
2,114,2,0,0,14,-14,51,2,4
3,895,1,0,0,14,-14,34,10,4
3,814,1,1,14,0,14,43,10,4
3,775,2,1,14,0,14,52,1,4
3,660,2,0,0,14,-14,40,5,4
3,485,1,1,17,0,17,33,10,4
3,398,1,1,17,0,17,52,10,4
3,323,1,1,17,0,17,23,10,4
3,290,2,1,17,0,17,32,1,4
3,90,2,0,0,17,-17,49,3,4
3,35,1,1,17,0,17,15,10,4
4,784,1,1,17,0,17,16,10,4
4,687,1,1,17,0,17,38,10,4
4,605,1,0,0,17,-17,22,10,4
4,520,2,0,0,17,-17,49,0,4
4,254,1,1,17,0,17,5,10,4
4,220,2,1,17,0,17,10,5,4
4,181,1,1,17,0,17,17,10,4
4,157,2,1,17,0,17,19,8,4
4,136,1,1,17,0,17,39,10,4
4,42,2,0,0,24,-24,27,19,4
4,22,3,0,0,24,-24,45,1,4
1,750,1,1,0,0,0,37,10,4
1,660,1,1,0,3,-3,15,10,4
1,380,1,0,3,0,3,24,10,4
1,319,1,1,0,3,-3,37,10,4
1,242,1,1,0,3,-3,49,10,4
2,658,1,1,2,3,-1,31,10,4
2,607,2,1,2,3,-1,22,1,4
2,528,1,1,2,10,-8,50,10,4
2,489,2,0,10,2,8,52,2,4
2,447,1,0,10,2,8,47,10,4
2,369,1,0,10,2,8,18,10,4
2,330,2,0,10,2,8,16,8,4
2,109,2,0,10,5,5,48,0,4
3,761,1,1,5,13,-8,35,10,4
3,597,2,0,13,5,8,55,19,4
3,420,1,0,13,5,8,41,10,4
3,350,1,1,5,13,-8,21,10,4
3,245,2,1,5,13,-8,40,3,4
3,144,2,1,5,13,-8,22,2,4
4,754,1,1,5,13,-8,52,10,4
4,566,1,0,16,5,11,10,10,4
4,180,1,0,16,11,5,47,10,4
4,85,2,0,16,11,5,34,3,4
4,43,2,0,16,11,5,12,7,4
1,821,1,0,0,7,-7,31,10,4
1,539,1,1,7,7,0,27,10,4
1,462,1,0,7,7,0,18,10,4
1,375,1,0,7,7,0,30,10,4
1,304,1,1,7,7,0,27,10,4
1,242,1,1,7,7,0,46,10,4
1,174,1,1,7,7,0,25,10,4
1,97,1,1,7,7,0,7,7,4
1,1,1,1,7,10,-3,35,10,4
2,825,1,0,10,7,3,3,10,4
2,560,2,0,10,7,3,53,4,4
2,535,1,1,14,10,4,43,10,4
2,494,2,1,14,10,4,37,4,4
2,378,1,1,14,10,4,1,1,4
2,357,1,1,14,17,-3,31,10,4
2,270,1,1,14,17,-3,44,10,4
2,235,2,1,14,17,-3,54,0,4
2,205,1,0,17,14,3,52,10,4
2,159,1,0,17,14,3,36,10,4
2,153,2,0,17,14,3,31,5,4
2,80,2,1,21,17,4,47,0,4
2,30,2,0,17,21,-4,43,1,4
2,3,2,0,17,21,-4,1,1,4
3,843,1,1,28,17,11,42,10,4
3,698,2,0,17,28,-11,18,2,4
3,396,1,1,31,20,11,35,10,4
3,296,1,0,20,31,-11,46,10,4
3,143,1,0,20,39,-19,35,10,4
4,859,2,0,20,39,-19,24,2,4
4,729,3,0,20,42,-22,44,1,4
4,662,2,0,20,42,-22,53,2,4
4,599,1,1,42,20,22,20,10,4
4,382,2,0,20,42,-22,48,1,4
4,360,1,1,42,20,22,53,10,4
4,337,2,1,42,20,22,43,0,4
4,248,1,0,20,42,-22,40,10,4
4,213,2,0,20,42,-22,33,3,4
4,111,1,1,42,20,22,46,10,4
4,93,2,1,42,20,22,53,3,4
4,81,1,0,20,42,-22,53,10,4
4,60,2,0,20,42,-22,46,3,4
1,894,1,0,0,0,0,35,10,4
1,799,1,1,0,0,0,16,10,4
1,780,2,1,0,0,0,22,4,4
1,745,1,1,0,0,0,29,10,4
1,616,1,1,0,0,0,53,10,4
1,585,1,1,0,0,0,42,10,4
1,319,1,1,0,2,-2,54,10,4
1,222,1,1,0,2,-2,12,10,4
1,192,1,1,0,2,-2,22,10,4
1,47,1,1,0,2,-2,55,10,4
1,1,1,0,2,0,2,45,10,4
2,866,1,0,2,0,2,54,10,4
2,796,1,1,0,2,-2,15,10,4
2,666,1,1,0,2,-2,45,10,4
2,580,1,1,0,2,-2,46,10,4
2,504,1,1,0,2,-2,11,10,4
2,484,1,1,0,2,-2,32,10,4
2,315,2,1,0,9,-9,38,2,4
2,282,1,1,0,9,-9,45,10,4
2,207,1,0,9,0,9,50,10,4
2,139,1,0,9,0,9,28,10,4
2,130,1,0,9,0,9,40,10,4
2,111,2,0,9,0,9,45,5,4
3,890,1,1,0,9,-9,36,10,4
3,788,1,0,9,0,9,36,10,4
3,765,2,0,9,0,9,40,6,4
3,730,1,0,9,0,9,48,10,4
3,695,2,1,0,9,-9,54,2,4
3,603,1,1,0,10,-10,35,10,4
3,428,1,1,0,17,-17,15,10,4
3,346,1,1,0,17,-17,49,10,4
3,237,2,1,0,17,-17,14,10,4
3,122,1,0,24,8,16,31,10,4
3,89,2,0,24,8,16,36,5,4
4,894,1,0,24,16,8,44,10,4
4,823,1,1,16,24,-8,9,10,4
4,784,2,1,16,24,-8,11,8,4
4,705,1,1,16,24,-8,40,10,4
4,643,1,0,24,16,8,23,10,4
4,591,1,0,24,16,8,1,1,4
4,533,2,0,24,16,8,1,1,4
4,293,2,1,24,24,0,50,10,4
4,121,1,1,24,24,0,20,5,4
4,115,2,1,24,24,0,16,1,4
4,94,1,1,24,24,0,15,10,4
4,77,1,1,24,24,0,4,4,4
4,73,2,1,24,24,0,1,1,4
4,32,1,1,24,24,0,1,1,4
1,837,3,1,0,0,0,52,0,4
1,816,1,0,0,0,0,54,10,4
1,748,1,0,0,0,0,5,10,4
1,601,1,0,0,7,-7,27,10,4
1,357,1,1,14,7,7,35,10,4
1,320,1,1,14,7,7,45,10,4
1,146,1,0,7,17,-10,5,14,4
2,784,1,1,17,7,10,41,10,4
2,749,1,0,7,17,-10,44,10,4
2,712,2,0,7,17,-10,38,4,4
2,527,1,1,20,7,13,52,10,4
2,443,1,1,20,7,13,39,10,4
2,342,1,1,20,7,13,23,10,4
2,287,1,1,20,14,6,21,10,4
2,116,2,0,21,20,1,29,0,4
2,75,1,0,21,20,1,25,10,4
3,837,1,0,21,20,1,40,10,4
3,561,1,0,21,20,1,42,10,4
3,412,1,0,21,23,-2,35,10,4
3,333,1,1,23,21,2,34,10,4
3,281,3,1,23,21,2,43,1,4
3,218,1,1,23,21,2,50,5,4
3,147,2,0,21,23,-2,45,2,4
3,40,1,0,21,23,-2,30,5,4
4,793,1,1,26,21,5,45,10,4
4,643,1,1,29,21,8,43,10,4
4,527,1,1,29,24,5,35,10,4
4,361,1,0,24,29,-5,19,10,4
4,147,1,0,24,30,-6,42,10,4
4,142,1,0,24,30,-6,30,10,4
4,114,2,0,24,30,-6,32,12,4
1,895,1,0,0,0,0,30,10,4
1,777,1,0,0,0,0,45,10,4
1,628,1,1,0,0,0,42,10,4
1,530,2,1,0,0,0,54,1,4
1,417,1,1,0,0,0,12,10,4
1,384,1,1,0,0,0,24,10,4
1,277,1,0,0,0,0,43,10,4
1,202,1,0,0,0,0,33,10,4
2,847,1,0,10,0,10,29,10,4
2,764,1,0,10,3,7,35,10,4
2,682,3,0,10,3,7,44,1,4
2,629,1,0,10,3,7,45,10,4
2,533,1,0,10,3,7,50,10,4
2,416,1,0,10,3,7,12,10,4
2,41,2,1,9,10,-1,47,4,4
3,876,2,0,10,9,1,54,1,4
3,820,1,1,9,10,-1,54,10,4
3,602,2,0,10,9,1,44,3,4
3,503,1,0,10,12,-2,39,10,4
3,424,1,1,12,10,2,7,10,4
3,287,1,0,10,12,-2,50,10,4
4,900,1,0,17,12,5,26,10,4
4,700,2,0,17,12,5,40,0,4
4,517,3,0,17,12,5,14,1,4
4,507,1,0,17,12,5,13,10,4
4,335,1,0,17,14,3,7,10,4
4,146,1,0,17,16,1,5,5,4
4,141,2,0,17,16,1,1,1,4
4,60,1,1,19,17,2,51,10,4
4,56,2,1,19,17,2,52,9,4
1,603,1,1,0,0,0,5,5,4
1,533,1,1,0,7,-7,16,10,4
1,389,1,0,7,0,7,41,10,4
1,277,2,1,0,7,-7,43,3,4
1,234,3,1,0,7,-7,45,1,4
1,110,1,0,7,0,7,55,10,4
1,71,2,1,0,7,-7,34,2,4
1,15,1,1,0,10,-10,35,10,4
2,537,2,1,0,13,-13,43,2,4
2,464,2,0,13,0,13,52,2,4
2,109,2,1,7,13,-6,28,15,4
3,556,1,1,10,23,-13,45,10,4
3,423,1,0,23,10,13,37,10,4
3,384,2,0,23,10,13,31,4,4
3,98,1,0,30,13,17,29,10,4
3,41,1,0,30,13,17,35,10,4
4,628,2,1,20,30,-10,51,0,4
4,520,1,0,30,20,10,37,15,4
4,440,3,0,30,20,10,52,0,4
4,127,1,0,33,20,13,1,1,4
4,120,1,0,33,27,6,24,10,4
4,32,1,0,33,34,-1,9,9,4
4,28,2,0,33,34,-1,11,11,4
1,894,1,0,0,0,0,30,10,4
1,849,2,0,0,0,0,40,0,4
1,825,1,0,0,0,0,44,10,4
1,792,2,0,0,0,0,51,3,4
1,754,1,0,0,0,0,54,10,4
1,571,1,0,0,0,0,38,10,4
1,544,1,0,0,0,0,50,10,4
1,446,2,1,0,0,0,7,10,4
1,360,1,1,0,0,0,35,10,4
1,331,1,1,0,0,0,22,10,4
1,196,1,1,0,7,-7,35,10,4
1,128,1,0,7,0,7,24,10,4
1,111,2,0,7,0,7,32,2,4
1,78,3,0,7,0,7,34,0,4
1,3,1,0,7,0,7,25,20,4
2,832,1,1,0,7,-7,8,10,4
2,765,1,1,0,7,-7,25,10,4
2,590,1,0,7,0,7,1,1,4
2,576,1,0,7,7,0,32,10,4
2,545,2,0,7,7,0,38,4,4
2,492,1,1,7,7,0,31,10,4
2,395,1,0,7,7,0,8,10,4
2,384,2,0,7,7,0,10,8,4
2,315,1,1,7,7,0,49,10,4
2,244,1,0,7,14,-7,18,10,4
2,160,1,1,14,7,7,53,10,4
2,146,2,1,14,7,7,49,14,4
2,110,1,0,7,14,-7,13,10,4
2,37,2,0,7,14,-7,38,10,4
3,888,1,0,7,14,-7,43,10,4
3,853,2,0,7,14,-7,43,10,4
3,820,1,0,7,14,-7,29,10,4
3,671,2,1,21,7,14,52,3,4
3,636,1,1,21,7,14,46,10,4
3,605,2,1,21,7,14,41,6,4
3,545,1,1,21,7,14,25,10,4
3,486,1,1,21,7,14,41,10,4
3,453,2,1,21,7,14,49,2,4
3,115,1,0,7,31,-24,37,10,4
4,844,1,1,34,7,27,47,10,4
4,750,1,1,34,7,27,5,10,4
4,582,1,1,34,9,25,18,10,4
4,562,2,1,34,9,25,23,5,4
4,518,1,1,34,9,25,34,10,4
4,476,2,1,34,9,25,40,4,4
4,429,1,0,9,34,-25,50,10,4
4,394,1,0,9,34,-25,35,10,4
4,354,2,0,9,34,-25,32,7,4
4,317,1,0,9,34,-25,23,10,4
4,286,2,0,9,34,-25,18,5,4
4,220,1,0,9,37,-28,35,10,4
4,189,1,0,9,37,-28,45,10,4
4,124,1,0,9,37,-28,25,10,4
4,118,2,0,9,37,-28,24,9,4
4,75,1,0,9,40,-31,35,10,4
4,47,1,0,9,40,-31,48,10,4
4,5,1,1,40,9,31,44,10,4
1,870,1,0,0,0,0,44,5,4
1,580,1,0,0,0,0,45,10,4
1,545,2,0,0,0,0,36,1,4
1,494,1,0,0,0,0,37,15,4
1,407,2,0,0,0,0,11,10,4
1,357,1,0,0,0,0,1,1,4
1,313,1,0,0,7,-7,29,10,4
1,55,2,1,10,0,10,39,2,4
1,1,1,0,0,10,-10,52,10,4
2,900,2,0,0,10,-10,46,4,4
2,879,1,0,0,10,-10,40,10,4
2,707,0,0,0,11,-11,33,0,4
2,610,1,0,0,11,-11,30,10,4
2,528,1,0,0,14,-14,35,10,4
2,490,1,0,0,14,-14,49,10,4
2,329,1,0,0,21,-21,8,10,4
2,254,1,0,0,21,-21,52,10,4
2,205,1,0,0,21,-21,26,10,4
2,157,1,0,0,21,-21,1,1,4
2,34,2,1,30,0,30,52,0,4
2,4,1,0,0,30,-30,1,1,4
3,760,1,0,0,37,-37,27,10,4
3,724,1,0,0,37,-37,13,10,4
3,509,1,1,40,0,40,37,10,4
3,327,1,0,3,40,-37,42,10,4
3,281,2,0,3,40,-37,36,4,4
3,215,1,0,3,40,-37,34,10,4
3,77,1,1,40,6,34,35,10,4
4,801,1,0,6,41,-35,40,5,4
4,557,2,1,41,9,32,31,14,4
4,489,1,1,41,9,32,49,10,4
4,412,1,1,41,9,32,32,10,4
4,364,2,1,41,9,32,25,3,4
4,284,1,1,41,9,32,36,10,4
4,250,1,1,41,9,32,51,10,4
4,214,2,1,41,9,32,55,6,4
4,68,1,1,41,9,32,44,10,4
4,63,2,1,41,9,32,48,6,4
1,895,1,1,0,0,0,31,10,4
1,862,2,1,0,0,0,35,6,4
1,764,3,0,0,0,0,49,0,4
1,650,1,0,0,0,0,21,10,4
1,541,1,0,0,3,-3,35,10,4
1,235,1,1,4,0,4,49,10,4
1,186,2,1,4,0,4,42,3,4
1,109,1,1,4,0,4,14,10,4
1,36,1,1,4,0,4,28,10,4
2,860,1,0,0,4,-4,35,10,4
2,731,1,0,0,4,-4,45,10,4
2,611,1,1,4,1,3,55,10,4
2,472,1,0,1,4,-3,39,10,4
2,246,1,1,4,1,3,7,10,4
2,200,2,1,4,1,3,15,2,4
2,90,2,1,4,1,3,39,0,4
2,50,1,0,1,4,-3,45,10,4
3,787,3,1,7,1,6,49,0,4
3,585,1,0,3,7,-4,41,10,4
3,486,1,1,7,3,4,48,10,4
3,295,1,1,7,3,4,25,10,4
3,281,1,1,7,3,4,39,10,4
3,124,1,1,7,3,4,21,10,4
3,50,1,1,7,6,1,35,10,4
3,1,1,0,6,7,-1,52,10,4
4,900,1,0,6,7,-1,9,9,4
4,755,1,1,15,6,9,35,10,4
4,634,1,0,6,15,-9,21,10,4
4,382,2,1,16,6,10,54,4,4
4,168,1,1,16,6,10,55,10,4
4,143,2,0,6,16,-10,52,7,4
4,114,1,0,6,16,-10,42,10,4
4,92,2,0,6,16,-10,36,4,4
4,62,1,0,6,16,-10,30,10,4
4,43,2,0,6,16,-10,25,5,4
4,1,3,0,6,16,-10,21,1,4
1,840,1,1,0,0,0,42,10,4
1,787,1,0,0,0,0,40,10,4
1,698,2,1,0,0,0,44,1,4
1,588,2,0,0,0,0,46,2,4
1,470,1,0,0,3,-3,38,10,4
1,385,2,1,3,0,3,28,3,4
1,33,2,1,3,3,0,18,2,4
2,796,2,1,3,10,-7,55,2,4
2,728,2,0,10,3,7,46,6,4
2,671,1,0,10,6,4,35,10,4
2,635,2,0,10,6,4,45,0,4
2,500,1,1,6,10,-4,38,10,4
2,435,1,1,6,10,-4,50,10,4
2,251,1,0,10,6,4,28,10,4
2,220,2,0,10,6,4,34,4,4
2,77,0,1,6,10,-4,25,0,4
3,894,1,0,10,6,4,36,10,4
3,856,1,0,10,6,4,48,10,4
3,795,1,1,6,10,-4,46,10,4
3,659,1,1,6,10,-4,40,10,4
3,466,1,1,6,13,-7,53,10,4
3,300,1,1,6,13,-7,5,10,4
3,146,1,1,6,13,-7,47,10,4
3,31,1,1,6,13,-7,3,3,4
4,882,2,1,6,13,-7,1,1,4
4,851,1,1,6,20,-14,37,10,4
4,822,2,1,6,20,-14,46,1,4
4,779,1,1,6,20,-14,52,10,4
4,716,1,0,20,6,14,40,10,4
4,617,1,0,20,6,14,47,10,4
4,488,1,0,20,9,11,30,10,4
4,190,1,0,20,12,8,35,10,4
4,115,3,0,20,12,8,45,0,4
4,92,3,0,20,12,8,35,1,4
4,87,1,0,20,12,8,34,10,4
4,79,1,1,12,20,-8,53,10,4
4,57,2,1,12,20,-8,48,5,4
1,896,1,0,0,0,0,41,10,4
1,857,2,0,0,0,0,49,2,4
1,779,1,1,0,0,0,42,10,4
1,709,3,1,0,0,0,32,0,4
1,673,1,1,0,0,0,30,10,4
1,636,2,1,0,0,0,22,2,4
1,475,1,0,7,0,7,41,10,4
1,369,1,1,0,14,-14,34,10,4
1,239,1,0,14,0,14,41,10,4
1,115,1,0,14,3,11,41,10,4
2,832,1,0,15,3,12,46,10,4
2,676,1,0,15,6,9,50,10,4
2,640,2,1,6,15,-9,52,2,4
2,616,1,1,6,15,-9,50,10,4
2,523,1,1,6,16,-10,35,10,4
2,410,1,0,16,6,10,8,8,4
2,158,2,0,16,6,10,40,5,4
2,122,1,1,6,16,-10,48,10,4
2,14,2,1,6,16,-10,45,3,4
3,897,1,1,6,16,-10,37,10,4
3,856,1,1,6,16,-10,55,10,4
3,781,1,0,16,7,9,30,15,4
3,742,1,0,16,7,9,45,10,4
3,598,1,1,7,16,-9,1,1,4
3,530,2,1,7,23,-16,42,1,4
3,484,1,0,23,7,16,40,10,4
3,454,2,0,23,7,16,41,11,4
3,280,1,1,7,23,-16,50,10,4
3,217,1,0,23,7,16,4,10,4
3,191,2,0,23,7,16,10,4,4
3,122,1,1,9,23,-14,50,10,4
3,39,1,0,23,9,14,47,10,4
3,0,1,0,23,9,14,35,10,4
4,818,2,1,16,23,-7,52,1,4
4,786,1,1,16,23,-7,50,10,4
4,754,1,1,16,23,-7,33,10,4
4,614,1,1,16,26,-10,50,10,4
4,551,1,0,26,16,10,50,10,4
4,518,2,0,26,16,10,46,6,4
4,441,1,0,26,16,10,10,10,4
4,340,1,1,23,26,-3,35,10,4
4,264,1,0,26,23,3,50,10,4
4,200,1,1,23,26,-3,47,10,4
4,173,1,1,23,26,-3,25,10,4
4,132,2,1,23,26,-3,16,1,4
4,112,1,1,23,26,-3,14,10,4
4,85,2,1,23,26,-3,9,5,4
4,61,1,1,23,33,-10,39,10,4
4,56,1,1,23,33,-10,29,10,4
1,803,1,1,0,0,0,35,10,4
1,740,1,1,0,0,0,6,10,4
1,647,1,1,0,0,0,32,10,4
1,457,2,0,0,3,-3,41,4,4
1,281,1,1,3,0,3,25,10,4
1,257,2,1,3,0,3,34,1,4
1,220,3,1,3,0,3,34,1,4
1,161,1,1,3,0,3,35,10,4
2,698,1,1,3,3,0,35,10,4
2,668,2,1,3,3,0,35,10,4
2,598,1,0,3,3,0,37,10,4
2,405,1,1,3,4,-1,35,10,4
2,349,1,1,3,4,-1,55,10,4
2,188,1,0,4,3,1,30,10,4
3,872,1,1,13,11,2,44,10,4
3,829,2,1,13,11,2,52,2,4
3,793,1,0,11,13,-2,51,10,4
3,761,2,0,11,13,-2,49,8,4
3,639,1,1,13,11,2,53,10,4
3,413,1,1,13,11,2,43,10,4
3,372,2,1,13,11,2,38,5,4
3,304,1,1,13,14,-1,35,10,4
3,109,2,0,14,13,1,41,10,4
3,1,1,1,13,14,-1,22,10,4
4,890,1,1,13,14,-1,11,10,4
4,702,1,0,17,13,4,44,10,4
4,578,1,1,13,17,-4,26,10,4
4,469,1,1,13,17,-4,5,5,4
4,438,1,1,13,24,-11,39,10,4
4,408,2,1,13,24,-11,46,3,4
4,299,1,0,24,13,11,11,10,4
4,228,1,1,13,24,-11,45,10,4
4,187,2,1,13,24,-11,37,2,4
4,122,1,1,13,24,-11,33,10,4
4,37,1,1,19,24,-5,37,10,4
4,25,2,1,19,24,-5,34,7,4
1,860,1,0,0,0,0,51,10,4
1,810,2,0,0,0,0,45,4,4
1,781,1,0,0,0,0,35,10,4
1,721,1,0,0,0,0,17,10,4
1,616,1,0,0,7,-7,13,10,4
1,545,1,0,0,7,-7,33,10,4
1,482,1,1,7,0,7,40,10,4
1,435,2,1,7,0,7,33,3,4
1,416,1,1,7,0,7,9,9,4
1,323,1,1,7,0,7,1,1,4
1,314,1,1,7,7,0,36,10,4
1,294,2,1,7,7,0,41,5,4
1,243,1,1,7,7,0,50,10,4
1,133,1,0,7,7,0,45,10,4
1,69,1,0,7,7,0,34,10,4
1,5,1,0,7,7,0,25,10,4
2,882,1,0,7,7,0,40,10,4
2,799,1,1,7,7,0,40,10,4
2,741,1,1,7,7,0,51,10,4
2,681,1,1,7,7,0,45,10,4
2,595,1,0,7,7,0,5,10,4
2,523,1,1,7,7,0,51,10,4
2,356,1,1,7,7,0,48,10,4
2,214,1,1,7,10,-3,35,10,4
2,114,1,1,7,10,-3,26,10,4
2,84,1,1,7,10,-3,14,10,4
2,21,1,1,7,13,-6,35,10,4
2,15,1,1,7,13,-6,43,15,4
3,881,1,0,13,7,6,31,10,4
3,649,1,0,20,7,13,55,10,4
3,511,1,1,7,23,-16,35,10,4
3,445,1,1,7,23,-16,46,10,4
3,375,1,0,23,7,16,53,10,4
3,83,2,0,23,10,13,38,3,4
3,60,3,0,23,10,13,40,1,4
3,30,1,0,23,10,13,42,10,4
4,900,2,0,23,10,13,51,1,4
4,726,1,0,23,17,6,35,10,4
4,496,1,0,23,17,6,16,10,4
4,434,3,0,23,17,6,26,0,4
4,285,2,1,17,23,-6,53,3,4
4,262,3,1,17,23,-6,51,1,4
4,115,1,0,23,17,6,55,10,4
4,109,2,1,17,23,-6,50,5,4
4,50,1,1,17,23,-6,36,15,4
4,45,2,1,17,23,-6,31,10,4
1,894,1,1,0,0,0,39,10,4
1,821,1,0,0,0,0,25,10,4
1,734,1,0,0,0,0,34,10,4
1,666,1,0,0,3,-3,35,10,4
1,638,2,0,0,3,-3,39,6,4
1,416,1,1,4,0,4,27,10,4
1,358,1,1,4,0,4,10,10,4
1,269,1,0,7,4,3,47,10,4
1,230,2,0,7,4,3,50,7,4
1,145,1,1,4,7,-3,41,10,4
2,843,2,1,4,7,-3,54,10,4
2,790,1,0,7,4,3,44,10,4
2,654,1,0,7,4,3,37,10,4
2,573,1,1,4,7,-3,27,10,4
2,514,1,0,7,4,3,6,6,4
2,434,1,0,7,7,0,17,20,4
2,340,1,0,7,7,0,48,10,4
2,300,1,0,7,7,0,33,10,4
2,258,2,0,7,7,0,24,1,4
2,171,1,1,14,7,7,36,10,4
2,162,2,1,14,7,7,28,2,4
2,141,1,1,14,7,7,26,10,4
2,98,3,1,14,7,7,16,0,4
2,31,1,1,14,10,4,9,9,4
3,751,1,0,13,14,-1,40,10,4
3,700,1,0,13,14,-1,55,10,4
3,636,1,1,14,13,1,36,10,4
3,590,2,1,14,13,1,40,6,4
3,439,1,0,13,17,-4,25,10,4
3,405,2,0,13,17,-4,33,2,4
3,337,3,0,13,17,-4,34,1,4
3,185,1,1,17,13,4,45,10,4
3,100,3,1,17,13,4,36,1,4
3,10,1,1,17,13,4,47,10,4
4,725,1,0,13,17,-4,25,10,4
4,557,1,1,17,20,-3,46,10,4
4,470,1,1,17,20,-3,39,10,4
4,227,1,1,17,28,-11,48,10,4
4,165,1,0,28,17,11,7,7,4
4,147,2,0,28,17,11,2,2,4
4,140,1,0,28,23,5,45,10,4
4,135,2,0,28,23,5,54,1,4
4,110,1,0,28,23,5,55,10,4
4,89,2,1,23,28,-5,46,1,4
4,85,1,1,23,28,-5,45,10,4
1,535,1,0,0,0,0,27,10,4
1,371,1,0,0,1,-1,35,10,4
1,287,1,1,1,0,1,44,10,4
1,249,1,1,1,0,1,54,10,4
1,102,1,0,0,1,-1,9,9,4
1,55,1,1,8,0,8,51,10,4
2,829,1,1,8,0,8,13,10,4
2,746,1,1,8,0,8,29,10,4
2,567,1,0,7,8,-1,30,10,4
2,445,1,1,15,14,1,35,10,4
2,302,1,1,15,14,1,43,10,4
2,166,1,1,15,14,1,32,10,4
2,150,2,1,15,14,1,40,2,4
2,16,1,1,15,14,1,29,10,4
3,823,1,1,15,14,1,43,10,4
3,777,2,1,15,14,1,35,2,4
3,745,1,1,15,14,1,28,10,4
3,608,1,1,15,17,-2,35,10,4
3,591,2,1,15,17,-2,43,2,4
3,515,1,0,17,15,2,36,10,4
3,479,2,0,17,15,2,26,0,4
3,426,1,0,17,15,2,25,10,4
3,382,1,0,17,22,-5,45,10,4
3,343,2,0,17,22,-5,53,2,4
3,80,1,1,22,24,-2,33,10,4
4,900,1,1,22,24,-2,54,10,4
4,627,1,0,27,22,5,45,10,4
4,550,1,0,27,22,5,25,10,4
4,423,1,0,27,25,2,51,10,4
4,126,2,0,34,25,9,15,3,4
4,92,1,0,34,25,9,44,10,4
4,63,1,1,25,34,-9,52,10,4
4,40,2,1,25,34,-9,45,2,4
1,895,1,1,0,0,0,36,10,4
1,851,1,1,0,0,0,48,10,4
1,772,1,0,0,0,0,41,10,4
1,722,1,0,0,0,0,25,10,4
1,650,1,0,0,7,-7,20,10,4
1,617,1,0,0,7,-7,31,10,4
1,554,1,1,7,0,7,21,10,4
1,497,2,1,7,0,7,23,8,4
1,395,2,0,0,7,-7,30,0,4
1,375,1,0,0,7,-7,31,10,4
1,353,2,0,0,7,-7,34,7,4
1,308,3,0,0,7,-7,40,1,4
1,143,1,1,7,0,7,16,10,4
1,79,1,1,7,3,4,49,10,4
1,35,1,0,3,7,-4,47,10,4
2,900,2,0,3,7,-4,27,1,4
2,824,2,0,3,7,-4,20,6,4
2,761,1,0,3,10,-7,42,10,4
2,688,1,1,10,3,7,16,10,4
2,653,2,1,10,3,7,21,5,4
2,622,1,1,10,3,7,30,10,4
2,583,1,1,10,3,7,42,10,4
2,480,1,0,3,10,-7,28,5,4
2,402,2,0,3,10,-7,43,9,4
2,364,1,1,10,3,7,26,10,4
2,345,1,0,3,10,-7,46,10,4
2,260,2,0,3,10,-7,30,8,4
2,215,2,0,3,10,-7,31,11,4
2,174,1,0,3,10,-7,25,10,4
2,157,2,0,3,10,-7,32,3,4
2,121,2,0,3,10,-7,43,3,4
2,100,1,0,3,10,-7,50,10,4
2,47,1,1,10,3,7,23,10,4
3,893,1,0,3,10,-7,40,10,4
3,852,2,0,3,10,-7,39,11,4
3,698,1,1,10,3,7,4,4,4
3,555,1,1,10,9,1,51,10,4
3,349,1,1,11,9,2,39,20,4
3,264,1,0,9,11,-2,23,10,4
3,209,1,0,9,11,-2,50,10,4
3,170,1,1,11,9,2,48,10,4
3,140,2,1,11,9,2,46,8,4
3,114,1,1,11,9,2,37,10,4
4,725,2,0,9,11,-2,45,6,4
4,683,3,0,9,11,-2,51,0,4
4,580,1,1,11,9,2,17,10,4
4,495,1,1,11,9,2,6,6,4
4,402,1,1,11,12,-1,25,10,4
4,320,1,1,11,15,-4,35,10,4
4,275,1,1,11,15,-4,20,10,4
4,141,1,1,11,18,-7,39,10,4
4,130,1,1,11,18,-7,53,10,4
4,51,1,0,18,11,7,17,10,4
4,46,2,0,18,11,7,23,4,4
1,750,1,0,0,0,0,39,10,4
1,674,1,0,0,3,-3,35,10,4
1,595,1,1,3,0,3,25,10,4
1,542,2,1,3,0,3,31,3,4
1,435,1,0,0,3,-3,39,10,4
1,342,2,0,0,3,-3,2,2,4
1,253,1,1,10,0,10,36,10,4
1,210,2,1,10,0,10,31,5,4
1,9,1,0,3,10,-7,28,10,4
2,840,1,1,10,3,7,52,10,4
2,694,3,0,3,10,-7,19,2,4
2,618,1,0,3,10,-7,10,10,4
2,590,1,0,3,17,-14,41,10,4
2,513,1,1,17,3,14,20,10,4
2,455,1,1,17,3,14,29,15,4
2,303,1,0,3,17,-14,40,10,4
2,260,2,0,3,17,-14,33,3,4
2,192,1,0,3,20,-17,35,10,4
2,174,2,0,3,20,-17,38,7,4
2,133,1,0,3,20,-17,46,10,4
2,49,2,0,3,20,-17,53,10,4
2,22,1,0,3,20,-17,10,10,4
2,16,2,0,3,20,-17,19,1,4
3,896,1,1,20,3,17,23,10,4
3,803,1,0,3,20,-17,30,10,4
3,775,1,0,3,20,-17,40,10,4
3,642,1,0,3,20,-17,12,10,4
3,582,2,0,3,20,-17,5,3,4
3,548,1,0,3,20,-17,1,1,4
3,457,2,1,27,3,24,34,2,4
3,210,2,0,3,27,-24,20,2,4
3,95,1,0,3,30,-27,35,10,4
3,75,2,0,3,30,-27,42,3,4
3,34,3,0,3,30,-27,45,0,4
4,864,1,1,30,3,27,20,10,4
4,786,1,1,30,3,27,32,10,4
4,749,2,1,30,3,27,35,7,4
4,714,1,1,30,3,27,43,10,4
4,526,1,0,3,37,-34,36,10,4
4,388,2,1,37,3,34,16,1,4
4,357,1,1,37,3,34,17,10,4
4,324,1,1,37,3,34,31,10,4
4,287,2,1,37,3,34,38,3,4
4,260,1,1,37,3,34,47,10,4
4,126,1,1,37,3,34,48,10,4
4,72,1,0,3,37,-34,37,10,4
4,44,2,0,3,37,-34,33,6,4
4,14,3,0,3,37,-34,29,2,4
1,855,2,0,0,0,0,36,5,4
1,759,1,1,0,0,0,21,10,4
1,725,1,1,0,0,0,33,10,4
1,543,2,0,0,0,0,27,1,4
1,501,1,0,0,0,0,29,10,4
1,355,1,0,0,0,0,54,10,4
1,232,2,1,0,0,0,18,13,4
1,189,1,1,0,3,-3,35,10,4
1,34,2,0,3,0,3,18,1,4
2,853,1,1,0,3,-3,41,10,4
2,810,2,1,0,3,-3,48,3,4
2,774,1,0,3,0,3,47,10,4
2,739,2,0,3,0,3,40,3,4
2,658,1,0,3,0,3,17,10,4
2,636,1,0,3,7,-4,41,10,4
2,602,2,0,3,7,-4,48,3,4
2,550,1,1,7,3,4,27,10,4
2,490,1,1,7,3,4,46,10,4
2,231,1,0,4,7,-3,48,10,4
2,162,1,1,7,4,3,15,10,4
2,152,2,1,7,4,3,22,3,4
3,889,1,0,11,7,4,41,10,4
3,857,2,0,11,7,4,51,0,4
3,788,1,1,7,11,-4,45,10,4
3,716,1,1,7,11,-4,14,10,4
3,688,1,1,7,11,-4,27,10,4
3,415,1,1,7,11,-4,28,10,4
3,350,3,1,7,11,-4,35,3,4
3,298,2,1,7,11,-4,29,2,4
3,135,2,1,7,14,-7,44,1,4
3,96,1,1,7,14,-7,47,10,4
3,62,2,1,7,14,-7,52,5,4
4,747,1,0,14,10,4,41,10,4
4,643,1,1,10,14,-4,32,10,4
4,496,2,0,14,17,-3,35,6,4
4,450,1,1,17,14,3,47,10,4
4,378,1,0,14,17,-3,28,10,4
4,235,1,1,17,14,3,48,10,4
4,108,1,0,14,17,-3,51,10,4
4,103,1,0,14,17,-3,39,10,4
4,97,2,0,14,17,-3,30,1,4
4,75,1,0,14,17,-3,27,10,4
4,53,2,0,14,17,-3,21,4,4
1,890,1,0,0,0,0,46,10,4
1,712,1,0,0,0,0,48,10,4
1,352,2,0,0,14,-14,43,2,4
1,172,1,1,14,0,14,46,10,4
1,69,1,0,0,14,-14,35,10,4
2,877,1,0,0,17,-17,35,10,4
2,775,1,1,17,0,17,12,10,4
2,681,1,1,17,0,17,52,10,4
2,608,1,1,17,0,17,14,10,4
2,530,1,1,17,0,17,30,10,4
2,340,1,0,0,17,-17,23,10,4
2,193,1,0,0,20,-20,35,10,4
2,142,1,1,20,0,20,33,10,4
2,94,2,1,20,0,20,45,10,4
2,14,3,0,0,20,-20,38,1,4
3,828,2,1,20,1,19,54,1,4
3,775,1,0,1,20,-19,54,10,4
3,435,1,0,1,20,-19,14,10,4
3,282,2,0,1,20,-19,49,1,4
3,253,1,0,1,20,-19,51,10,4
3,228,1,1,20,1,19,48,10,4
3,71,1,0,2,20,-18,18,10,4
3,4,3,0,2,20,-18,28,0,4
4,900,1,0,2,20,-18,30,10,4
4,802,1,1,20,2,18,25,10,4
4,648,1,1,20,5,15,53,10,4
4,608,2,0,5,20,-15,49,2,4
4,578,3,0,5,20,-15,47,0,4
4,358,1,1,23,5,18,53,20,4
4,188,1,1,23,5,18,7,10,4
4,166,2,1,23,5,18,10,7,4
4,94,2,0,5,23,-18,52,10,4
4,20,3,0,5,23,-18,53,1,4
1,783,1,1,0,0,0,18,10,4
1,664,1,1,0,3,-3,33,10,4
1,630,1,1,0,3,-3,54,10,4
1,496,1,0,3,0,3,15,10,4
1,421,1,0,3,3,0,33,10,4
1,387,2,0,3,3,0,41,2,4
1,155,1,1,3,3,0,42,10,4
1,1,1,0,3,3,0,51,10,4
2,779,1,1,3,10,-7,43,10,4
2,741,1,0,10,3,7,50,10,4
2,525,1,0,10,6,4,48,10,4
2,444,2,0,10,6,4,46,2,4
2,344,1,0,10,6,4,43,10,4
2,181,1,1,6,10,-4,1,1,4
2,15,1,1,13,24,-11,16,10,4
3,894,1,1,13,24,-11,27,10,4
3,854,2,1,13,24,-11,34,3,4
3,763,1,0,24,13,11,45,10,4
3,532,1,0,24,13,11,19,10,4
3,457,1,0,24,13,11,26,10,4
3,312,1,1,16,24,-8,45,10,4
3,141,1,1,16,27,-11,35,10,4
3,121,2,1,16,27,-11,43,2,4
3,36,1,0,27,16,11,49,10,4
4,856,1,1,16,27,-11,50,10,4
4,660,2,1,16,30,-14,35,10,4
4,622,1,1,16,30,-14,49,10,4
4,345,1,0,30,16,14,55,10,4
4,180,2,1,16,30,-14,13,1,4
4,169,1,1,16,30,-14,11,10,4
4,134,2,1,16,33,-17,44,1,4
4,79,1,0,33,16,17,32,10,4
4,74,2,0,33,16,17,33,9,4
4,14,2,1,16,33,-17,23,12,4
1,894,1,1,0,0,0,37,10,4
1,717,1,0,0,3,-3,35,10,4
1,599,1,0,0,3,-3,54,10,4
1,566,2,0,0,3,-3,48,4,4
1,492,2,0,0,4,-4,41,4,4
1,464,3,0,0,4,-4,45,0,4
1,437,1,0,0,4,-4,46,10,4
1,344,1,1,4,0,4,30,10,4
1,237,2,0,0,4,-4,49,1,4
1,197,3,0,0,4,-4,49,1,4
1,112,2,0,0,4,-4,42,5,4
1,69,1,0,0,4,-4,37,10,4
1,1,1,0,0,4,-4,26,10,4
2,810,2,0,0,4,-4,30,15,4
2,749,1,1,4,0,4,54,10,4
2,713,2,0,0,4,-4,49,3,4
2,433,1,1,11,0,11,19,10,4
2,363,1,1,11,3,8,35,10,4
2,195,1,1,11,3,8,27,10,4
2,148,2,1,11,6,5,37,8,4
2,100,2,0,6,11,-5,39,1,4
2,61,2,0,6,11,-5,41,10,4
2,28,1,1,11,6,5,34,10,4
2,5,1,1,11,6,5,49,10,4
3,670,1,0,6,11,-5,24,10,4
3,633,2,0,6,11,-5,16,2,4
3,440,1,1,14,6,8,46,10,4
3,261,1,0,6,14,-8,23,10,4
3,186,1,1,14,6,8,53,10,4
3,135,1,0,6,14,-8,44,10,4
3,78,1,0,6,14,-8,29,10,4
3,1,1,0,6,14,-8,15,10,4
4,900,2,0,6,14,-8,8,3,4
4,702,1,0,6,21,-15,35,10,4
4,500,1,1,21,6,15,5,5,4
4,414,1,1,21,9,12,38,10,4
4,216,1,0,9,21,-12,6,6,4
4,102,1,0,9,28,-19,50,10,4
4,90,2,0,9,28,-19,50,10,4
1,880,2,0,0,0,0,45,1,4
1,823,1,1,0,0,0,46,10,4
1,637,2,1,0,1,-1,47,10,4
1,615,1,0,1,0,1,42,10,4
1,454,1,0,1,0,1,5,10,4
1,387,1,0,1,0,1,51,10,4
1,159,1,1,0,1,-1,14,10,4
1,109,2,1,0,1,-1,23,1,4
1,72,1,1,0,1,-1,42,10,4
1,44,2,1,0,1,-1,50,2,4
1,1,1,0,1,0,1,32,10,4
2,866,2,0,1,0,1,23,1,4
2,768,2,0,1,0,1,1,1,4
2,710,1,1,7,1,6,24,10,4
2,632,1,0,1,7,-6,42,10,4
2,581,1,1,7,1,6,28,10,4
2,544,2,1,7,1,6,23,5,4
2,511,3,1,7,1,6,19,1,4
2,308,1,1,7,4,3,38,25,4
2,191,1,0,4,10,-6,35,10,4
2,157,1,1,10,4,6,46,10,4
2,76,2,0,4,10,-6,40,10,4
2,45,1,0,4,10,-6,18,10,4
2,33,1,0,4,16,-12,19,10,4
2,12,2,0,4,16,-12,16,13,4
3,895,1,1,16,4,12,35,10,4
3,814,1,1,16,4,12,47,10,4
3,629,1,0,4,23,-19,55,10,4
3,589,2,1,23,4,19,46,1,4
3,525,2,1,23,4,19,38,4,4
3,496,1,1,23,4,19,33,10,4
3,429,2,1,23,4,19,24,1,4
3,395,1,1,23,4,19,22,10,4
3,364,2,1,23,4,19,15,3,4
3,310,1,1,23,7,16,35,10,4
3,284,2,1,23,7,16,36,9,4
3,223,1,0,7,23,-16,13,10,4
3,109,1,0,7,23,-16,39,10,4
3,66,2,0,7,23,-16,35,6,4
4,890,3,0,7,24,-17,45,0,4
4,726,1,1,24,7,17,32,10,4
4,677,1,1,24,7,17,47,10,4
4,576,2,0,7,24,-17,51,1,4
4,220,1,1,24,10,14,3,3,4
4,191,2,1,24,10,14,2,2,4
4,165,1,1,24,17,7,35,10,4
4,158,2,1,24,17,7,33,12,4
4,104,1,0,17,24,-7,43,10,4
4,98,2,0,17,24,-7,39,6,4
1,870,2,0,0,0,0,35,2,4
1,835,1,0,0,0,0,40,10,4
1,802,2,0,0,0,0,49,2,4
1,769,1,0,0,0,0,53,10,4
1,733,2,1,0,0,0,50,3,4
1,700,1,1,0,0,0,44,10,4
1,610,1,1,0,0,0,34,10,4
1,463,1,0,0,0,0,53,10,4
1,423,2,0,0,0,0,44,1,4
1,385,1,0,0,0,0,43,10,4
1,296,1,0,0,1,-1,35,10,4
1,128,2,1,1,0,1,29,12,4
2,882,1,0,0,1,-1,23,10,4
2,816,1,0,0,1,-1,30,10,4
2,715,1,1,1,0,1,43,10,4
2,680,2,1,1,0,1,50,3,4
2,627,1,0,0,1,-1,26,10,4
2,562,1,1,1,0,1,55,10,4
2,298,1,0,0,8,-8,42,10,4
2,202,2,1,8,0,8,34,10,4
2,150,1,1,8,3,5,40,10,4
2,130,1,1,8,3,5,53,10,4
2,20,1,0,3,15,-12,10,10,4
3,894,1,1,15,3,12,32,10,4
3,820,1,1,15,3,12,45,10,4
3,753,1,0,3,15,-12,35,10,4
3,717,2,0,3,15,-12,27,2,4
3,680,1,0,3,15,-12,19,10,4
3,645,2,0,3,15,-12,12,3,4
3,575,1,0,3,15,-12,2,2,4
3,518,2,0,3,22,-19,41,2,4
3,465,1,1,22,3,19,52,10,4
3,411,1,1,22,3,19,50,10,4
3,385,2,0,3,22,-19,53,3,4
3,343,1,0,3,22,-19,33,10,4
3,259,1,0,3,22,-19,3,3,4
3,160,1,0,3,29,-26,3,3,4
3,119,2,0,3,29,-26,1,1,4
3,48,1,0,3,36,-33,51,10,4
4,900,3,1,36,3,33,50,1,4
4,778,1,1,36,3,33,46,10,4
4,628,1,0,3,50,-47,31,10,4
4,519,1,0,3,50,-47,50,10,4
4,309,1,1,50,3,47,14,15,4
4,286,2,1,50,3,47,11,14,4
4,190,1,1,50,3,47,45,10,4
4,173,1,1,50,3,47,13,10,4
4,125,1,1,50,11,39,40,10,4
4,101,2,1,50,11,39,35,15,4
4,40,1,1,50,17,33,5,0,4
1,894,1,1,0,0,0,31,10,4
1,742,1,0,0,0,0,53,10,4
1,638,1,0,0,7,-7,32,20,4
1,485,1,1,7,0,7,46,10,4
1,424,1,1,7,1,6,35,10,4
1,297,2,0,1,7,-6,24,3,4
1,244,3,0,1,7,-6,26,1,4
1,219,1,0,1,7,-6,28,10,4
1,180,1,0,1,7,-6,44,10,4
1,112,2,1,7,1,6,47,1,4
2,830,1,0,1,7,-6,3,3,4
2,797,2,0,1,7,-6,2,2,4
2,781,1,0,1,14,-13,35,10,4
2,690,2,0,1,14,-13,31,10,4
2,517,1,0,1,22,-21,29,10,4
2,363,1,1,22,1,21,26,10,4
2,101,1,1,22,4,18,45,10,4
3,894,1,0,4,29,-25,27,10,4
3,807,1,1,29,4,25,43,10,4
3,679,1,0,4,29,-25,34,10,4
3,438,2,1,36,4,32,5,0,4
3,346,1,1,36,11,25,15,10,4
3,319,2,1,36,11,25,23,2,4
3,263,1,0,11,36,-25,45,10,4
3,173,1,1,36,18,18,30,10,4
3,50,2,0,18,36,-18,55,1,4
4,584,1,1,36,18,18,28,10,4
4,475,2,0,18,36,-18,27,10,4
4,429,1,1,36,18,18,46,10,4
4,384,1,0,18,36,-18,53,10,4
4,227,1,0,18,36,-18,16,10,4
4,179,2,0,18,36,-18,10,4,4
4,138,1,0,18,36,-18,2,2,4
4,107,1,0,18,43,-25,45,10,4
4,99,2,0,18,43,-25,40,5,4
1,852,2,0,0,0,0,35,3,4
1,804,1,0,0,0,0,38,10,4
1,757,1,0,0,0,0,51,10,4
1,682,1,1,0,0,0,22,10,4
1,531,0,0,0,0,0,52,0,4
1,312,1,0,0,0,0,1,1,4
1,296,1,0,0,7,-7,29,10,4
1,169,1,0,0,7,-7,54,10,4
1,8,2,0,0,7,-7,27,1,4
2,794,1,0,0,14,-14,47,10,4
2,681,1,1,14,0,14,29,10,4
2,552,2,0,0,14,-14,31,2,4
2,192,2,0,0,14,-14,12,3,4
2,180,3,0,0,14,-14,10,1,4
2,129,1,0,0,17,-17,46,10,4
2,70,2,1,17,7,10,47,2,4
2,29,1,0,7,17,-10,24,10,4
2,24,2,0,7,17,-10,30,4,4
3,849,1,1,17,7,10,50,10,4
3,688,2,0,7,17,-10,48,14,4
3,409,1,0,7,17,-10,35,10,4
3,362,2,0,7,17,-10,32,7,4
3,338,1,0,7,17,-10,17,10,4
3,168,1,1,20,7,13,25,10,4
3,103,1,1,20,7,13,26,10,4
4,789,1,1,20,7,13,23,10,4
4,626,2,1,20,10,10,40,0,4
4,462,2,1,20,10,10,18,2,4
4,419,1,1,20,10,10,3,3,4
4,377,2,1,20,10,10,2,2,4
4,335,1,1,20,13,7,35,10,4
4,115,1,1,20,16,4,47,10,4
1,896,1,1,0,0,0,37,10,4
1,865,2,1,0,0,0,46,1,4
1,703,1,0,0,3,-3,35,10,4
1,535,1,0,0,3,-3,22,10,4
1,492,2,0,0,3,-3,23,9,4
1,369,1,0,0,3,-3,29,10,4
1,302,1,0,0,3,-3,39,10,4
1,204,1,1,6,0,6,45,10,4
1,120,1,0,0,6,-6,50,10,4
1,92,2,0,0,6,-6,45,5,4
1,63,3,0,0,6,-6,42,2,4
2,884,1,0,0,7,-7,35,10,4
2,811,1,0,0,7,-7,44,10,4
2,595,2,0,0,7,-7,25,4,4
2,479,1,0,0,10,-10,36,10,4
2,374,1,0,0,17,-17,46,10,4
2,92,1,1,17,0,17,16,10,4
2,38,1,1,17,7,10,42,10,4
2,15,2,1,17,7,10,55,8,4
3,722,1,0,7,17,-10,55,10,4
3,519,1,0,7,17,-10,54,10,4
3,504,1,0,7,17,-10,37,10,4
3,373,2,0,7,18,-11,35,10,4
3,200,2,1,18,7,11,43,13,4
3,83,1,1,18,10,8,35,10,4
4,868,1,1,18,10,8,51,10,4
4,836,2,1,18,10,8,55,6,4
4,648,2,1,18,10,8,20,2,4
4,619,3,1,18,10,8,22,0,4
4,410,1,1,18,10,8,53,10,4
4,322,3,0,10,18,-8,47,0,4
4,287,1,0,10,18,-8,45,10,4
4,70,1,1,18,10,8,48,10,4
1,834,1,1,0,0,0,24,10,4
1,796,2,1,0,0,0,32,2,4
1,762,1,1,0,0,0,36,10,4
1,640,2,0,0,0,0,53,1,4
1,609,1,0,0,0,0,55,10,4
1,531,1,1,0,0,0,40,10,4
1,329,1,0,7,0,7,35,10,4
1,165,1,0,7,0,7,27,10,4
1,7,1,1,3,7,-4,29,10,4
2,900,1,1,3,7,-4,53,10,4
2,806,1,0,7,3,4,13,10,4
2,752,1,0,7,3,4,20,10,4
2,669,1,0,7,3,4,5,5,4
2,614,2,0,7,10,-3,32,3,4
2,484,1,1,10,7,3,48,10,4
2,389,1,1,10,7,3,31,10,4
2,21,1,0,14,20,-6,30,10,4
2,17,2,0,14,20,-6,32,8,4
3,895,1,0,14,20,-6,37,10,4
3,852,2,0,14,20,-6,45,2,4
3,685,1,1,20,14,6,21,10,4
3,517,1,0,14,20,-6,38,10,4
3,455,1,0,14,20,-6,17,10,4
3,434,1,0,14,20,-6,6,6,4
3,370,2,0,14,20,-6,3,3,4
3,298,2,0,14,27,-13,38,1,4
3,255,1,1,27,14,13,52,10,4
3,185,3,1,27,14,13,43,1,4
3,117,1,1,27,14,13,26,10,4
4,859,2,0,17,27,-10,49,10,4
4,799,1,1,27,17,10,33,10,4
4,675,2,0,17,27,-10,33,6,4
4,565,0,0,24,27,-3,54,0,4
4,518,2,0,24,27,-3,49,3,4
4,141,1,0,24,37,-13,25,10,4
4,134,2,0,24,37,-13,20,5,4
4,96,1,0,24,40,-16,45,10,4
4,71,2,0,24,40,-16,44,9,4
4,67,3,0,24,40,-16,36,1,4
1,767,1,1,0,0,0,18,10,4
1,650,2,1,0,0,0,49,1,4
1,564,1,1,0,0,0,10,15,4
1,508,1,1,0,0,0,30,10,4
1,477,2,1,0,0,0,34,6,4
1,443,1,1,0,0,0,40,10,4
1,280,1,1,7,0,7,47,10,4
1,248,2,1,7,0,7,42,5,4
1,117,3,1,7,0,7,49,1,4
2,843,1,0,0,7,-7,35,10,4
2,769,1,1,7,0,7,55,10,4
2,513,1,0,0,10,-10,36,10,4
2,364,1,0,0,10,-10,31,10,4
2,132,2,0,0,20,-20,48,10,4
2,88,1,0,0,20,-20,8,10,4
2,80,1,0,0,20,-20,20,10,4
2,15,2,0,0,20,-20,38,9,4
3,537,1,0,0,27,-27,1,1,4
3,411,1,1,34,0,34,45,10,4
3,387,2,1,34,0,34,54,1,4
3,326,1,0,0,34,-34,35,10,4
3,90,1,0,0,34,-34,53,10,4
4,742,2,0,7,34,-27,35,4,4
4,707,1,0,7,34,-27,31,10,4
4,593,1,0,7,37,-30,29,10,4
4,271,1,1,37,7,30,13,10,4
4,245,2,1,37,7,30,14,9,4
4,118,1,1,37,10,27,35,10,4
4,114,2,1,37,10,27,39,6,4
4,60,2,1,37,10,27,33,10,4
1,822,1,0,0,0,0,43,10,4
1,752,1,1,0,0,0,34,10,4
1,678,1,1,0,0,0,53,10,4
1,586,1,0,0,0,0,22,10,4
1,345,1,0,0,0,0,3,3,4
1,286,1,0,0,6,-6,44,10,4
1,217,1,1,6,0,6,19,10,4
1,128,1,1,6,0,6,32,10,4
1,64,2,1,6,0,6,14,3,4
2,900,1,1,6,3,3,35,10,4
2,851,1,0,3,6,-3,43,10,4
2,765,2,1,6,3,3,45,0,4
2,441,1,1,6,6,0,38,10,4
2,377,1,1,6,6,0,21,10,4
2,140,2,1,6,6,0,42,1,4
2,54,1,1,6,6,0,31,10,4
3,867,2,0,13,6,7,24,10,4
3,803,1,1,6,13,-7,43,10,4
3,695,1,0,13,7,6,35,10,4
3,520,2,1,7,13,-6,47,4,4
3,441,2,1,7,13,-6,21,10,4
3,418,1,0,20,7,13,51,10,4
3,313,1,0,20,7,13,1,1,4
3,171,2,1,14,20,-6,39,1,4
3,2,2,1,14,27,-13,37,1,4
4,780,1,0,27,14,13,42,10,4
4,686,1,1,14,27,-13,38,10,4
4,632,2,1,14,27,-13,29,1,4
4,607,1,1,14,27,-13,17,10,4
4,532,1,1,14,27,-13,1,1,4
4,369,1,0,34,14,20,1,1,4
4,332,2,0,34,14,20,1,1,4
4,306,1,0,34,20,14,26,10,4
4,252,1,0,34,20,14,32,10,4
4,131,1,0,34,27,7,15,10,4
4,63,1,1,27,34,-7,52,10,4
4,58,2,1,27,34,-7,52,10,4
1,846,2,1,0,0,0,30,10,4
1,697,1,0,0,0,0,35,10,4
1,584,1,1,0,0,0,53,10,4
1,439,1,0,0,0,0,13,10,4
1,650,1,0,0,0,0,47,10,4
1,615,1,0,0,0,0,37,10,4
1,420,1,0,0,0,0,5,10,4
1,247,1,0,0,0,0,30,10,4
1,22,2,0,1,0,1,46,3,4
2,827,1,1,0,1,-1,39,10,4
2,790,2,1,0,1,-1,47,2,4
2,695,2,1,0,1,-1,40,0,4
2,662,1,1,0,1,-1,37,10,4
2,637,1,1,0,1,-1,25,10,4
2,521,2,1,0,4,-4,40,5,4
2,450,1,1,0,4,-4,51,10,4
2,397,1,0,4,0,4,53,10,4
2,304,1,0,4,0,4,22,10,4
2,68,1,1,3,12,-9,1,10,4
2,46,1,1,3,12,-9,16,10,4
2,5,2,1,3,12,-9,23,17,4
3,888,1,0,12,3,9,37,10,4
3,820,1,1,3,12,-9,53,10,4
3,690,1,1,3,12,-9,31,10,4
3,556,1,0,12,3,9,54,10,4
3,356,1,1,3,12,-9,36,10,4
3,290,1,1,3,12,-9,20,10,4
3,260,2,1,3,12,-9,16,6,4
3,206,1,1,3,12,-9,10,10,4
3,174,1,1,3,19,-16,36,10,4
3,894,1,0,19,3,16,8,17,4
4,887,1,0,19,3,16,44,10,4
4,775,1,1,3,19,-16,38,10,4
1,857,1,0,0,0,0,34,10,4
1,773,1,0,0,0,0,3,3,4
1,740,2,0,0,0,0,2,2,4
1,664,3,0,0,0,0,1,1,4
1,643,1,0,0,7,-7,30,10,4
1,614,2,0,0,7,-7,36,4,4
1,593,1,0,0,7,-7,44,10,4
1,527,1,1,7,0,7,41,10,4
1,487,2,1,7,0,7,35,4,4
1,416,1,1,7,3,4,34,10,4
1,311,1,0,3,7,-4,24,10,4
1,287,2,0,3,7,-4,28,6,4
1,250,1,0,3,7,-4,35,10,4
2,714,1,1,7,3,4,17,10,4
2,250,1,1,7,20,-13,37,10,4
2,147,1,0,20,7,13,34,10,4
3,890,1,1,7,22,-15,34,10,4
3,820,3,1,7,22,-15,30,6,4
3,785,1,1,7,22,-15,23,10,4
3,732,1,1,7,22,-15,9,9,4
3,634,1,1,7,30,-23,33,10,4
3,614,2,1,7,30,-23,35,8,4
3,575,1,1,7,30,-23,44,10,4
3,539,2,1,7,30,-23,53,1,4
3,485,1,1,7,30,-23,55,15,4
3,371,1,0,30,7,23,47,10,4
3,345,2,0,30,7,23,54,3,4
3,147,1,0,30,7,23,5,10,4
3,46,1,0,30,7,23,24,10,4
4,864,1,0,30,10,20,30,15,4
4,766,1,0,30,10,20,54,10,4
4,685,1,0,30,10,20,11,10,4
4,571,1,0,30,10,20,8,15,4
4,477,1,1,10,30,-20,34,10,4
4,448,2,1,10,30,-20,35,9,4
4,275,1,1,10,30,-20,26,10,4
4,249,2,1,10,30,-20,22,6,4
4,184,1,1,10,30,-20,20,10,4
4,138,1,0,30,10,20,52,10,4
4,104,2,0,30,10,20,50,12,4
4,61,2,1,10,30,-20,44,1,4
4,8,1,0,30,10,20,34,10,4
4,1,2,0,30,10,20,30,6,4
1,695,1,0,7,0,7,7,10,4
1,653,2,0,7,0,7,2,2,4
1,587,1,0,7,0,7,1,1,4
1,527,2,0,7,0,7,1,1,4
1,507,1,0,7,7,0,18,10,4
1,247,2,1,7,10,-3,37,3,4
1,205,1,1,7,10,-3,41,10,4
1,30,1,0,10,7,3,50,10,4
2,869,2,1,7,10,-3,23,4,4
2,831,1,1,7,10,-3,19,10,4
2,727,1,1,7,13,-6,37,5,4
2,578,2,1,7,13,-6,47,2,4
2,457,2,1,7,13,-6,12,2,4
2,357,1,1,7,13,-6,8,8,4
2,165,1,1,7,20,-13,54,10,4
2,47,2,1,7,20,-13,52,2,4
3,894,1,1,7,20,-13,30,10,4
3,868,2,1,7,20,-13,36,4,4
3,653,1,1,7,20,-13,17,10,4
3,273,2,0,23,7,16,52,3,4
3,1,2,0,23,7,16,32,1,4
4,900,1,0,23,7,16,30,10,4
4,836,1,0,23,7,16,2,2,4
4,460,1,0,26,13,13,38,10,4
4,357,1,1,13,26,-13,43,10,4
4,299,2,0,26,13,13,50,10,4
4,67,1,0,26,15,11,52,10,4
1,690,1,0,0,6,-6,26,10,4
1,628,1,1,6,0,6,27,10,4
1,557,3,1,6,0,6,19,2,4
1,502,1,1,6,0,6,9,5,4
1,421,1,1,6,3,3,35,10,4
1,341,1,0,3,6,-3,25,10,4
1,79,2,1,6,3,3,50,1,4
2,844,1,0,3,6,-3,1,1,4
2,812,1,1,13,3,10,28,10,4
2,786,2,1,13,3,10,21,3,4
2,751,1,1,13,3,10,15,10,4
2,589,1,0,10,13,-3,41,10,4
2,571,2,0,10,13,-3,38,7,4
2,243,1,1,19,10,9,40,10,4
2,134,1,1,19,10,9,38,10,4
3,642,1,1,19,16,3,46,10,4
3,592,2,1,19,16,3,55,1,4
3,334,1,1,19,16,3,50,10,4
3,257,1,0,16,19,-3,43,10,4
4,842,1,1,27,16,11,1,1,4
4,36,1,1,30,30,0,1,1,4
1,815,1,0,0,0,0,43,10,4
1,783,2,0,0,0,0,37,4,4
1,684,1,0,0,0,0,5,5,4
1,555,1,1,6,0,6,36,10,4
1,377,2,0,0,6,-6,52,4,4
1,333,1,1,6,0,6,53,10,4
1,253,1,1,6,0,6,10,10,4
1,21,1,0,0,6,-6,37,10,4
2,475,1,0,5,6,-1,16,10,4
2,458,2,0,5,6,-1,7,1,4
2,422,1,0,5,6,-1,5,5,4
2,319,1,0,5,13,-8,27,10,4
2,192,1,1,13,5,8,26,10,4
2,157,1,0,5,13,-8,40,10,4
2,95,1,1,13,5,8,17,10,4
2,30,1,0,5,13,-8,17,10,4
2,25,2,0,5,13,-8,19,8,4
3,899,1,0,5,13,-8,25,10,4
3,830,3,0,5,13,-8,32,3,4
3,798,1,0,5,13,-8,41,10,4
3,660,1,1,13,5,8,26,10,4
3,620,2,1,13,5,8,18,2,4
3,604,3,1,13,5,8,17,1,4
3,465,1,1,13,13,0,28,10,4
3,395,1,0,13,13,0,22,10,4
3,276,1,0,13,13,0,49,10,4
3,180,1,0,13,13,0,39,10,4
4,900,2,1,16,13,3,51,4,4
4,802,1,1,16,13,3,45,10,4
4,713,1,1,16,13,3,16,10,4
4,620,1,1,16,13,3,6,6,4
4,473,2,0,20,16,4,44,10,4
4,227,1,0,20,16,4,5,10,4
4,160,1,0,20,16,4,34,10,4
4,112,1,0,20,16,4,50,10,4
4,90,2,0,20,16,4,51,9,4
4,63,1,1,16,20,-4,49,10,4
4,59,2,1,16,20,-4,47,8,4
4,54,1,1,16,20,-4,38,10,4
4,31,2,1,16,20,-4,37,9,4
1,878,1,1,0,0,0,7,10,4
1,826,1,1,0,0,0,29,10,4
1,747,1,1,0,0,0,44,10,4
1,663,1,0,0,0,0,45,10,4
1,596,1,1,0,7,-7,25,10,4
1,438,1,0,7,0,7,42,10,4
1,35,1,1,7,15,-8,35,10,4
1,1,2,1,7,15,-8,41,4,4
2,799,1,0,15,7,8,21,10,4
2,721,1,0,15,7,8,31,10,4
2,220,2,0,15,10,5,40,2,4
2,185,3,0,15,10,5,38,0,4
2,151,1,1,10,15,-5,45,10,4
2,30,1,0,18,10,8,20,10,4
2,23,1,0,18,10,8,31,10,4
3,622,2,0,18,10,8,25,1,4
3,294,1,1,18,18,0,21,10,4
3,164,1,1,18,18,0,54,10,4
4,861,2,1,18,21,-3,41,4,4
4,774,1,1,18,21,-3,52,10,4
4,706,1,1,18,21,-3,34,10,4
4,613,1,1,18,22,-4,35,10,4
4,485,1,0,22,18,4,17,10,4
4,377,2,0,22,18,4,2,2,4
4,329,3,0,22,18,4,1,1,4
4,242,2,0,22,18,4,6,15,4
4,131,1,0,22,21,1,47,10,4
4,101,1,1,21,22,-1,46,10,4
1,750,1,1,2,0,2,39,10,4
1,657,1,1,2,0,2,29,30,4
1,474,2,0,0,2,-2,50,3,4
1,240,1,0,1,2,-1,45,10,4
1,136,1,0,1,3,-2,39,10,4
2,871,2,0,7,10,-3,37,1,4
2,839,1,0,7,10,-3,39,10,4
2,808,2,0,7,10,-3,48,1,4
2,562,1,0,7,10,-3,7,10,4
2,514,1,0,7,10,-3,30,10,4
2,472,2,0,7,10,-3,27,7,4
2,431,3,0,7,10,-3,24,4,4
2,270,1,1,10,7,3,43,10,4
2,230,1,1,10,7,3,30,10,4
2,158,1,1,10,10,0,35,10,4
2,40,1,1,10,10,0,17,10,4
3,835,3,0,10,10,0,46,0,4
3,658,1,1,10,10,0,43,10,4
3,605,2,1,10,10,0,52,1,4
3,565,3,1,10,10,0,53,0,4
3,211,1,0,10,16,-6,50,10,4
3,33,2,1,16,11,5,45,0,4
4,732,1,0,11,24,-13,37,10,4
4,586,3,1,25,11,14,44,5,4
4,555,1,1,25,11,14,40,10,4
4,247,1,0,11,26,-15,35,10,4
4,156,1,1,26,11,15,33,10,4
4,150,2,1,26,11,15,34,9,4
4,93,1,0,11,26,-15,48,10,4
4,83,2,0,11,26,-15,48,10,4
4,75,1,0,11,26,-15,23,10,4
1,834,2,1,0,0,0,30,1,4
1,805,1,1,0,0,0,34,10,4
1,703,2,1,0,0,0,55,2,4
1,665,3,0,0,0,0,54,1,4
1,519,2,0,0,0,0,21,2,4
1,434,1,0,0,0,0,53,15,4
1,239,1,0,0,0,0,39,5,4
1,37,1,1,0,7,-7,36,10,4
2,881,1,0,7,0,7,41,10,4
2,794,1,0,7,7,0,33,10,4
2,703,1,1,7,7,0,40,10,4
2,628,2,1,7,7,0,44,14,4
2,574,1,1,7,7,0,5,10,4
2,549,2,1,7,7,0,15,0,4
2,301,1,0,7,7,0,45,10,4
2,245,1,1,7,7,0,38,10,4
2,129,1,1,7,7,0,2,2,4
3,846,1,0,15,14,1,53,10,4
3,822,1,0,15,22,-7,28,10,4
3,718,2,0,15,22,-7,49,3,4
3,648,1,1,22,15,7,9,10,4
3,535,1,0,15,22,-7,44,10,4
3,358,1,0,15,23,-8,55,10,4
3,320,2,1,23,15,8,46,1,4
3,280,1,1,23,15,8,45,10,4
3,150,1,1,23,23,0,35,20,4
3,86,1,0,23,23,0,1,10,4
3,73,1,0,23,23,0,19,10,4
3,1,2,0,23,23,0,23,6,4
4,886,1,1,23,23,0,50,10,4
4,757,1,0,23,23,0,35,10,4
4,576,1,1,26,23,3,34,10,4
4,376,2,1,26,30,-4,20,0,4
4,296,1,1,26,30,-4,36,10,4
4,196,2,1,26,30,-4,48,10,4
4,156,1,0,30,26,4,15,10,4
4,150,1,0,30,26,4,26,10,4
4,126,2,0,30,26,4,32,4,4
4,99,1,0,30,26,4,36,10,4
4,73,2,0,30,26,4,45,1,4
4,51,1,0,30,26,4,47,10,4
1,898,1,0,0,1,-1,35,10,4
1,748,2,1,1,0,1,14,5,4
1,645,2,1,1,3,-2,43,2,4
1,591,1,1,1,3,-2,50,5,4
1,553,2,1,1,3,-2,54,1,4
1,408,1,0,3,1,2,13,10,4
1,195,1,1,7,3,4,20,10,4
1,185,1,1,7,3,4,7,10,4
1,77,1,1,7,10,-3,31,10,4
2,652,1,1,7,17,-10,1,10,4
2,559,1,1,7,31,-24,38,10,4
2,141,1,1,7,38,-31,54,10,4
2,35,1,0,38,7,31,4,4,4
2,30,1,0,38,13,25,25,10,4
2,1,2,0,38,13,25,29,6,4
3,549,1,0,41,13,28,15,10,4
3,446,2,1,15,41,-26,47,1,4
3,150,1,1,18,41,-23,20,10,4
3,1,1,0,49,18,31,48,10,4
4,747,2,0,49,18,31,16,11,4
4,704,1,0,49,26,23,28,10,4
4,550,3,0,49,26,23,53,0,4
4,519,1,0,49,26,23,55,10,4
4,456,1,1,26,49,-23,32,10,4
4,356,1,1,26,52,-26,35,10,4
4,213,1,0,52,26,26,11,10,4
4,130,1,1,26,52,-26,54,10,4
4,111,2,1,26,52,-26,46,2,4
4,87,1,1,26,52,-26,44,10,4
4,64,1,1,26,52,-26,33,10,4
4,40,2,1,26,52,-26,29,6,4
1,820,1,0,0,0,0,30,10,4
1,735,1,0,0,0,0,36,15,4
1,659,1,1,0,0,0,54,10,4
1,574,1,1,0,0,0,15,10,4
1,465,1,1,0,0,0,50,10,4
1,407,1,0,0,0,0,36,10,4
1,332,1,0,0,0,0,9,9,4
1,255,1,0,0,7,-7,23,10,4
1,162,1,0,0,7,-7,35,10,4
1,22,1,0,0,7,-7,52,10,4
2,878,1,0,0,7,-7,17,10,4
2,741,1,0,0,7,-7,31,10,4
2,717,2,0,0,7,-7,23,2,4
2,403,1,0,0,10,-10,30,10,4
2,314,1,1,10,0,10,15,10,4
2,221,1,0,0,10,-10,40,10,4
2,180,2,0,0,10,-10,31,1,4
2,122,1,0,0,16,-16,3,0,4
2,90,1,1,16,0,16,41,10,4
2,56,1,1,16,0,16,5,10,4
2,48,1,1,16,0,16,21,10,4
2,27,2,1,16,0,16,23,8,4
3,852,2,1,16,0,16,53,2,4
3,794,3,1,16,0,16,55,0,4
3,754,1,0,0,16,-16,54,10,4
3,678,1,0,0,16,-16,40,10,4
3,632,2,0,0,16,-16,33,3,4
3,603,3,0,0,16,-16,31,1,4
3,551,1,0,0,16,-16,30,10,4
3,492,1,0,0,16,-16,20,10,4
3,415,1,0,0,22,-22,31,10,4
3,199,1,1,22,3,19,35,10,4
3,164,2,1,22,3,19,38,7,4
3,134,3,1,22,3,19,45,0,4
3,32,1,0,3,22,-19,50,10,4
3,2,2,0,3,22,-19,46,6,4
4,843,1,1,25,3,22,7,5,4
4,755,1,1,25,3,22,4,4,4
4,706,2,1,25,3,22,1,1,4
4,635,3,1,25,3,22,1,1,4
4,541,1,1,25,11,14,51,10,4
4,475,2,1,25,11,14,45,16,4
4,399,2,0,11,25,-14,18,1,4
4,273,1,0,11,25,-14,12,10,4
4,223,2,0,11,25,-14,6,4,4
4,144,1,0,11,28,-17,54,20,4
4,63,2,1,29,11,18,45,5,4
1,826,2,1,0,0,0,55,3,4
1,708,1,0,0,0,0,35,10,4
1,685,2,0,0,0,0,27,2,4
1,535,2,1,0,0,0,39,2,4
1,525,1,1,0,0,0,35,10,4
1,414,1,1,0,3,-3,35,10,4
1,314,1,0,3,0,3,46,10,4
1,222,1,0,3,0,3,2,10,4
1,54,1,0,3,0,3,17,10,4
2,900,1,0,3,0,3,45,10,4
2,819,1,1,0,3,-3,15,10,4
2,666,1,1,0,3,-3,42,10,4
2,642,2,1,0,3,-3,36,4,4
2,509,1,1,0,3,-3,6,6,4
2,441,1,1,0,6,-6,35,10,4
2,335,1,0,6,0,6,23,10,4
2,305,2,0,6,0,6,20,7,4
2,228,1,0,6,7,-1,33,10,4
2,149,2,1,7,6,1,54,1,4
2,119,2,1,7,6,1,51,10,4
2,96,1,1,7,7,0,35,10,4
2,89,1,1,7,7,0,53,10,4
3,893,1,0,7,10,-3,44,10,4
3,662,1,1,10,9,1,44,10,4
3,615,2,1,10,9,1,51,3,4
3,567,2,0,9,10,-1,43,2,4
3,497,2,0,9,10,-1,32,2,4
3,457,1,0,9,10,-1,29,10,4
3,421,2,0,9,10,-1,24,5,4
3,150,1,1,13,16,-3,55,10,4
3,84,2,0,16,13,3,46,1,4
3,56,3,0,16,13,3,45,0,4
4,832,2,0,16,20,-4,54,3,4
4,749,1,1,20,16,4,31,10,4
4,654,2,1,20,16,4,51,3,4
4,624,3,1,20,16,4,53,1,4
4,543,1,0,16,20,-4,16,10,4
4,316,1,1,27,16,11,42,10,4
4,182,3,0,16,27,-11,51,1,4
4,177,1,0,16,27,-11,50,10,4
4,126,1,0,16,27,-11,33,10,4
4,116,2,0,16,27,-11,32,9,4
4,73,1,0,16,27,-11,21,10,4
4,48,2,0,16,27,-11,18,7,4
4,29,3,0,16,27,-11,18,7,4
1,895,1,0,0,0,0,38,10,4
1,862,1,0,0,0,0,49,10,4
1,796,3,1,0,0,0,52,1,4
1,580,2,1,0,3,-3,42,3,4
1,500,2,0,3,0,3,54,1,4
1,450,2,0,3,0,3,35,0,4
1,354,1,1,0,3,-3,3,3,4
1,298,2,1,0,3,-3,1,1,4
1,162,1,1,3,3,0,52,5,4
1,130,2,1,3,3,0,49,2,4
2,824,1,1,3,10,-7,27,10,4
2,581,1,0,10,3,7,40,10,4
2,319,1,0,10,6,4,48,10,4
2,180,1,0,10,9,1,49,10,4
2,105,1,1,9,10,-1,16,10,4
3,785,1,0,10,17,-7,19,10,4
3,744,2,0,10,17,-7,11,2,4
3,706,3,0,10,17,-7,10,1,4
3,530,1,0,10,20,-10,35,10,4
3,423,2,0,10,20,-10,53,3,4
3,254,1,1,20,11,9,47,10,4
3,1,1,1,21,11,10,43,10,4
4,844,1,1,21,11,10,11,10,4
4,727,1,1,21,11,10,46,10,4
4,561,1,1,21,18,3,22,10,4
4,493,1,1,21,18,3,43,10,4
4,221,2,1,21,18,3,41,15,4
4,166,1,1,21,21,0,35,10,4
4,161,2,1,21,21,0,44,1,4
4,155,1,1,21,21,0,48,10,4
4,114,1,0,21,21,0,7,7,4
4,77,1,0,21,21,0,1,1,4
5,0,2,0,28,28,0,26,1,4
5,0,1,0,28,28,0,20,10,4
5,0,1,0,28,28,0,1,1,4
5,0,2,0,28,28,0,1,1,4
5,0,0,1,34,28,6,1,0,4
5,0,1,1,34,28,6,25,10,4
5,0,1,1,34,34,0,35,10,4
5,0,2,1,34,34,0,26,1,4
5,0,1,1,34,34,0,20,10,4
1,829,1,0,0,0,0,42,10,4
1,666,2,1,0,0,0,39,10,4
1,586,1,1,0,0,0,25,10,4
1,139,1,1,14,0,14,54,10,4
1,89,1,0,0,14,-14,50,10,4
1,81,2,0,0,14,-14,43,3,4
1,50,1,0,0,14,-14,23,10,4
2,894,3,0,0,14,-14,1,1,4
2,873,1,0,0,20,-20,20,10,4
2,308,1,1,29,0,29,23,10,4
2,158,1,1,29,8,21,48,10,4
3,896,1,1,36,11,25,28,10,4
3,666,1,1,36,11,25,26,10,4
3,408,1,0,14,36,-22,11,10,4
3,360,2,0,14,43,-29,44,4,4
3,166,1,1,43,14,29,30,10,4
3,64,2,1,43,14,29,14,1,4
4,885,1,1,43,14,29,8,10,4
4,657,2,0,17,43,-26,49,3,4
4,603,3,0,17,43,-26,47,1,4
4,584,1,0,17,43,-26,44,10,4
4,544,2,0,17,43,-26,37,3,4
4,215,1,1,46,17,29,25,10,4
4,132,1,0,17,46,-29,42,10,4
4,114,1,0,17,46,-29,55,10,4
4,80,1,1,46,17,29,10,10,4
4,40,1,1,46,17,29,21,10,4
4,20,2,1,46,17,29,21,10,4
1,894,1,1,0,0,0,26,10,4
1,720,3,1,0,0,0,40,1,4
1,678,1,1,0,0,0,34,10,4
1,589,1,1,0,0,0,8,10,4
1,445,1,0,0,0,0,51,10,4
1,410,2,0,0,0,0,46,5,4
1,351,1,0,0,3,-3,45,10,4
1,226,1,0,0,3,-3,16,10,4
1,130,1,0,0,6,-6,50,10,4
2,870,2,1,6,0,6,15,3,4
2,825,1,1,6,3,3,35,10,4
2,675,1,0,3,6,-3,30,10,4
2,506,2,0,3,12,-9,53,4,4
2,292,1,1,12,3,9,3,3,4
2,275,2,1,12,3,9,4,4,4
2,244,1,1,12,10,2,25,10,4
2,52,1,0,10,12,-2,18,10,4
2,47,2,0,10,12,-2,21,7,4
2,14,1,0,10,19,-9,43,10,4
2,1,2,0,10,19,-9,47,6,4
3,848,2,0,10,19,-9,45,2,4
3,713,1,1,19,13,6,35,10,4
3,495,1,0,13,19,-6,26,10,4
3,332,1,0,13,19,-6,45,10,4
3,245,3,0,13,19,-6,35,0,4
3,220,1,0,13,19,-6,34,10,4
4,900,1,1,22,13,9,18,10,4
4,845,1,1,22,13,9,8,8,4
4,787,1,1,22,20,2,46,10,4
4,760,1,0,20,22,-2,47,10,4
4,663,2,0,20,22,-2,27,2,4
4,526,2,1,25,20,5,29,10,4
4,467,3,1,25,20,5,39,0,4
4,303,2,0,20,25,-5,33,1,4
4,209,2,1,25,20,5,38,10,4
4,169,1,1,25,23,2,35,10,4
4,114,1,0,23,25,-2,24,10,4
4,80,1,0,23,25,-2,26,10,4
4,73,2,0,23,25,-2,22,6,4
1,821,1,0,0,0,0,42,10,4
1,786,1,1,0,0,0,52,10,4
1,768,2,1,0,0,0,51,9,4
1,678,1,1,0,0,0,14,10,4
1,624,1,1,0,0,0,26,10,4
1,585,1,1,0,0,0,37,10,4
1,449,1,0,0,0,0,53,10,4
1,409,2,0,0,0,0,54,9,4
1,303,2,1,0,7,-7,34,10,4
1,149,2,0,7,0,7,26,1,4
1,116,1,0,7,0,7,22,10,4
2,900,1,0,7,3,4,46,10,4
2,746,1,0,7,3,4,22,10,4
2,473,2,1,6,7,-1,36,8,4
2,422,2,0,7,6,1,22,1,4
2,388,1,0,7,6,1,27,10,4
2,249,1,0,7,6,1,43,10,4
2,209,2,0,7,6,1,53,0,4
3,713,2,0,7,6,1,10,2,4
3,676,1,0,7,6,1,4,4,4
3,540,1,1,9,7,2,28,10,4
3,455,1,0,7,9,-2,47,10,4
3,425,2,0,7,9,-2,54,3,4
3,383,1,1,9,7,2,51,10,4
3,4,1,1,12,15,-3,26,10,4
4,883,1,1,12,15,-3,10,10,4
4,796,1,1,12,15,-3,1,1,4
4,538,2,0,22,12,10,41,1,4
4,456,1,0,22,12,10,14,10,4
4,371,1,0,22,18,4,38,10,4
4,329,2,0,22,18,4,47,1,4
4,141,2,1,18,22,-4,10,10,4
4,94,1,0,29,26,3,27,10,4
4,88,1,0,29,26,3,38,10,4
4,84,2,0,29,26,3,40,8,4
4,60,3,0,29,26,3,48,0,4
5,0,2,1,29,29,0,30,5,4
5,0,1,0,32,29,3,6,6,4
1,877,1,0,0,0,0,29,10,4
1,783,1,1,0,0,0,4,15,4
1,607,1,1,0,0,0,31,10,4
1,547,1,0,0,0,0,53,10,4
1,457,1,0,0,0,0,37,10,4
1,231,1,0,0,0,0,54,10,4
1,1,1,1,0,7,-7,18,10,4
2,845,1,0,7,0,7,47,10,4
2,724,1,1,0,7,-7,51,10,4
2,689,2,0,7,0,7,51,2,4
2,585,2,0,7,0,7,46,13,4
2,473,1,0,7,6,1,35,10,4
2,375,1,0,7,6,1,4,4,4
2,345,1,0,7,14,-7,8,10,4
2,86,1,1,21,14,7,50,10,4
3,871,2,1,22,14,8,41,2,4
3,823,3,1,22,14,8,42,1,4
3,775,2,1,22,14,8,52,2,4
3,695,1,0,14,22,-8,22,10,4
3,590,2,0,14,22,-8,26,20,4
3,550,1,1,22,14,8,29,10,4
3,252,1,0,17,22,-5,47,10,4
3,155,1,1,22,17,5,15,10,4
4,544,1,1,22,20,2,41,10,4
4,454,1,0,20,22,-2,40,10,4
4,279,2,0,20,22,-2,50,1,4
4,250,1,0,20,22,-2,48,10,4
4,212,2,0,20,22,-2,40,2,4
1,868,1,0,0,0,0,42,10,4
1,610,1,1,1,0,1,45,10,4
1,496,2,0,0,1,-1,25,8,4
1,120,1,0,0,1,-1,19,10,4
2,751,2,1,4,0,4,23,4,4
2,739,1,1,4,0,4,14,10,4
2,603,2,1,4,7,-3,29,2,4
2,448,1,0,7,4,3,1,1,4
2,420,2,0,7,4,3,1,1,4
2,382,3,0,7,4,3,1,1,4
2,364,1,0,7,4,3,1,10,4
2,259,3,0,7,4,3,10,1,4
2,190,2,0,7,4,3,20,1,4
2,180,1,0,7,4,3,22,10,4
3,825,1,0,10,7,3,21,10,4
3,695,2,1,7,10,-3,32,1,4
3,660,1,1,7,10,-3,35,10,4
3,205,2,1,14,10,4,39,6,4
3,130,1,0,10,14,-4,16,10,4
3,92,2,0,10,14,-4,23,3,4
4,900,1,1,14,10,4,40,10,4
4,710,2,1,14,13,1,51,11,4
4,530,2,0,13,14,-1,45,1,4
4,454,3,0,13,14,-1,44,0,4
4,430,1,0,13,14,-1,43,10,4
4,306,1,0,13,17,-4,46,0,4
4,280,2,0,13,17,-4,55,1,4
4,264,3,0,13,17,-4,55,1,4
4,215,1,1,17,13,4,54,10,4
4,180,2,0,13,17,-4,46,0,4
4,106,2,0,13,17,-4,24,6,4
4,75,1,0,13,17,-4,42,10,4
4,73,2,0,13,17,-4,44,12,4
1,796,1,1,0,0,0,9,10,4
1,721,1,0,2,0,2,43,10,4
1,637,1,1,0,2,-2,39,10,4
1,610,2,1,0,2,-2,32,3,4
1,428,2,1,0,2,-2,52,0,4
1,255,1,1,0,5,-5,35,10,4
1,30,2,1,0,5,-5,51,1,4
2,875,1,1,0,5,-5,7,10,4
2,834,2,1,0,5,-5,9,8,4
2,737,1,1,0,5,-5,46,10,4
2,597,1,1,0,5,-5,49,10,4
2,500,1,0,5,0,5,19,10,4
2,459,1,0,5,0,5,35,10,4
2,363,1,1,0,5,-5,45,10,4
2,330,1,1,0,5,-5,16,10,4
2,304,2,1,0,5,-5,15,9,4
2,209,1,1,0,8,-8,47,10,4
3,858,1,0,8,3,5,43,10,4
3,810,2,0,8,3,5,40,7,4
3,762,1,0,8,3,5,31,10,4
3,675,1,0,8,6,2,35,10,4
3,558,0,0,8,6,2,27,0,4
3,481,1,1,6,11,-5,35,10,4
3,368,2,1,6,11,-5,41,0,4
3,339,1,1,6,11,-5,40,10,4
3,105,1,0,11,6,5,54,10,4
3,38,1,0,11,6,5,47,10,4
4,770,2,0,11,6,5,7,1,4
4,740,1,0,11,6,5,3,3,4
4,705,2,0,11,6,5,1,1,4
4,672,1,0,11,12,-1,34,10,4
4,654,2,0,11,12,-1,43,1,4
4,558,1,1,12,17,-5,37,10,4
4,501,1,1,12,17,-5,50,10,4
4,414,1,0,17,12,5,31,10,4
4,308,1,1,12,17,-5,38,10,4
4,214,1,1,12,20,-8,39,10,4
4,101,1,1,12,23,-11,25,10,4
4,95,2,1,12,23,-11,18,3,4
4,72,1,1,12,23,-11,14,10,4
4,32,3,1,12,23,-11,5,1,4
1,890,1,1,0,0,0,26,10,4
1,721,1,1,0,0,0,51,10,4
1,695,1,1,0,0,0,26,10,4
1,636,1,1,0,0,0,14,10,4
1,565,1,1,0,0,0,3,3,4
1,472,1,0,7,0,7,53,10,4
1,395,1,0,7,0,7,1,10,4
1,375,2,0,7,0,7,9,2,4
1,301,2,0,7,0,7,25,1,4
1,158,1,1,0,7,-7,40,10,4
1,132,2,1,0,7,-7,46,4,4
1,53,1,0,7,0,7,24,10,4
1,33,1,0,7,0,7,35,10,4
2,845,1,1,0,8,-8,35,10,4
2,653,2,0,8,0,8,38,10,4
2,572,1,1,0,8,-8,47,10,4
2,550,1,0,8,0,8,45,10,4
2,439,2,0,8,3,5,35,10,4
2,194,1,0,9,4,5,35,10,4
2,130,1,1,4,9,-5,41,10,4
2,73,1,0,9,4,5,47,10,4
2,40,1,1,4,9,-5,5,10,4
2,30,1,1,4,9,-5,15,10,4
3,869,1,1,4,9,-5,15,10,4
3,796,2,1,4,17,-13,29,16,4
3,689,1,0,17,4,13,40,10,4
3,642,1,0,17,4,13,19,10,4
3,497,1,1,11,17,-6,32,10,4
3,355,1,1,11,17,-6,4,10,4
3,226,1,0,20,11,9,48,10,4
3,129,1,0,20,11,9,10,10,4
3,102,2,0,20,11,9,19,1,4
3,44,1,1,11,20,-9,41,10,4
4,865,1,1,11,27,-16,15,10,4
4,704,3,0,27,11,16,36,1,4
4,581,1,0,27,11,16,18,10,4
4,475,1,0,27,14,13,35,10,4
4,185,1,0,27,17,10,35,10,4
4,157,2,0,27,17,10,40,5,4
4,36,2,0,27,17,10,1,1,4
1,897,1,1,0,1,-1,35,10,4
1,795,1,0,1,0,1,19,15,4
1,775,2,0,1,0,1,24,10,4
1,739,3,0,1,0,1,34,0,4
1,715,1,0,1,0,1,35,10,4
1,522,1,1,0,8,-8,48,5,4
1,479,2,1,0,8,-8,44,1,4
1,429,1,1,0,8,-8,53,20,4
1,317,1,1,0,8,-8,1,1,4
1,264,2,1,0,16,-16,35,10,4
1,170,1,0,16,0,16,30,10,4
1,142,2,0,16,0,16,20,0,4
2,800,1,0,16,8,8,24,10,4
2,725,1,0,16,9,7,35,10,4
2,610,1,0,16,16,0,46,10,4
2,530,1,1,16,16,0,8,10,4
2,490,2,1,16,16,0,14,4,4
2,341,1,1,16,16,0,39,10,4
2,160,1,0,16,16,0,6,10,4
2,54,2,0,16,16,0,54,5,4
3,861,1,0,16,16,0,45,10,4
3,780,1,1,16,16,0,25,10,4
3,522,1,1,16,16,0,3,10,4
3,492,2,1,16,16,0,12,1,4
3,454,1,1,16,16,0,22,10,4
3,412,1,1,16,16,0,48,10,4
3,350,1,0,16,16,0,44,10,4
3,288,2,0,16,16,0,35,1,4
3,145,1,0,16,16,0,1,1,4
3,129,1,0,16,23,-7,29,10,4
4,617,1,1,23,22,1,9,10,4
4,573,2,1,23,22,1,18,1,4
4,516,1,1,23,22,1,48,10,4
4,345,2,1,23,25,-2,41,4,4
4,305,1,1,23,25,-2,47,10,4
4,221,1,0,25,23,2,40,10,4
4,180,2,0,25,23,2,37,7,4
4,73,1,1,26,25,1,17,10,4
4,67,2,1,26,25,1,21,6,4
1,850,1,1,0,0,0,42,10,4
1,632,1,0,0,0,0,37,10,4
1,384,1,1,0,8,-8,40,10,4
1,348,2,1,0,8,-8,35,5,4
2,860,1,1,8,11,-3,47,10,4
2,795,1,1,8,11,-3,33,10,4
2,702,1,1,8,11,-3,3,3,4
2,591,1,0,19,8,11,25,10,4
2,530,1,0,19,8,11,23,10,4
2,180,2,0,19,11,8,7,1,4
2,143,0,1,17,19,-2,1,0,4
2,121,1,0,19,17,2,40,10,4
3,805,1,1,17,19,-2,54,10,4
3,593,1,1,17,19,-2,20,10,4
3,372,1,0,22,20,2,35,10,4
3,275,2,1,20,22,-2,54,3,4
3,155,1,1,20,23,-3,35,10,4
4,900,2,0,23,20,3,45,1,4
4,876,1,0,23,20,3,43,10,4
4,841,2,0,23,20,3,38,5,4
4,705,1,0,23,20,3,44,10,4
4,310,1,1,26,23,3,47,10,4
4,184,1,1,26,26,0,48,10,4
4,123,1,0,26,26,0,25,10,4
4,115,2,0,26,26,0,28,13,4
5,0,1,0,26,26,0,35,10,4
5,0,2,0,26,26,0,33,8,4
1,758,1,0,0,0,0,50,10,4
1,654,1,1,0,0,0,37,10,4
1,624,2,1,0,0,0,45,2,4
1,592,1,0,0,0,0,53,10,4
1,531,1,0,0,0,0,35,10,4
1,443,2,0,0,0,0,15,2,4
1,385,1,0,0,0,0,10,10,4
1,361,1,0,0,7,-7,45,10,4
1,49,1,0,0,14,-14,35,10,4
2,860,2,0,0,14,-14,7,5,4
2,837,1,0,0,21,-21,28,10,4
2,773,1,0,0,21,-21,45,10,4
2,737,2,0,0,21,-21,52,3,4
2,697,3,0,0,21,-21,55,0,4
2,493,1,1,21,7,14,48,10,4
2,401,1,1,21,7,14,17,10,4
2,360,2,1,21,7,14,26,1,4
2,114,1,0,7,21,-14,20,10,4
2,107,2,0,7,21,-14,30,0,4
3,750,1,1,21,7,14,25,10,4
3,674,1,1,21,10,11,35,10,4
3,520,1,1,21,10,11,44,10,4
3,234,2,1,21,10,11,2,1,4
3,101,2,0,18,21,-3,43,3,4
4,751,1,1,21,21,0,35,10,4
4,604,1,1,21,21,0,51,10,4
4,481,1,0,21,21,0,33,10,4
4,260,1,1,24,21,3,17,10,4
4,97,1,1,27,27,0,25,10,4
4,73,2,1,27,27,0,20,5,4
1,795,1,1,0,0,0,38,15,4
1,671,1,0,0,0,0,40,10,4
1,290,1,1,1,0,1,46,10,4
1,250,1,1,1,0,1,20,10,4
1,165,1,1,1,0,1,8,8,4
1,140,2,1,1,0,1,2,2,4
1,17,3,0,3,1,2,54,10,4
2,833,1,1,1,3,-2,23,10,4
2,722,1,0,3,1,2,37,10,4
2,680,1,0,3,1,2,27,10,4
2,570,1,0,3,4,-1,35,10,4
2,457,2,0,3,4,-1,34,30,4
2,301,1,1,4,3,1,32,10,4
2,215,1,0,3,4,-1,40,10,4
2,147,1,1,4,3,1,50,10,4
2,139,1,0,3,4,-1,50,10,4
2,86,1,0,3,4,-1,31,10,4
2,73,2,0,3,4,-1,39,2,4
3,894,1,0,3,4,-1,37,10,4
3,862,2,0,3,4,-1,40,7,4
3,562,1,0,3,4,-1,53,10,4
3,408,1,0,3,4,-1,3,3,4
3,387,1,0,3,11,-8,39,10,4
3,292,1,1,11,3,8,52,10,4
3,219,1,0,3,11,-8,45,10,4
3,115,1,0,3,18,-15,34,10,4
4,900,2,0,3,18,-15,47,10,4
4,853,1,1,18,3,15,23,10,4
4,778,1,0,3,18,-15,32,10,4
4,682,1,0,3,18,-15,46,10,4
4,583,1,0,3,18,-15,17,10,4
4,383,1,1,25,3,22,37,10,4
4,353,1,0,3,25,-22,4,4,4
4,212,1,0,3,32,-29,44,10,4
4,109,3,0,3,32,-29,41,1,4
1,892,1,0,0,0,0,43,10,4
1,860,2,0,0,0,0,50,3,4
1,687,1,0,0,0,0,50,10,4
1,566,2,0,0,0,0,28,2,4
1,429,2,1,3,0,3,50,2,4
1,352,1,1,3,7,-4,5,10,4
1,224,1,1,3,7,-4,43,10,4
1,91,1,0,7,3,4,27,10,4
2,856,1,1,3,10,-7,35,10,4
2,541,2,0,10,6,4,41,4,4
2,518,1,0,10,6,4,48,10,4
2,305,1,1,6,11,-5,40,5,4
2,145,1,0,11,6,5,32,10,4
2,140,2,0,11,6,5,41,1,4
2,119,1,1,6,11,-5,22,10,4
3,887,1,1,14,14,0,24,10,4
3,734,1,0,14,14,0,2,2,4
3,676,2,0,14,14,0,1,1,4
3,616,1,0,14,21,-7,43,10,4
3,585,2,0,14,21,-7,46,7,4
3,547,1,1,21,14,7,46,10,4
3,433,1,1,21,17,4,51,10,4
3,314,1,0,17,21,-4,28,10,4
3,225,1,0,17,21,-4,48,10,4
3,159,1,1,21,17,4,51,10,4
3,25,1,1,21,17,4,18,10,4
4,841,1,1,21,20,1,35,10,4
4,656,1,1,21,20,1,37,10,4
4,578,1,1,21,20,1,25,10,4
4,543,2,1,21,20,1,17,2,4
4,428,1,1,21,20,1,1,1,4
4,346,1,1,21,28,-7,33,10,4
4,327,2,1,21,28,-7,40,3,4
4,243,1,1,21,28,-7,40,10,4
4,169,1,1,21,28,-7,27,10,4
4,145,2,1,21,28,-7,29,12,4
4,91,1,1,21,31,-10,25,20,4
4,52,1,1,21,31,-10,44,10,4
4,47,2,1,21,31,-10,36,2,4
1,893,1,1,0,0,0,19,10,4
1,697,1,0,0,0,0,25,10,4
1,384,1,1,7,3,4,42,5,4
2,803,1,1,7,6,1,47,10,4
2,730,1,0,6,7,-1,49,10,4
2,695,2,0,6,7,-1,45,6,4
2,649,3,0,6,7,-1,40,1,4
2,615,1,0,6,7,-1,39,10,4
2,448,1,0,6,7,-1,22,10,4
2,414,2,0,6,7,-1,25,7,4
2,360,1,1,7,6,1,48,10,4
2,227,1,0,6,7,-1,44,10,4
2,108,1,1,7,13,-6,33,20,4
3,894,1,0,14,10,4,34,10,4
3,646,1,1,10,15,-5,47,10,4
3,557,1,0,15,10,5,4,10,4
3,478,1,0,15,10,5,17,10,4
3,363,1,1,10,15,-5,49,10,4
3,193,2,1,10,15,-5,20,1,4
4,834,0,0,18,10,8,40,0,4
4,790,3,1,10,18,-8,44,1,4
4,703,1,1,10,18,-8,17,10,4
4,577,1,0,18,10,8,45,10,4
4,292,1,1,13,18,-5,5,10,4
4,222,1,0,18,13,5,38,10,4
4,141,1,0,18,13,5,43,10,4
4,98,1,0,18,13,5,24,10,4
4,74,2,1,13,18,-5,36,16,4
4,42,1,1,13,18,-5,51,10,4
4,36,2,1,13,18,-5,48,7,4
4,14,3,1,13,18,-5,43,2,4
